Jackie Kerr	Well said
king King	Tasha K is the first droke motherfuker I know to lie when their drunk you usually tell the truth this broken woman straight up lied
Robin MC Unknown	The last quote wa well stated in this video it come back
Kayron Simmons	Girl Cardi paid your source more trust me u are being used for publicity your source is making that money Mann that s GAaammmeE
jocelyn jorden	A NG Well first I dont really care Second I m not corporate and I have access to the internet like everyone who ha commented Some people give stock to little information like that before calling someone a lie So I figured why not throw that into the discussion She called it krogers Y all said it Murray s So I let folk know krogers owns Murray s That s all the rest is chatter on irrelevance
B Michelle	I like the video but the best part wa hearing Lefteye rap at the beginning I miss that chick ğŸ˜‡ğŸ˜‡
Joyce-Suzzanne	Has anyone checked her web page She said she wa going to put the receipt on her website ğŸ¤ª
LIVEFRMNYC	The dog meme wa perfect ğŸ˜‚ğŸ¤£ğŸ˜‚
biscuitoffme	How her source delete her dm I may be wrong but how the source get in Tasha k sm to delete her message
Clarisse Amay	This is really annoying af like fr
Hugh Mad Bro	She â€™ s a whole lie her life is probably a lie she need to lay off the booze clearly ğŸ¤¦ğŸ»â€â™€ï¸ I know it â€™ s free these company â€™ s are fueling her habit ğŸ¤·ğŸ»â€â™€ï¸
Veronica Cooper	Close friend that dont know her
Natasha Horton	How can someone delete message that they sent you I â€™ m confused am I missing something She is just toooo drunk and loud for this Tasha She â€™ s a special kind
Latasha stoker	Whaaaat I call bullshit Like really Now Remy in it She reaching wayyyyy to far
icey 786	she to ob with cardi dam leave cardi to live her dam life with her nunu and hubby stop the hate gwad dam
sharonda goode	Why do y all keep making video about TashaK just move on and find your own content to gossip about
gregory18000	â€œ Remy doe smoke crack â€ I don â€™ t believe anything that come out of Tasha â€™ s mouth
Kimme G	She need to put the Wine Down
Carolyn Brown	Shut your stuttering Stanley as up ğŸ˜‚ğŸ˜‚ğŸ˜‚ğŸ˜‚ğŸ˜‚ğŸ˜‚ğŸ˜‚ Cardi got these bitter BITCHES MAD MAD
Charlene Mitchell	Tasha is jealous of Cardi b because she is she is ugly and broke and Cardi is not
Timeka Brandon	I started watching your channel and I subscribed to your channel because I like the news that you reported Right now it seems like you re being a bully and that I don t like I m going to unsubscribe and I will not watch your channel anymore
Kelley G	I can â€™ t hardly watch Tasha K all that damn yellin Smh just talk you got a fucking mic why u yelling
Baby Chanel	ğŸ¤£ğŸ¤£ğŸ¤£ğŸ¤£ to BLOODCLAAW wtf ğŸ˜­ğŸ˜‚ğŸ˜‚
blkindians	Hi my name is tashak and I m a alcoholic The group speaks hello tashak
Beverly  Craven	I used to be a huge fan of Tasha and although I m not a Cardi fan I had to unsub Not down with lying on anyone
Moon Incantesimi	Y â€™ all sound like crack headed bitch if you think â€œ Tasha k ha a personal vendetta for cardi â€ that â€™ s probably one of the most retarded shit I â€™ ve ever heard an adult say yall think blogger gone protect your favorite artist that â€™ s not how life work obviously
MooBerry2009	I use to like tasha but shes being a hypocrite how can you get mad at someone for defending themselves but a soon a people attack her she defends herself and sends those wino after people
Hazeleyez Amour	Lmao every body mad at Tasha k ion see y she been doing this Tasha not the only one who gossip about celebs She must be doing some thing right ALL Y ALL SOME TASHAK HATERS SHE GOT ERBODY ATTENTION make that stew TashaK
Kahpone Bone Formerly OF MO Thugs Ruthless Records	She look like the road runner from bug bunny cartoon
nikanj6	Luv the ending of your video I live by what go around come around ğŸ‘ğŸ¾
NAOMA RILEY- HALL	Tasha is being messy but that what â€™ s happens when you are a messy person you can report thing but do it nice ğŸ‘
Arionna Moore	Tasha K get off of cardi pussy so hard all u do is keep talking about her and her people u a grown as woman get ur life right
Naomi King	Tasha K can t get her lie togetherğŸ˜‚ğŸ˜‚ğŸ˜‚ damn she really must hate Cardi B s
Marques desade	Ned the wino
laylay beautiful	Nikki salty Her worker Tasha K gon na get laid off today The End
Mark Smith	shyt don t make sense
thepatshowonwp	Your editing is hilarious I wa done with Tasha K when she ambulance chased that dude who used to work for Khia and it blew up in her face when it wa revealed he stole from Khia this guy wa so inarticulate and stupid there wa no way he wa telling the truth I said it then and I ll say it now It will happen again Since I said it the first time she ha gotten her as in a wringer with the R Kelly situation Usher Remi and now Cardi She s greedy and so she ll never learn watch my word
Tre Mason	She is the perfect example of u can t win when u play dirty
Duwa Nova	ğŸ˜‚ğŸ˜‚ğŸ˜‚ğŸ˜‚ğŸ˜‚ğŸ˜‚ ooookay
K Adams	Tasha you have been exposed you ladder climber
Shay Songtress	ğŸ˜‚ğŸ˜‚ nobody wa texting her She had to think of the lie
a_rose_forlife G	Yessss Eat her as up Cardi ğŸ’¯ğŸ’¯ğŸ’¯
Brittany Williams	Lol there â€™ s no way a blogger would get info like that and not screenshot
Honey B	Teeeeheeheeee ğŸ¤£ğŸ¤£ğŸ¤£
Corey Bennett	Lord Tee Give It Up Girl Somebody Gone End Up Fucking You Up Behind All These Lies
Denise Zientek	Tasha K is the least informative and entertaining youtuber Out here She need to fabricate and exaggerate she feel like for some reason I guess she don â€™ t think people will like her if she â€™ s just herself and tell the truth She â€™ s got ta be so extra all the time Extra loud extra bullshit I â€™ ve really tried and I just can â€™ t with her
Honey Summers	Tasha ha Obsession She in love with Cardi
Miss. Bee	Tasha is popping right now she got this girl making video about her go Tasha ğŸ‘ğŸ¾ğŸ‘ğŸ¾ğŸ‘ğŸ¾ got the cardi fan mad and making video
kisha mceady	Tasha Tasha Tasha come on si you got to do better
Gina JackÃŸon	Everybody who contacks you now about Cari B Will mostlikely be fake story andvthey no your gon na run it cause you seem desperate You messed up with fake story Story Starr gave you without doinf proper research I doubt if Cardi B Sent a fake Paper for Tasha to quit slandering her Tasha Needs to worry about a law suit Prays
kiA down2earthasschic	She â€™ s so messy ain â€™ t no Grown Ass Woman that interested in another grown woman and they coin ğŸ¤¦ğŸ½â€â™€ï¸ The star bitch wa so busy tryna tell cardi business she ain â€™ t tell y she wa facing charge and from that alone shouldn â€™ t be credible how u gon tell somebody else story when u can â€™ t be honest abt your own it â€™ s jus sadğŸ¤·ğŸ½â€â™€ï¸
truth hurtz	ğŸ˜‚ğŸ˜‚ğŸ˜‚tasha thts wht yo punk as get ğŸ˜‚ğŸ˜‚ğŸ˜‚ğŸ˜‚dummie a drunk aint shit
P S A	Tasha pulled a Jennifer Williams ğŸ’€
Unapologetically Me	I really don t like her she be reaching for mess
Elena Kelly	ğŸ˜°ğŸ˜°ğŸ˜°ğŸ˜° she is a liar and a hater
Tammy james	She is sooo obsessed with Cardi I m so over her dumb as
teaka loveinme	Once you send a person something through YouTube or through Facebook or through Messenger you can t delete what you already sent somebody you can delete it on your side but the party still get it she s just a liar I used to like her when she first started her YouTube now she s messy
Jay D	I don â€™ t know Tasha you looking bad now straight up However those receipt should have been screen shot if you wa telling the truth Why are you talking about Remy called her black lip that â€™ s not nice fucked up Gurl bye ğŸ‘‹ âœŒğŸ¾ğŸ˜œ
Danny Ross	Lololol thats what you get hoe ğŸ˜‚ğŸ˜‚ğŸ˜‚ğŸ˜‚ğŸ˜‚ğŸ˜‚
Des Gaze	All the different clip confuses me This is unorganized and it kinda distracts me from what yours sayin
QCC Golding	If that â€™ s the case you are no better although I don â€™ t watch every one of her life I did watch that one and she did screenshot some of the message but you left that out Therefore you are not a credible source either
Angela Butler	Are you serious
Rosalind Wallace	Girl you need stop Stop cloud chasing Unwinewithtashak winning ğŸ˜ğŸ˜ğŸ˜ğŸ·ğŸ·ğŸ·ğŸ’¯ğŸ‡ºğŸ‡¸stop hating
Ebony_Love_R_007	OMG the DOGS tho BWAAAAAA ğŸ˜‚ğŸ˜‚ğŸ˜‚ğŸ˜‚ğŸ˜‚ğŸ˜‚ğŸ˜‚ğŸ˜‚ğŸ˜‚ğŸ˜‚ğŸ˜‚ğŸ˜‚ğŸ˜‚ğŸ˜‚ I love how they carry on while anxiously waiting for Tea biscuit LOL ğŸ˜ğŸ˜ğŸ˜
Twilight Moon	Perhaps if u did your research b4 making this stupid video you would of seen that both woman were yelling the truth Cardi is a compulsive liar and your yesturday news and don â€™ t no nothing about nothing
dareisha darden	Lol that bitch cardi going to jail
SweetHeart !	These Evil bitch ğŸ˜ˆ be trying to get at cardi And GOD see all uglyğŸ¤£ğŸ¤£ğŸ¤£ GOD is protecting Cardi from EVIL What you send out come back ten time worse
Nurse BessieRN	WTH wrong wit Tasha
CariBeLatina-Doll	she doe have a vendetta against cardi even though she exposed those lying a stripper her goal wa still using cardi B to get into Hollywood she thought that by helping Nicki destroy cardi she would get into Nicki Minaj good grace and hoped that Nicki would use her contact to help her into Hollywood but that plan of her backfire miserably she is soo desperate for fame it s pathetic
Truth Serum	She never had info Cause if she did she would have screenshot it like she do everything else
Shout Out	Tk there going yo set you up really bad You are out here looking desperate to bring Cardi down You cover only Cardi Talk about Kayne Drake dumb as and so much more you can talk about Cardi got money now she will pay people to fuck with your PLATFORM Leave Cardi alone she is her worst enemy
Cha Ndo Mav	ğŸ¤£ğŸ¤£ğŸ¤£ğŸ¤£ the struggle is real
PD	WhoğŸ¤·ğŸ¤·ğŸ¤·knows what anybody doe to somebody that they don t know or may never meet Sometimes the comment section blow my entire ya digğŸ¤£ğŸ¤£ the thing people call each other trying to stand up for a star that they don t even knowğŸ¤“ğŸ˜µğŸ¤”ğŸ˜‚ y all stay safe out here in the world of entertainment âœŒï¸ â¤ï¸
Kat Morada	Why doe this chick act like everyone is hard of hearing God damn tone it down woman
raingreen10	Tasha is the bos here ok
femylafi	Remy smoke crack I dont believe that bullshit look at Remy glowing and full boned no crack head is glowing and big boned They look fucked up that bull shit need to stop To me it seems like people are attacking Remy and Cardi when pregnant because they know it easier to get an emotional response People need to stop playing when people are pregnant Smh
Your safe space or mine?	Love your voice girl Personally le of the editing in of the memeable thing would be better just in my opinion Hope you grow girl
Marie Eubanks	This woman is thirsty af Stop drinking so damn much Damn
Melissa Barnes	ğŸ˜‚ğŸ˜‚ğŸ˜‚ğŸ˜‚ğŸ˜‚ğŸ˜‚ğŸ˜±ğŸ˜±ğŸ˜±ğŸ˜±ğŸ˜±ğŸ’ƒğŸ’ƒğŸ’ƒğŸ’ƒğŸ’ƒğŸ˜œğŸ˜œğŸ˜œğŸ˜œğŸ˜œTHE WINO GOT PLAYED
Lauren Thomas	Lol
Carmen PAGE	Tasha is the best in these street thats y u r talking about her You are not brilliant like her
Lonnie 1Love	Lol lol
â™¥BlkandBeautifulDeeâ™¥	Cardi B is not a innocent a you think she is lol She is a liar and got exposed for lying about the makeup artist Don â€™ t know why people cape for her so bad
Super Nova	ğŸ˜‚ğŸ˜‚ğŸ˜‚
BigBwoyTing	Tashak is like 10 people i unsub after that b starmarie interview and if you re smart you will to
MochaBaRbee 18	Tasha K act like she on crack
Valerie Hinds	Trasha K need therapy alcoholism and being a lying as heifer Obsession for Cardi will bring her down
REDDNISE STRAWBERRY	SMDH
shanell adkins	ğŸ¤£ğŸ˜‚ğŸ¤£ğŸ¤£ğŸ˜‚ğŸ¤£ğŸ˜‚
Priceless TV	There is no krogers in New York CityğŸ˜‚ğŸ¤£
Carrie Moore	Haha ğŸ˜…ğŸ˜…ğŸ˜…ğŸ˜…
The Queen	Tasha k already known a a liar clout chaser SAME for starmarie They DONE ğŸ¤£ğŸ¤£ğŸ¤£ğŸ¤£ğŸ¤£ğŸ¤£
Maria MaÃ±ge	Tasha K is straight lying
Angela Williams	ğŸ¤£ğŸ¤£ğŸ¤£ğŸ¤£ğŸ¤£ğŸ¤£ğŸ¤£ğŸ¤£ğŸ¤£ğŸ¤£ğŸ¤£ğŸ¤£
Trisha Hawkins	There wa a Kroger in Brooklyn in 1990 never There wa never a mutherfuckin Kroger ever in Brooklyn this bitch is a lie Never in the history of Brooklyn wa there ever a Kroger
Tol a	Yall check this video it s something smh Quavo Huncho Dreams Quavo Huncho http youtu be Ja4cpA yNRM
SouthernGirl	New 2 your channel â¤â¤â¤â¤ unsubscribed from TashaK too toxic 4 my soul
Cute Tiee	That bitch just mad ğŸ¤·ğŸ¾â€â™€ï¸ I â€™ m patiently waiting for cardi to see Tasha in person Dead as Not even to sock her but just to come front her Because this internet thuggin beyond dead
candyyamzz bowler	lolll ok i see wah yall saying bout the dog lmaoo
Angel Ita	Great video Sunni Great commentary The dog part wa genius ğŸ˜‚ğŸ˜‚ğŸ˜‚ğŸ˜‚ğŸ˜‚
Bae Bee	I am kinda old and new to instagram but can you delete your sent DM s from the person you sent them to AFTER you ve already sent them
Alicia Jordan	ğŸ˜‚ğŸ˜‚ğŸ˜‚ğŸ˜‚ she look ğŸ‘€ dumb a hell wow I new she fraud a soon a she came up she changed and it â€™ s another channel that said Cardi and remy played Tasha K the made a fake page and said stuff about Cardi with no real proof to see if Tasha fall for it and she did it â€™ s hilarious ğŸ˜‚ I for got the lady â€™ s name I think it â€™ s let me check I will post it soon her name
Allen Allen	Its sad that black people will attack a black woman but support other race We love taking down black woman That s why we will never be greater then others Let her make money off this bitch Cardi is using black people to make it not she Puerto Rican again
famous zack	I hate her video s Tasha k Need to âœ‹ stop Sit down
aireus griffin	All are very childish for this shit this shit is played out ti is done with it like leave it alone all you black people take about uplifting but constantly tearing yah own down sad man
You tube Fan!	Tasha is reaching she need to get a life ğŸ’¯
Vanessa Delacruz	BITCH GO TO REHAB LEAVE CARDI B ALONE BITCH
REFER For PRIZES	Why are you all assuming that all the info is false Just because she quote on quote lost the receipt ain t got nothing to do with Starmarie s Testimony and y all seem to have forgotten that one of Cardi B s friend spilled the bean about Cardi being the only one who hung out with Starmarie and that they lived together so if Tasha lost the receipt all she got to do is look at her video which have screenshots on them duh
Techno-Virus 757	Damn this shit crack me up Words are powerful and if you can see and feel that Tasha is lieing Especially if you are accustomed to her platform
Bosalyn Goss	Can u get over 1000 view without Tasha K name in it ğŸ˜‚ğŸ˜‚ğŸ˜‚
shantasia B.	Lmaoooooo that â€™ s what she get smh she love too feed off of negativity Like drop it already lady smh
Talib Moore	cardi b trash
Itzy Zaza	It â€™ s obvious she is lying
Ms I Justice	Great video ğŸ¤£ the doggy tho ğŸ¥º ğŸ• lmao ğŸ© ğŸ¶ ğŸ¤¦ğŸ½ too funny
Hermosa Reina	The same hole Tasha k digging for Cardi Tasha is falling right into it and this hole so deep it â€™ s going to take a long time for her to climb out and she ha to do it alone cause her folk she thought had her back just watching her without helping her It already began This is factual everything Tasha k is saying is a lie remyroja is no snitch Cardi and all her roja si move in silence I know them Truth already began coming out This entire situation is beyond â€œ Damage Control â€ Just sit back and observe
Sheena McReynolds	she need to cut the shit
Sassy Green	See if I made it I would never speak on no bitch that ant got no TV Show 2 I would be silent and if any law be broken I m suing that LITTLE BLOGGER CASE CLOSED
Mariah Gains	She usually smoke crack outside of Kroger s umm ğŸ¤”ğŸ¤” Where would that be Tasha Definitely not NYC If only you knew how you play d and exposed yourself with just that ğŸ‘†lie right there Just shut your dumb drunk desperate for view as up Nobody asked for your imaginary source OR that on the spot bullsh t story you invented
Kawona McCray	I don t even believe this Y all need to quit making video talking bad about other youtubers
narcfree keekee	Crickets
Davonne Hayes	Get off Cardis bra strap ğŸ˜‚ğŸ˜‚ğŸ˜‚ tasha no k
Rena Coney	She really thrusty this shit is real out here I wa always told if u gon na do something do it right There is a wrong and right way to do thing Sis this is not a good look on your part
Deeply Intuit	But DOJA Cat is that Bitch
rosalyn blackwell	Please leave Cardi B alone move on to something new smh tasha k sad sad sad
BaltimoreBama	ğŸ˜‚ğŸ˜‚ğŸ˜‚ğŸ˜‚ğŸ˜‚ğŸ˜‚ I bet her heart dropped â€œ hold on real quick â€ â€œ I don â€™ t wan na reveal my source â€ ğŸ˜‚ğŸ˜‚ğŸ˜‚ğŸ˜‚
Gemini Awakening	Come Through Octavia St Laurent an the end of the vid lol ğŸ˜
me	This stuff sounded so stupid when she wa saying it How the hell they going to do a reenactment when the girl don t work there anymore 2 If they went back it called retaliation or trying to intimidate the victim Which other charge can be brought against them 3 If her friend snitched that s what it is you can t fix that 4 I don t know if anybody is even paying attention Actually Tasha is bullying intimidating and defamation Where she s spreading lie to get ppl not to work with Cardi And this wa started after the Nicki Cardi beef Which we all heard it that Tasha told Star Queen Radio will call you for a interview and she will hire her to work for her payment for a story So it go to show you Nicki pay and get ppl to bully make up lie try to stop ppl s bag Do what ever they can to discredit ppl in the industry So yeah I guess Tasha ain t worried about anything because Nicki ha her lawyer on deck She s coming after millionaire and she doesn t have money like that to back her up unless someone is paying for it ğŸ¤”ğŸ¤”ğŸ¤”ğŸ¤« Tasha wrote that the information she ha is fact it wa verified and true She NEVER said allegedly She said it wa true and fact That s defamation she won t be on here to much longer that s why she s opening other acct and stuff Her CREDITABILITY IS SHOOT A blind person can see she lied Her supporter and follower how are y all going to justify what she said And know she LIED AGAIN
Anton LaVey	WAIT FOR IIIIIIIT aaaaand NOTHING ğŸ¥Š
Rayne_D	Wait talking to a teddy bear Krogers in NY Used to live on LI if she said Pathmark might had believed her
Bruner Chan	No she just lying She got a fake source herself
Latosha Lemons	ğŸ˜‚ğŸ˜‚ğŸ˜‚ğŸ¤£ğŸ¤£ğŸ¤£
The Dominique Harris Channel	Let me say something this Rat face witch is ACCUSING CARDI B OF CONSPIRING TO HAVE SOMEONE ASSAULTED LETS BE CLEAR CONSPIRING TO DO ANYTHING THAT IS ILLEGAL IS A FEDERAL CRIME IF A WELL KNOWN GANG MEMBER CONSPIRES TO DO SOMETHING ILLEGAL IT IS 3 TIMES WORSE IF NOT MORE THINK ABOUT THE ALLEGATION SHE IS TRENDING AN WHY IF SHE HAD REAL RECEIPTS OR ENOUGH FAKE RECEIPTS TO PROVE CARDI B TO HAVE DONE WHAT SHE CLAIMS CARDI B WOULD FACE THOSE ALLEGATIONS IN COURT YOU CAN T FUCKING UPLOAD A VIDEO ACCUSING SOMEONE ONE OF A FUCKING CRIME FOR A MF CHECK WHERE IM FROM WE CALL THESE PEOPLE RATS AND SNITCHES INFORMANTS
DeeDee Moreno	Sure she did
QueenWeezyâ„¢	Tasha is a loser
Khya Bonnie	Her close friend that doesn t really know her TashaK is an idiot
Ms Juandele'	Tasha lookn more like lil boooosie the more she mkn foooooool outtta herselfğŸ˜©ğŸ˜©ğŸ˜©
Steelcity 412	Man this is getting embarrassing Tasha k need to let this whole cardi ordeal go cause it â€™ s making her look crazy out in these street smh
dollbaby4400	Lawd The dog I died laughing Great video New subscriber Tfs blessing Doll
Tracy Smith	I m not a fan of Special k at all she talk loud and thirsty and don t be saying nothing I don t know what it is with Cardi that she just can t get enough of i think her husband love Cardi cause she send for bae like it s personal
Beans And Cornbread	Lookin up and to the left searching for lie Psychology 101
Mighty Jo Experience	ğŸ¤£ğŸ˜‚ğŸ¤£ğŸ˜‚ğŸ¤£ğŸ˜‚ğŸ¤£ğŸ˜‚ğŸ¤£ğŸ˜‚ğŸ¤£ dog gifs
Hyasmine	She tryna say Remy snitched to the cop is she nut Nicki must be paying Tasha Now Tasha caught Nicki s bad luck Oh well
Jade Kentron	I can see Cardi right now saying Owwwwwww ğŸ˜ğŸ˜ğŸ˜ğŸ˜ğŸ˜
Love Luv	Who is the lady at the end ğŸ˜‚ğŸ˜­ğŸ˜‚
Terri Kitiona	Tasha s negative energy is so toxic that I had to unsubscribe to her channel
Carolyn Hester	I m tired of y all using Tasha k for y all view damn y all ain t got nothing to talk about if it ain t nothing going on with Tasha k what is y all going to talk about then cuz that s all y all seem to talk about these day it s Tasha K find something to talk about baby Clout chasing is playing tf out I m getting sick if y all Cash and Carry name is popping and y all trying to make ya ll s pop by using Tasha K name stop it is she flopping you flopping cuz you talk about whatever going on in her s what s going on over there on your side of the world nothing but Tasha K yeah she s popping is she going to keep popping thanks to y all hater is a motherfxxing motivator baby you didn t know that Y all other blogger are lame af frfr
Lisa Marie	lmao ğŸ¤£ğŸ¤£ğŸ¤£ğŸ˜„ğŸ˜…
elle boogie	aint no krogers in Brooklyn
TMW vids	The dog in the video thoğŸ˜‚ğŸ˜‚ğŸ˜‚ğŸ˜‚
Queen Supreme	Your editing ha me in love and tear at the same time New subscriber here Can t wait to see your other content Keep doing your thing
BORIQUA QUEEN	Soon enough Toxic K will advertise that she ha the exclusive on the roach from NY The lil roach will be sharing how it make them feel when Cardi B us them to describe a chick Wait for it
apostleozzie198	Doe s Tasha K realise how stupid that story sounded And why she have to shout all the d time
Chioma Jonas	Loud as ugly as tasha k
Have A Seat	She made up a fake page and wa sending herself DM â€™ s smh
DEDE BLASS SOUNDCLOUD	TK LOOKS JUST LIKE LIL BOOSIE CUT DAT DUK ON DA TOP OF HER HEAD HAHAHA GOT TA DELETE NO RECEIPTS HEAD TOO BIG OPRAH ANNOUNCE TO DA WORLD U A GOOD DIK SUKA NOOOO CLASS LIKE SUNDAY NOOO CLASS I BELIEVE SHE SOLD HER SOUL HAHAHA 37 DATS FORTY HUNN DEDE BLASS
Proud of Yourself	Now i doubt every video she make even about Rkelly she wa so obsessed
Holliwood	Cardi B doesnt even like yall Yall will die for Cardi b but she wont die or Acknowledge none of her minion Lol Get a life and get off Cardi B tit
Mztrue87	Something tell me she s been paid to act like this cz she just ha no shame smh
billivee	i fell out at the octavia clip
Stacy Bell	How reliable is a source that s close friend with someone they do not like
Bridget Boston	i cant stand tasha k now i once wa a fan however i cant be apart of this bull shit
Mz Virgo317	That idiot is a FRAUD If you call yourself a professional you would most definitely review and gather your information BEFORE you try to present it to your audience ğŸ™„ unless you didnt have the information at all and your just LIEING FOR VIEWS AND ATTENTION ğŸ¤” just throw the whole page away Tasha K annnnnd her wino obsessed worship the ground Tasha K walk on brainwashed follwers Bye Felicia and her Bebe kid âœŒ
ybaby suchafuknlady	I can t stand a loud mouth as femaleğŸ—£ I never felt her anyways
SMALLZZZ SMALLZZZ	Yo Tasha K is insane
T HolleYWood	ğŸ˜‚ğŸ˜‚ğŸ˜‚ğŸ˜‚ğŸ˜‚ğŸ˜‚ğŸ˜‚ğŸ˜‚
W. Wade	Tasha make shit up a she go She done caught that lie disease from star aka ebony aka forehead aka aka ğŸ˜‚ğŸ˜‚ğŸ˜‚
Candice Jones	New sub lmao all fact
KEY key	did she say black lip remy
N Syl	Lol Yes honey Tasha K giving black YouTube a bump up creating check for the people I ve never seen or heard of ya ll folk until y all started making video about Tasha But I m here for it bitch ğŸ¤ªâ˜•streetsğŸğŸğŸğŸğŸğŸ
STREET LIVE TV WITH THE REALEST LADAWN	Why y all putting GOD in this mess believe me he ha more important thing to do Y all eat sleep and breathe Cardi B Her homegirl actually deleted the DM Report on some real news for a change I m so sick of this Cardi Tasha beef a if it s nothing else that matter going on in the world Y all sitting around worshiping Cardi B Get a life
Rey	Anyone with a brain know how petty misleading tasha K ha been with her Cardi B receipt
Bickenhead	This bitch is obsessed with Cardi
El Pee Loko Phboyz	Awha ha Ha Dum hoe
Niya Seivwright	Damn idiot ğŸ˜‚ğŸ˜‚ğŸ˜‚ğŸ˜‚
Pembrook Sutherland	ğŸ˜†ğŸ˜†ğŸ˜†ğŸ˜†ğŸ˜†ğŸ˜†ğŸ˜†ğŸ˜†THIS MC LYTE SOUND BITE SOUNDING HOE AND FOGHORN LEGHORN LOOKIN BITCH IS BATSHIT CRAZY
sosweetbaby4	TashaK doesn t like Cardi B for SHIT ğŸ˜³ Who know probably Nicki is paying ğŸ’° her Ass too ğŸ¤£
ShamelessRadio CT	Tasha K ha lost a lot of credit It s almost like she ha a personal vendetta against Cardi There is blogging and commenting and then there is too far
Chevy Everett	Tasha K need to have a downfall in order to be humbled All she do is spread fake news with no receipt Plus she never doe her homework thoroughly Tasha K need A Tall Glass Of STFU ğŸ¤¨ğŸ¤£ LovelyTi TeaSipper
Sun Fire	ğŸ˜‚ğŸ˜‚ğŸ¤£ğŸ¤£ğŸ˜‚ğŸ˜‚that wendy Williams clip
Nicole Jane	I m so glad she s coming falling down like Humpty Dumpty lmao
Vanna Kegley	I wa there for her Live show once she kept repeating there wa a Kroger in NYC I started to literally feel bad about her level of thirst Kroger DOES NOT exist there and she couldve easily googled that shit to confirm that fact
Kimberly Mathis	This video funny as hell but one yetğŸ˜‚âœŠğŸ¾
Chicadee901	Smh
Wendy Gregory	Tasha K ha it going on
Yvonne Carter	love the fact you reply to everyone
exzonda ross	Peope need start tell the truth
Mecca Shabazz	Why is tasha k so goddamn loud
Miss Understood	Haha thats what that bish get now she looking dumb asf
msBellosa	Jaaaaaaaaaaaaaa the dog
nellymacc91	She â€™ s her own source lmao
Lin07Q	ğŸ˜‚ğŸ˜‚ğŸ˜‚ğŸ˜‚
IamConnie Phx_Az	Sad thing is i now believe nothing from her mouth and God know how many other lie based video she s made about other celebrity I m not a bit curious about her next drama rant it all lie now in my eye I will make sure i don t even click on her drunkard channel by accident Thats how much i care about ME NOT contributing to her so called YouTube journalism job
Stacey  Caver	She s an alcoholic she really ha problem with herself but more importantly with Cardi They played her simply minded assğŸ˜†ğŸ˜†ğŸ˜†ğŸ˜† that circus clown ğŸ¤¡better known a Tasha K her train is derailing by the second Can t wait til this buffoon ğŸ¦is knocked down a peg or two
earthangel	HilariousğŸ˜‚ğŸ˜‚
Lakesha Scott	New subscriber love this
Josie San	I have work in that area for over 12 year there is no Kroger there
Cat Peterson	I love this video ğŸ˜‚ğŸ˜‚ğŸ˜‚ hilarious
Hollywoodhair4uâšœï¸ğŸ•¯âœ¨	Tasha K is a WEIRDO ğŸ¤ªğŸ¤ªğŸ¤ª
Me, myself, and I	One of my favorite video about Toxic K so far lol This wa hilarious ğŸ˜‚ğŸ˜‚ğŸ˜‚ğŸ˜‚ great job New subscriberâ¤ï¸
Tiffany Robinson	But you still watching Tasha ğŸ·ğŸ·ğŸ·ğŸ·ğŸ·ğŸ·ğŸ·ğŸ·ğŸ·ğŸ·ğŸ·ğŸ·ğŸ˜˜
Asia Tyree Show	Cardi said she know her so im lost
D. D.	http youtu be Va7suDxgnBo check out this exposure
Moneque Artis	New Here â¤â¤â¤
Shammiria Clark	I kind of believe this is why your IG post been deleted ğŸ’… shit been crazy on IG
CONFIRMATION of INFORMATION	You sound like you know how much of a fan CARDI is of TASHA CARDI go live everyday and not one time ha she thanked all you BLACK BITCHES FOR TRYING TO RIGHT HER WRONGS AND COVER UP HER LIES YALL WOULD BE SO EXCITED IF CARDI REACHED OUT TO Y ALL BECAUSE Y ALL THINK SHE IS SOMEBODY AND BEFORE I M CALLED A HATER I M ABOVE CARDI TAX BRACKET 2 HOMES SEATTLE LAS VEGAS BUSINESS OWNER WITH A STAFF NO DEBT WE OWN EVERYTHING I M BEAUTIFUL BLACK WITH REALLY NICE TEETH LONG REAL HAIR BODY STAY ON POINT ALL NATURAL NO FIX A FLAT IN MEğŸ˜² I HAVE A HANDSOME HUSBAND AND 2 SMART GORGEOUS KIDS I VE NEVER BEEN ARRESTED I USE MY PASSPORT OVER 5 TIMES A YEARğŸ˜ NOR HAVE I HAD TO SUCK FUCK AND SLIDE DOWN A POLE TO GET THRU HARD TIMES all I see is ENVY y all don t have enough hair on ya pussy to be on some REAL SHIT BE A LEADER LIKE TASHA WHO refused to back down or bow down to that DOMINICAN MUD RAT BLACK PEOPLE SO QUICK TO CLAIM CARDI BECAUSE SHE LIGHT SKIN WITH WHAT Y ALL CALL GOOD HAIR AND DOMINICAN PEOPLE WON T ACCEPT HER BECAUSE SHE DARK SKIN WITH WHAT THEY CALL NAPPY HAIRğŸ˜² BUT ONE THING IS FOR SURE OFFSET AND HIS FAMLIY WON T UNDERSTAND SHIT HER AND HER NON ENGLISH SPEAKING FAMLIY HAS TO SAY AT Thanksgiving dinnerğŸ˜†ğŸ˜†ğŸ˜† CARDI JUST BETTER BE GLAD SOMEONE TALKING ABOUT HER NOW WE ALL SEEN WHAT HAPPENS WHEN THEY STOP TALKING IT S BECAUSE THEY FORGOT ABOUT YOUğŸ™„
Carrol Haywood	Bitch wa drunk lmao
Lavette 0618	I am CRINE ğŸ˜‚ğŸ˜‚ğŸ˜‚ The wine constantly being pouredğŸ˜‚ğŸ˜‚ğŸ˜‚
frenchweewee	the best thing everyone can do right now is stop giving toxic k life let her sheep following sip the fake juice pretend this chick doesn t exist the best thing that happened out of all of this fake gossip is I found other you tuber page that have better content I unsubscribed haven t been back on her page since I don t dislike her don t know the chick but her content is wack the gossip her source are not reliable she is way too thirsty trying to find dirt on everyone she will eventually fade out not soon enough because she is caping way too hard to be revelant
SeeWhaT ISee	Ya lil kum up WON â€™ T kum from THIS ONE CTFUUUUU GIRL TAKE YA TIED ASS ASS GO TO BED U BIG MAD HOE ğŸ¤£ğŸ¤£ğŸ˜‚ğŸ˜‚ğŸ˜‚
theetinolewis	There s no Kroger in New York ğŸ˜‚
Eric Williams	That dog LoL lol hahahaha lol hahahaha lol hahahaha lol hahahaha
Lioness Of Judah	Cardi B tricked TashaK She always swearing Cardi behind her being exposed They swore she wa behind the iamahaterstarmarie13 page I made Ain t damn Cardi involved my homies tricked her gullible as She had the nerve to tell her blind follower her source wa verified ğŸ˜‚ğŸ˜‚ğŸ˜‚ Now y all see she doesn t take the time do her research thoroughly she doesn t care if the info is credible or not If she think she s going to go viral by putting it out there that s bitch on it ğŸ˜…ğŸ˜…ğŸ˜… Talking about they trying to make her not look credible Girl your drunk as been doing that yourself ğŸ˜‚ğŸ˜‚ğŸ˜‚ Oh if y all haven t heard come to my page and check out that Unwinewithtashak StarMarie Diss track ğŸ’ªğŸ˜…ğŸ˜…
Nicki Sway	We love Tasha k so shit happens stop hating it look like you doing the same thing now hit the glass ğŸ·ğŸ¥„ğŸ·ğŸ¥„ğŸ·ğŸ¤£ğŸ˜
Janine Cantey	ğŸ˜‚ğŸ˜‚ğŸ˜‚ğŸ˜‚ğŸ˜‚ğŸ˜‚ğŸ˜‚ğŸ˜‚ğŸ˜‚ğŸ˜‚ğŸ˜‚ That s what that Drunk A Thirsty fraud get Karma
Lizzy Bee	She kept stalling the whole time She didn â€™ t have anything so it turned into slander smh
bubukitty kat	SHE S A LIAR ğŸ˜‚ğŸ˜‚ğŸ˜‚ğŸ˜‚ THAT GIRL IS SICK IN THE DRUNKEN HEAD
Jessica Rabbit	This dumb bitch keep saying â€œ Cardi â€™ s CLOSE FRIEND THAT SHE DOESN â€™ T KNOW â€ How are you close friend w someone you DO NOT know I â€™ m confused ğŸ¤”ğŸ¤” Her wine zombie don â€™ t see right through her if they do they don â€™ t care are a messy a her as is She â€™ s so juvenile it â€™ s sickening YouTube need to take her channel away She us it to attack bully people that she â€™ s never met She also try to get her zombie to bully people too She â€™ s a disgrace to the African American motherhood intelligent community LoL She ha to be stopped before she get hurt
Snickers	Lol those dog
Natasha Walker	Something wrong with this Tasha k lady
China Luv	Lol Watch Tasha v Jessica Reid Lol They â€™ re exposing her Lol
kssnmiss	Great video new subscriber
Alyssa Charles	Love Tasha k you hater smh Black woman again
Blessed	Everyone on Tasha Ks page Can you â€™ ll do youlls own research though you â€™ ll hating on someone doing what you â€™ ll do
Shauny Green	this video wa lit I enjoyed every bit it wa better than wine â¤
A NG	LMAO the crazy part is I m from NYC and wa watching LIVE I kept telling her in the comment there is no Kroger they are trying to discredit her and she would not listen There were multiple people chiming in w the same complaint I knew this would happen sooner or later Sad
