game freak	Why are you screaming Stop it
Michael Halbrook	Do you know how not to yell the whole fuckin time
xD	Gaya is hella gay
Luke Williams	Offline is just so boring playing 40 game of that is just dead to me if it wa just 4 game a day I â€™ d do it but with fur champ division a well it â€™ s too many game
Antonio Soares	NÃ£o sejas assim AA9skillz Sabrina nÃ£o Ã© mau de todo xD
Fruzzy T	Why is he buying point on a RTG
Wob Wob Ninja	You just special man That s why
Michael Quinn	Wjnaldum Wanyama
PiggyGamer	I dont play it too much because i think it more boring then rival so i use the time i have to do rival
BOMBMAN323 OW	I played fit champ and it didn â€™ t give me any rewardsğŸ˜ª
Prince Eton	Why doe everyone have these crazy team then bronze player on the bench Am I missing something
LMA GAMING	sell henry
Ethan Irwin	Please don t get Best because then you will say good thing about him and his price will go up coz I m saving up for him
BEAST x G0Lden	Squad battle is time consuming
Kevin Owens	Dashie fan came here
Louie Jakes	14 win 14 loss
Dylzeo Playz	Get bale instead of neymar
Aaron Hammond	I â€™ m a Leicester fan so thanks for the love Skillz
Psycho XIIX	Have no time and i think ronald give me more w9th al the oppertunities i can play do ye keep on the doen
Masqerader	Offline beat playing against nothing but people who spends 1000 to win a game of finesse kick
Cody White	I â€™ ve watched you for a long time now Wanted to say the reason I watch your video besides the content the high reward and how good of a player you are You are pure at heart and you absolutely love your job and truly appreciate your support For most content creator I can â€™ t feel even close to the love and appreciation like you put through your work Keep up the good video man Never give up God bless you Btw would keep Henry and sell blanc and save up a bit longer for gullit
orifah28	I don â€™ t play squad battle cu it â€™ s not a fun a rival
Will Watson	Quit flexin you know you like Sabrina Skillz
Classic Xi	I need help tell me a squad to buy with 200k
GTA Fox	Fair play to you bro mentioning the Leicester incident it wa a nice touch
Angel Garcia	I play squad battle because it free reward when I put youtube video on in the backround
oscar molina	Fifa 19 The Stupidest Game Ever made
crazyfullife	Packed 89 Klose out of my elite1 sb reward yesterday
DHS D	PLEASE GETTTTT GULLIY
Jac Ankers	Got Kevin de Bruyne and van dyke from silver 1 reward
Liam Mcbride	I use to love squad battle I can easily get elite 1 every week but I can never get anywhere near the top 100 despite watching your video on how to so I tend not to play it no more ğŸ˜
_ _	I spend around 1 2 hour a day on average on FIFA during the week day when i only have that little amount of time on the game i prefer playing online and doing SBC s and such If i had the time like you do i d 100 also do Squad Battles no doubt Ppl got ta remember the time you got on your hand compared to u regular fifa player Oh btw don t get rid of Henry
LGR Games	Sell them and try and get gullet and inform mbpape
George Rowe	ğŸ¦ŠğŸ’™ğŸ™ğŸ»
Kyriakos Christoforou	Blanc of course
Reece Goatley	Mbappe
JohnBvoN	i got pogba for gold 2 squad battle lol
Donald duck	Nice
Vpg / Vpgw Royals	29 1 cuz of your record ğŸ˜‚ğŸ˜‚ğŸ”¥ğŸ”¥ğŸ‘ŠğŸ¿
Aslan B	Squad battle is the pnly thing i play that s where i at least skip playing against kid who dab and sweat all the time
NIjah Reid	my friend played 8 game and got dybala i got to elite 1 and got no board
Dean Karas	Sabrina is a banger
Karel Stroeykens	Play the pro tournament
banjo ranvir	Yes giullet
xD VINNY	Insane
StQu The StarQuest	I don t have time to play squad battle and even fut champ because of university who else
Evan Rogers	Absolutely top class guy keep up the good work ğŸ˜
Ben Evans	I got gold 2 cause I didn â€™ t really play but packed Sergio Ramos out of a mixed player pack
Nicole Allouche	I actually love this guy
Sam Moss	No keep Henry
Paul Geldenhuis	I like how fifa is important to you and you play everyday but you still know that some thing are more important and you don t mind skipping a set of squad battle to spend time with your girlfriend ğŸ‘ğŸ‘
Jabu Deng	1030
timothie goodshaw	You would make more fan from Being in the pro scene
Levi0113	Love your video bro being watching since Fifa 12 booyah team
Kristina Baidakova	I play squad battle beacause i cant get playstation plus
adioz1337	what is the fun in getting the same player he had in fifa 18 why not try out some of the new cool icon like Ballack Eusebio Cruyff ButragueÃ±o Figo and such
Pedro Henrique	u just really sold your first owner Alex Sandro or the one in your club is untradable
Conall Dejene	Get icon George best for RW
Ligma Balls	I went 13 17 in weekend league And I don â€™ t play squad battle because I don â€™ t have time because of school
D4 Damage x	I got silver 2 in my second ever weekend league and I got gold 3 in squad battle co I only played 2 set
Niall Jordan	Skillz I finished 17 13 in the weekend league and I only played squad battle game and finished gold
R2 Bazz	Plz do a pro tournament some time
Nic Mat	Skillz bro absolutely love your vids man did the koke scream sbc today and packed your man henry wa so hyped Keep doing what your doing brother
C Smith	Sell blanc for gullit
Foxdog778	Gullit 3
Jack Clark	I love you
TommyPlaysFortnite	I don t like playing against the computer it s boring af
LeBarack James	Sabrina the Teenage Cat leeel
Finn B	What will happen to icon will they stay at 620k due to prime sbc â€™ s always being there or will they drop back soon
XMS5 -	My man stop shouting ğŸ™„
Daniel Culverwell	Skillz if it ain t broke Don t fix it
Snake Sorcerer	Skillz you could watch Prison Break in Netflix
Ryan Palmer	A9skillz this week got 28wins 1 draw and 1 lose
Bobby Cukaleski	Bro you are just real and many people see that real recognize real and you are the realeat And you got a DMX voice It s tooooo dope to not listen too
Harry Toogood	I only get gold 2 any tip
Karim OLeary	I packed 91 modric in my pre order pack
Mistrial Econ	do it get hullit and mbappe
Amzu	Bowser looking as im dead
LUKE.	love your vids man
Stuart Vinyard	Was it 100 a win lol
Willwolves Gaming	Henry for gullit
Callum Watson	Yes
Scottch24	Elite 1 squad battle and weekend league only 17 win this week
castillovictor88	Are we even getting monthly reward Because i haven t been playing all my game
blakem speechley	Aa9 I love to watch your video because they give me hope in the game and your gracious from whatever you pack Your content is so interesting to watch and it make me happy to know there is a YouTuber out there so pls continue the great work you put into your video Best fifa YouTuber next to nep
kilpo kilpo	nah not hrnry
Pro65gamer	Where is the free rtg
Callum Prout	I don â€™ t play squad battle because I don â€™ t have Time and it â€™ s real boring sometimes
I am the Best	I just find offline really boring
Sammy Foo7ball	I had silver 1 and 3 game left and won the last three to get gold 3 and i made the last 2 people rage quit
Thomas Munthe	He got 29 1
Zaid The Gamer	I reached gold 2
Ramy Jr	YES FINALY BABY GULITT CAN T WAIT TO SEE ROCK THE SHITT OUT OF HIM
martin bitkeland	I got Modric in Squad B reward
Nert	still waiting on a skill and ray porno on pornhub
Danny Habetyes	I m just tryna see Skillz get prime Pele
LT Sports	AA9skillz man someone tell me this guy aint the most humble and likeable guy on youtube cmon Keep doing your thing my guy
Kakashi Hatake	You re getting 30 0 and you re getting awesome reward I m telling you Believe it
Tim Neumann	Get Messi now
Tom Games	I wish I had skillz team
Mahmoud Idris	I got de bruyne for silver one reward
Saki 209	gold 2 i wa 10pts short to gold 1 PepeHands
Henry Mazariegos	I got gold 3 and got lloris and aczpelqueta lol
Rashwin Sandhu	Don t buy mbappe try different player
CA Gaming	2 28
Harko And co	I ve gone through 2 100k pack 2 50k pack 4 35k pack 2 45k pack and havent gotten 1 single 86 rated card Aa9skillz please talk to the person you talk to about getting better pack for me please
Miner 69er	Anyone else say A â€™ s intro with himğŸ˜‚
Yaseen Flipper	Get an icon GK Yashin
That Gingerguy	Im predicting 29 1
Ryan Goncalves	14 win and just never played squad battle
Poison Leo clan	In weekend league I only got 8 win
Kade Phillips	Instead of selling blanc and Henry sell matthaus
CB3	sell blanc for gulit and sell neymar and get bale
RI SE	Hey skill for squad battle I got elite three and for the weekend league I got silver one keep it going good content love you skill no Homo
Gareth Clements	16 win in WL Gold 1 each week for squad battle Best pack pull icon baresi Best WL reward pick Lukaku mahrez
DesignerSharp	Teach me your skill
Batderp	Instead of a poor man to glory do a Pack do glory You end up using player that you never would of tried before
muhammed taha	Your an inspiration
vinto LFC	I got sliver 1 in squad battle and packed james Rodriquez
BNSF220	14 27 I DON T KNOW WHY EITHER Read more
J7 Baker	Skillz i dont even think getting top 100 is worth it bro i finished 87th in the world and i shafted
Erica Magana	How ha he already played 590 game
CoreyMx20	Deffo get mbappe back he â€™ s so good on this game
The G.O.A.T	Don â€™ t have time
John Konkack	Love the vids But switch it up make new lineup with player you haven â€™ t used yet
Lawrie	Skillz plz explain monthly â€™ s because it say I have a rank but apparently there no monthly â€™ s
Jonathan	Love U fam
Elliott Kob	14 16 WL
Ruben Pinto	We will have monthly reward in fut champ I want
Filthy Anemal	Skills bouta Pack 3 Ronaldo â€™ s lol
Claudiu Niga	Great move change blanc and henry for gullit and mbappe
Ameer Saleh	bestcontentcreator ğŸ’¯ğŸ‘‘
Jesus Gonzalez	Blanc
Kyle_scifo13	I Found Bale Out Of 25K pack and Ericksen Out Of 50k
Kiwi 101	Get gullit and keep henry
Official_nine ortiz	Blanc
Rodrigo De La Torre	I â€™ m so happy man just pulled my first icon 89 rated Ryan giggs off a draft reward pack Should I keep or sell
Karim Saad	How about Varane for ramos
Negster	You actually might be the most sexy motherfucker this world ha ever seen
The Gamer Cal	8 55 Wanyama XD Wijnaldum
The Homie	I went 15 15 in the weekend league with my 50k squad My very first fut champion ever Hope to get something usable in the reward
Polelek Games	Packed lukacu in preorder pack
ClashWithSticky 881	I â€™ ve had enough point for a few week but I couldn â€™ t play a I had a lot on but imma play this one so is FUT champ an absolute sweat fest or is it like div rival keep in mind I â€™ m only a Div 6 player thanks
sshk1234	Why is mbappe so shit for me
J O	Only reason I don â€™ t play is because I really couldn â€™ t be bothered
Joshua Casarrubias	You â€™ re the goat skillz
Jaii Shrimpton	Blanc for Paul pogba
HaZzA G 123	I don â€™ t play squad battle because I can â€™ t beat semi pro yet I still get gold 1 fit champ
ASKDEM	You da goat ğŸâ¤ï¸
Champ At Soccer	I â€™ d love to play a game against you you seem such a fun person to talk to a well Love the video bruv
Jordan Iz here	Get Bergkamp for Viera
Juan Carlos Ramirez	Bro Who is better Mbappe oh bale To gite for my squad
Enrico Martinelli	Bro don â€™ t even stress if you missed 4 game cause you spent time with your gf it â€™ s wa probably the right choice ğŸ˜‚
Manu Branc	Sell both blanc and henry and buy gullit and regular mbappe Mbappe is one of the best card rn There wa no need to sell him for henry
Brodie Dowling	sell blanc before black friday
LGTRIXTER GAMER	Does anybody know if there is going to be monthly reward for fut champ in this fifa
DAFFA RAYZA PRATAMA SETYAWAN	Sell neymar and blanc for gullit and mbappe
James Irving	Squad battle is the only game mode I play
Mazen Elaraby	29 1
saad juma	17 win and 13 remaining couldn t continue cuz i got buzy with family ğŸ˜¡ğŸ˜¡
THE TOTAL GAMERR	PLEASE GO HELP THIS GUY http youtu be 2ge6 3SIG0w
Arsenal fan	Get the Asian legend nakata he is a beast
No20	Post some squad battle gameplay so we get some tip to beat CPU on legendary
michael van der linden	Reached gold 1 for the first timeğŸ¤ª
ziad torres	it is so cheeseroniiiiii homiee and it boring
Defend	finished 25 5
Daniel 67	Skillz I â€™ m going through a very hard time and trust me when you say in you â€™ re video that you always try to make u happy for at least 15 minute everyday to forget all the bad shit that happens the world every minute You succeed with that in every video You always make me and the booyagang entertained in every video Thank you Skillz
Venatiano	Sabrina while playing squad battle in Legendary Show off lol
Gael Grateraux	I got inform lewandowski from gold 1 reward
This is Adam	Where is the poor man rtgğŸ˜­ğŸ˜­
Ben Preston	Blanc
ZaddyWill	I play squad battle but only to gold 1
Adrian Neblett	Bro get Gullit and Mbappe
hello everyone	I packed Alex Sandro and sold him for 110K
Bryan Monroy	Get best back
Joe Jackson	Yo skillz nice reward bro I played 1 squad battle game and got silver 3 and in the 7 5k pack I got courtois somehow which wa a nice 95k
DFF 763	Racist bitch How â€™ s he gunna call Gini WanyamağŸ™„ğŸ¤£ğŸ¤¦ğŸ»â€â™‚ï¸
Batester	I â€™ m a new subscriber and I love your energy dude
SId Mehra	Sall Blanc and Henry and get the Ruud Gullit
Carter DUNN	Get if Sandro
Genko Junior	why not prime Best
ChickenNugg Life	My highest is Gold one I â€™ ve gotten elite but then down graded because you have to be consistent so the amount of point needed I didn â€™ t get
Origin X Swift	Gg skillz 29 win this week well played
EarlVentRR	Skills you said real job im one of those that ha a real job and i can tell you you are an entertainer people feel you and people respond with love you my brother have a real job too
Jay Jay	Yo I got a ter stegen crap inform and Thiago Silva in the same pack then next one I got ederson I got silver 1 O wait looking back on it might b from my preorder
Omar Gonzalez	Dont sell henry
Finlay Carnegie	Yh offline bore me to death man so I cbağŸ¤·ğŸ¼â€â™‚ï¸ğŸ˜‚
Daniel Solis	My record for the weekend league wa 15 15ğŸ˜…
Raphael Barbier	10 29 lol 69 transfer
William Large	You should get hullit ğŸ˜‰
Haris 2791	Skillz you ain â€™ t ugly man chill bruh and you are good at Fifa I would love to play you
Ewan Peek	I play squad battle too skillz i get elite 1 every week but never get anything good
MrRavingSheep	Get Balack
Paulod1110 HD	I don â€™ t do squad battle because I â€™ m in school most of the time or else I â€™ m asleep
Muhammad R	Save money sell blanc for gullit but keep henry
Daanmuis Daan	Skillz we now you want to be a creator on YouTube and not a pro but it would be very entertaining if you would go to an event for entertainment Love form holland
KarlBraySmith	I went 16 14 is that good
SeveN GG	Stop yelling
ACMChino	No time bro wish I could but just not possible anymore I play like 4 match every other day of that I qualified for the weekend league and missed if I finally qualified but I wa busy all weekend and couldnt even play one match
Joe Mohamed	ğŸ’œğŸ’œğŸ’œğŸ’œğŸ’œğŸ’œğŸ’œ
Jonathan Basso	the problem i have with squad battle is that once i play it alot the moment i got to online i try finesse shot WAY too much
zorgfortnight	I packed salah earlyier
jose Linares	Shout out to AA9SKILLZ 23 in the world
Louis Page	I got baby pires and IF ilicic in the same preorder pack today first icon ever and sold at an inflated 609k thanks to the icon SBC s ğŸ˜€
Liam McGirr	Did someone do the math
GTAvaddazockt	You are always too harsh to yourself
Ksaver Tomasic Srdar	are u dating a 9 yr old
hayden black	What formation doe he run in game
Marko StojanoviÄ‡	Spoiler alert
hoboman2277	If it aint broke also why you bronze benching brother isnt it skill rating not team now Much love from wale
omar hisham	Skills can you give advice on beating legendary squad battle
Itz_Sitrex	My record in Fut Champs is ehhhh I won 12 and lost 18 but I play casually
Bryan Zacarias	I don â€™ t play squad battle anymore cuz I literally fall asleep I â€™ m not even playing
ItalianRfLx	Get Gullit
Kyle Brown	Squad battle is just so boring to play so it not worth it for me
Balaal Kayhan	We watching uhhh sabrina pls don â€™ t make fun of me ğŸ˜‚ğŸ˜‚
MrPerkaholic HD	favourite youtuber man your so humble
Cristiano Ronaldo	U not ugly
Stattix - Fifa 19 Content	Someday the poor man to glory will return Hopefully
Marc Crossan	I got 6 win 4 loses
Anthony Castellanos	Gold 3
K N	Dirty fuckin egg head
Jon Moniz	Yo skillz why haven t you considered eusebio yet Really benfica fan n not looking into eusebio
FIFA MASTERS	You are probably going to get an upgrade on Ronaldo to 95 this week
Diego Swinkels	Weekend league 11 out of 13
freddybobo2	Skills when you have a discussion about how you may or may not have made top 100 but then put it in the title
Bas -	17 13 Im sooo happy with it
Big Fatty	Squad battle top 100 is the same pack a gold 3 fut champ
Yaasir Ugaas	Henry for gullit
Johan Karlsson	Dude i click your vids becasue of you If you say you are not the best content creator out there but you are a super nice chill guy who love what he doe and put and really fun informative video everyday Keep up the good work man Love ya from Sweden
Brorsornamalberg	I played 2 game in squad battle this week and packed 90 Rivaldo from a 7 5 k pack
Craig Jeffery	Got 8 win in 16 game First fut champ so happy with that Shame I couldn â€™ t do all the match
just me	The reason why i dont do squad battle is because i almost loose everytime
Samer M.Masrouaa	I have no idea how you enjoy offline mode squad battle career
Game B632	It â€™ s because I don â€™ t have fifa 19
Alex Davis	He got 29 1
Luke  Collins	Where â€™ s the actual rtg
James Scott	Just got goosebump skillz
Unknownlmao	Mate is there Any chance To see You without the hat
Caine Sheehy	Elite 1 SB 17 11 WL
Abdullah Ahmad	Would love to see you at FIFA esports event You could do a vlog or highlight etc etc etc for that time period It would be a waste of your ability to not go to an event despite qualifying 4 it Even if you get destroyed there we your community will feel being represented at esports event
xDeamZz	Imagine if there were 1 7 mil people in the top 100 it would be the top 1 7 million
chipi escobar	I don t have fifa 19
Miguel rios	Try messi
Revzy TV	i want to be a content creator because i make more money and it â€™ s le stressful lmao
Inferno Dragon	Blanc tbh
Rich127 G	Keep doing what you â€™ re doing We gotchu
Aryan Vasani	appreciate the condolence cmon Leicester
Rodrigo Valenzuela	Im fakeğŸ˜£ i quit watching for all summer then came back
Villads Jensen	I dont have time so i chose to play division rival
Idek	Skillz I just got baby Nesta out of silver 1 reward
Andre ferreira	Buy roberto carlos
Ole Petter	Gullit and mbappe in
Dylan Sousa	good video
Vinte Um	wtf wa that 3 minute NO SKIPPABLE ADD
D C	I m taking a dump right now
Hyper_ King	Big boy Suarez smacking Real
Daniel Anaya	add me on ps4 Lucas0313 for a coin dupe glitch
Isaac Eckermann	Your second channel is called AA9skillz VLOGS You haven â€™ t done a Vlog in like 3 month man Name change
Vincent Miller	Aa9 is 29 1 and this weekend later
Tollef VikerÃ¸degaÃ¥rden	My weekend League record wa 14 win and 26 loss but that wa my first weekend league
EyÃ¾Ã³r Andri Arnarsson	I got Neuer from the pre order pack
Sam #15	I don â€™ t have time to do squad battle and I think it â€™ s really boring
Dmast 911	Sell blanc and courtois get gullit and get ter stegen
Shock Tipsyy	10 5
Abdullah Boraie	S B boring and no time
Anne WÃ¸ldike Kilsdal	Yesterday i played 8 squadbattle game cuz i did not have time the Day before and that wa Hella boring but im useally af elite 1 top 100 in it so im grinding to get middle blanc
Daniel Å imek	i packed aguero in preorder pack
Damian Mangold	squad battle is super boring Rewards were great but it s too time consuming
tomas antunes	8 56 wanyamağŸ˜‚
Iniesta G	Was I the only one who noticed that 69 under the transfer page in 0 0069 second
Shane Bermingham	I got toni Kroos in gold ll ğŸ˜‚ğŸ˜‚ğŸ˜‚
danny 1o3	Rid of henry and blanc for mbappe and gullit
Cheeky NiNjA	Blanc for gullit
Hugo	I â€™ m a Leicester fan ğŸ˜ª
hdkaanozan hd	Ronaldo cm ha
Paul Gallagher	Bruh u aint ugly
Ø­Ø§ØªÙ… Ø§Ù„ØºØ§Ù…Ø¯ÙŠ	17 13
Teodor Lacatusu-Tran	I got elite 1 on squad battle and packed Pique and a inform My friend got silver 2 and packed stoichkov his middle card Man he is lucky
haitham hamad	My first weekend this week and I got 20 8
Greece G21	sell henry and buy stoikov to get money for gullit
ROBBEN 04 A	You should save up for Prime Icon R9 Ronaldo
Jacob Mukumba	For the first time I got gold 3 and in squad battle I don â€™ t really play squad battle cause I find it a little boring
Anselmi Pollari	Just packed hazard from my gold 1 squad battle reward Also when i wont play squad battle it because i dont have time for it
crebactie #	I dont play squad battle cause it take to long to get decent reward for me it not worth it I finished silver 1 in the weekend league
karoll kaveen	29 1
Evan cahill15	I play squad battle cause i cant put money into the game to get the free pack and coin and i have already packed 4 walkout this year from squad battle
Sorin Ionut	Squad battle fifa scripting at it s best Easy to play with legend but let me see you play with an average team max 82 rating against last team on Ultimate
rupertx1	I would â€™ ve kept the first owner Sandro you know
Lachlan Steedman	Dude I just love your vids so much keep up your great work Your a great fifa player Your a great entertainer Every time u upload I know that I â€™ m gon na enjoy it and be entertained for 20 min Thanks man
RPR Gang	Do a schoolboy RTG where you can only play an hour a day Monday to Friday and se what happens
Cristi Stefan	Please try Ter Stegen
Mohamad Reza Soltani	sell Hanry buy gulit and mpbape
Ivan Zarate	spoiler alert he did 29 1 you twitted that
Mr Tiko7Gamer	I got gold 3 and pack 95 messi
Stan Ley DaaaOneAndOnly	Single player is boring
oscar flores Chavez	like for henry for gullit
Mert S.	He end this Weeknd League with 29 1 Thank me Later
Chrissy G	i got gold 1 with 22 win and losing 8 5 of them were from pen which is very annoying because i cant take pen
Sam Head	Do you even get monthly reward now but congrats on that it â€™ s mad
Angelo Giambrone	I would say hold onto blanc and henry since they re doing well for you right now Play a few more weekend and make some coin hopefully around a million in 3 week then you should be at a decent position for gullit
Nadia Kamel	Sell henry and blanc then get mbappe and gullit
Cian Hartnett	I got 11 17 on my fut champ and it wa my first time ever playing in fut champ and I â€™ m happy with that
Toby Worner	My friend ha packed 4 icon this year 93 maradona prime Kluivert prime makelele and JJ
Kelsey Ewen	I play squad battle every week and get elite 1 every week very easily but I only play my weekend game because I don t have time to play during the week I do it because it s easy coin and pack and I use it a warm up game Love the vids bro
Marno Cronje	Go for inform mbappe
Floris Wijtzes	On 8 55 you said Wanyama didn t you call Wijnaldum Wanyama last year aswell
OG Alonso	do poor RTG skillz
FAN MANCHESTER CITY	I don t play Squad Battles because it is way too many game
Supreme Gaming	Keep Henry pleaseeeeee
Dan Caines	Sell blanc
Martim Quinteiro	He got 50th in the world this weekend Thank me later for the spoil
sklonky	Aims for Elite 1 get 9 in the world
William Oxley	I packed 89 rated steven gerrard from elite 2 reward I usually get elite 1 but missed like 3 set
Xx_Nicolas_xX	Do the Hazard sbc
Naturedrex31	Imagine for â€œ Top 100 â€ monthly reward they let you choose an icon
Elliott Scott	Blanc for Gullit
Elimannin4	get rid of blanc keep mattaus aw day
ProSano	Elite 1 for squad battle
HoStOoY	We love you man just please don t wear the Man Shitty jersey again lol
DTHD	Great video like always Skillz Keep up with the awesome content broğŸ‘ŠğŸ½
Yordi Plukker	Talk slower
Benjamin Aas Zimmermann	I Got gold 1 in squad battle but i did only play on Friday and Saturday
System	Again 1 pack opening 15 minute Do them shorter or im gon na keep skipping your vids
Ali Stachan	Gold 3
Jakobinius	I used to play Squad Battles but I quit because it is really boring and the AI is sooo annoying even tho I play on semi pro or pro just to get an easy win they play like ultimate Hate it
Aleksander Å adl	You don â€™ t even know how good your video areğŸ‘ RESPECT
Kexz Gaming	Nooo don t
IXX_HD_IXX	You got 29 1 you can calculate a he got 487 which went up to 496 and his loss went up by 1 can â€™ t remember the exact number
Mohawk Effect	Offlines to boring also I have barely any time to play fifa
Viraj Ganglani	going shopping for 10 min won t fucking mean you missed the update it your fault you forgot to do it no way you were out for 8 hour
Ralph Roof	He got top 100 on fut champ this weekend
LC_9_Gaming	Keep Henry he â€™ s far too good Skillz
Henry Hines	I often get gold 2 but got gold 1 this weekend but when it come to offline I can â€™ t beat AI if it ain â€™ t on semi pro gen
VitoTheGreat	â¤ï¸
NG9Gaming	We ain â€™ t got time like you skillz It â€™ s boring that â€™ s y we don â€™ t play squad battle
kaiiizy	I don t play squad battle because I don t have the gameğŸ˜•ğŸ˜‚ğŸ˜‚
Muhammad Ozaib	Hey Skillz i got a question i have a normal team and Packed Debruyne in Squad Battles reward i wana know if I Should keep him or sell him and replace with Eriksen Debruyne is 400k
Miguel Francisco	I got 87 base mertens in preorder pack 90k
Danny Koning	I always try to get elite 1 in SB Easy 30k and 2 55k pack
kyle kylekeown@hotmail.co.uk	Fut champ I got 13 win out of 30
Connor kelly09	I love squad battle
Gustav Boye	All the one telling the spoiler to Shut up you knew it wa coming
Nathan Cutcliffe	Bro should deffo do the hazard a you regretted not last year and it â€™ s an account where you can add money ğŸ¤™ğŸ»ğŸ¤™ğŸ»ğŸ¤™ğŸ»
John Kearns	I finished Gold 2 barely played all week and packed Prime Icon Nesta
king	Skills ha more win than I have game played
Daniel Allen	I got my first top ğŸ’¯ on SB this week Your tip really helped Rewards were boo boo though Not even a board
Peter Dukez	Hi skillz it â€™ s great to see how passionate and how true to yourself u r about what u do especially in a world of ppl who just want to be better than u and have better stuff your video r top class and keep them coming
SQU3AKY P3NGU1N	I don â€™ t play squad battle because I don â€™ t feel like it â€™ s fun playing against a robot Playing v a human being is brain v brain to see if you are better than the person
K #THE ULTIMATE CHANNEL	That TV show is dope lol ğŸ˜±ğŸ˜±
Yassin VIP	I came in Silver 2 fut Champions I came in silver 1 in Squad Battles i dont played so much
FaZe_Niclas	Blanc for gullit
Carlos Panzardi	Squad Battles is boring and take too much time
Aneesh Karthik	I have no word to speak about the effort that you put up to entertain u Indeed you are one of the best content creator s on YouTube man keep up the job love your videosğŸ˜ğŸ˜ And yes Blanc for Gullit
-NIMAZ -	Sell BLANC
Lamine Toure	I packed Harry Kane and two informs in my squad battle reward I got gold 1
ItzF8 ItzF8	All respect to u brother we would want you to go to the pro scene mooooooore thaaaaaaannnnnn anyyyything We know ur able to get top 100 ffs you got top 100 squad battle and missed a set you have done the 30 0 We just don â€™ t want our favourite Fifa player to waste his talent man Make a pol let u vote for either a few day of video or maybe one or two vids of u in the pro scene Please consider it more brother â¤ï¸â¤ï¸â¤ï¸â¤ï¸â¤ï¸â¤ï¸â¤ï¸â¤ï¸â¤ï¸
Valtteri VÃ¤isÃ¤nen	Squad battle is boring
Jonas Solberg Andersen	he did 29 and 1
Shahbaz Khan	Why did I look at the comment ffs now I know what he got
Ariel	stick with this squad no poor man to glory yet love seeing the top100 finish
Edgar Hernandez	I only play squad battle
Rahhze	Skillz i just qualified for this week fut champ any tip
SmashGamers	Bring back the goatğŸ Mpabbe and sell Henry for gullit pleaseğŸ˜«ğŸ™ğŸ™ğŸ’“
Jack Nolan	Sell Blanc and keep Thierry Henry
Adrian Rosales	Sell blanc for gullit
Zamppa86	Some 86 Alex Sandro is considered an insane walkout now huh LOL D On the better side of football game the PES side I just packed a 91 rated Ter Stegen and a 90 rated Rakitic I got them for playing the game No extra money I also have some other awesome player like 96 rated Neymar 96 rated Ziyech 88 Pepe 90 Bonaventura Lukaku David Silva Some Alex Sandro is nothing compared to those
Drip Squad	Stop saying you suck or your ugly becaus you will believe it in the endğŸ™ğŸ™ğŸ™and Your beutiful
Exugator	dont sell henry skillz
Steinar Freyr Kjartansson	Walkout 6 42 don â€™ t thank me
Mitchel Huis	I didnt watch it but i seen it Typical Skillz
TwistedMind	I don â€™ t play it i just reach gold II and stop because it â€™ s boring
Elliot Vasilakis's	SKILLZ GOT 29 0 GG SKILLZ TOP 100
Charl Visser	Bro inprove you bench so your rating go higher
Receding Hairline	Gold 1 20 9 overall Don â€™ t play squad battle anymore too many game Would rather focus on rival
Petar Knezevic	I got Firmino Gold 1 ğŸ˜„
Skeleton Jim13	I packed Alex Sandro from silver 1
The Fifa boys	I got Thiago in one of my pack for squad battle pack I only got silver 1 since I m focusing on getting FUT champ
John joe Forde	Squad battle are so boring to play imo
ActivistM17	Appreciate the kind word brother being a Leicester fan it mean a lot â¤ï¸
Kwaku Boateng	Got Elite 1 in Squad Battles Silver 1 in FUT champ Got Van Dijk Alisson Douglas Costa
Brahmas4	Now that you point out that that â€™ s your name I followed your team before I think you should change your online back to AA9skillz
Johnny Playz	Blanc obviously
Josh	Yo skill straight up mbappe and gulliet
Amr Abdin	What is wrong with your bench
Moaaz F	Mbappe and Gullit for Henry and Blanc
Killing Joke	Geh gullit and martial if please
Sh0cKkK	I played SB for 2 week got elite 1 both time but i don t play anymore because it just so much BS
Charlie Latham	We love you skillz whatever you doğŸ™ŒğŸ™ŒğŸ™ŒğŸ™ŒğŸ™ŒğŸ™ŒğŸ™ŒğŸ™ŒğŸ™ŒğŸ™ŒğŸ™ŒğŸ™ŒğŸ™Œ
Nathan Preshous	Your pack luck is insane this year I haven â€™ t had one walk out this year best player Iv packed is blue depay worth about 80k
james lonergan	AUEROOOOO I swear you ve never seen anything like it so watch it breath it take in Best premier league moment like if you agree
adele williams	I don t play squad battle cuz it make me worse
Jacob Kotey	I don t play squad battle cause the AI make me triggered
Cathal	Sabrina The Teenage Cat you crack me up man ğŸ˜‚
AJC_Studios	Sell Henry and get guillet and mbappe
Yeah vh V Same	Get mbappe and gullit
Ryan Little	Love this guy â¤ï¸
Liam Wootten	The most humble mother fucker there is GG skill you get everything you deserve mate keep up the good work ğŸ”¥ğŸ”¥
Daniel Johnston	How long did he go to the shop for
Joseph Green	why would anyone dislike this vid shame on you if you did
Stahlz_XI	BLANC OUT GULLIT IN
Aaron Lee.s	Sell neymar for bale or mbappe
memeseum	You should sell Viera and Blanc and get gullit play him at CF and get a midfielder
Maty Krimsky	Dude how about switching up the formation a little selling Neymar and trying Messi
Francisco Santos	elite 1 in sqd battle gold 3 in the wl all the best from Portugal Carrega Benfica
Maxy Boi	Get gullet
luger bims	elite 1 but i only got 84 fabregas life great
DJR Fifa	Squad battle r boring
adel baalawy	He got 29 1
AbderrahMane Ridouane	skillz and respect for the booyah just humangous
Gabe Curry	This is a sick series so far but maybe it â€™ s just me but I like the early grind of fifa I often delete my club after a couple month because I get bored this year I am enjoying the game more than previous year Essentially what I â€™ m saying is bring out poor man road to glory
LEGENDERY GAMER HD	Skills get 50th in the world trust me I know
quint brugts	8 54 ehm Wanyama commmmee onnnn
NBXX_	Started to play squad battle today and last game I got rekt co that ai wanted me toğŸ¤£ğŸ¤£ğŸ¤£
agatecoronet	What happened with leister
James Starmer	We click your video because your humble and a normal person who treat everyone a equal kool dude and good influence and roll model to people people say good thing happen to good people and your good person so you deserve it all
zizonectar	Nahhh bro don â€™ t do it
Filip Larsson	Bland for gullit
Ahmed Ali	I got Kante from Gold 1 reward Can â€™ t believe my luck
Sean Stewart	Blanc for gullit skillz also seem u wa 93rd with 12 min left said u got top 100 just scraped it though ğŸ™ŒğŸ¼
BC 7	That â€™ s why we watch you it â€™ s because you try your best for u and show u some great content with amazing reward
Amin Chihab	My best is elite 1 I only played friday saturday and sunday 42 000 point I aways do gold 3 tho Dont have time and fut champ is better reward
Krsna Maharaj	Sabrina and Riverdale is actually pretty neat
Shane Doyle	Hold skillz you like 35 and have never heard of sabrina the teenage witch till now hahahaha bro I watched the shit when I wa like 8
Costarican107	This week I could have gotten gold 3 for the first time But I lost 4 game in penalty
Shaunak Rama	Your daily uploads is genuinely what make my day you are a GOAT
Dec Digger	Sell blanc and Henry and get mbappe and gullit so neymar get full chem
NorwaySkillKickers	I got Silver 2
TJ	I know I â€™ m just one of just 1 7 million sub but I can honestly say you â€™ ve effected the way I play FIFA in a BIG way Whether it be people pack or even scheme you have involuntarily had a hand in my thought process We should be the one THANKING YOU And keep listening to your girl she seems like she keep you balanced homie
Toby Buswell	yes sell for gullit
Alper Yaldiz	0 00 0 02 autotune ğŸ˜‚ğŸ˜‚
Cory Greiser	I â€™ m struggling Any tip on tactic or formation
aydan brownlee	So is ronaldo getting a inform on Wednesday
Tobias Risberg	I got gold 3
Marcus Jacobsen	Nice vid love you bro
Jack Bishop	Sandro is not insane
M	I happy with gold 2 lolğŸ™‚
Calin Dodut	i don t play squad battle because the offline is boring and too hard for me haha it seems overpowered i d love to see gulit in that team and i love mbappe too
WZOG	Did he say Wanyama at 9 00 Im Dutch and you pronounce his name a followed Vi nal dum
crazy bob	SB pack are always shit never even got a walkout out of these
Fino Does	I try to play squad battle but I get so bored of the AI going to ultimate and fisting me
Conor Anderson	i â€™ ve went 14 14 3 week in a row nowğŸ˜‚don â€™ t bother playing the last 2 game because it won â€™ t change my reward
Ian Jowett	I play it but only a few game to get gold 1 just for a few pack most of the time it feel like everything go for the Ai so I cba too play too many
J Randum	Elite 3 in squad battlea
Rebellen007	Ez worth I got Elite 1 and I unpacked Mertens and Boateng
DarkShadow4502	I don â€™ t play squad battle because of the scripted 45th minute goal
Daniel Rivas	I don â€™ t play squad battle cause it â€™ s so boring and frustrating This fifa in general trash defending inside the box shooting trash Plus I have to grind a game where the ai get most possession from stupid bounce can hit longshot from anywhere Meanwhile my player act stupid don â€™ t know how to pas and like playing how many time I can hit post And then I get no board 2 week straight from elite 1 reward That â€™ s why I don â€™ t grind squad battle
Nathan Littler	U r such an amazing person skillz and I flipping adore watching ur video keep these amazing vids coming brother
Jose Prado	Skillz you can entertain u both way if you really think we prefer a squad battle top 100 over you competing with pro Do a poll that simple
Gamebazen	8 55 did you just call wijnaldum wanyama ğŸ˜‚
Ollie Cooper	Leicester season ticket holder here bro Very sad time for all involved RIP ğŸ’”
Gaming xXSAMXx	How do you get the pre order pack everyday
carlos zammit	buy gullet 86 overall instead of blance
knuckleballerz	My team is 442 normal Neuer Blue Vrsaljko Koulibaly BOateng Alaba Callejon Hamsik Veratti red Di maria Mertens Weah PSG I do swap icardi for weah straight away Any upgrade I should make
Brian H	Played my first weekend league and only managed 11 win went 7 0 then couldn â€™ t get a win to save my life ğŸ˜‚ğŸ˜‚
max vanneste	in my pre order pack i got buffon en team of the week fabian and mousa dembele
Gavin Doyle	I got 2 10 in the weekend league but it wa my first time in it so I â€™ m ok with it ğŸ˜‚ğŸ¤·â€â™‚ï¸
jshela	I snuck into elite 1 squad battle
Luis Da Silva Gomes	you say bro and baby like every second word
Chase Gauldin	Messi
aLLx Co	Surely Blanc for Gullit
DLH	sell blanc for gullit
Agent AKE	Bro I got a legit Ronaldo no lie from a pre order pack I swear to heaven and hell
Temperr	Yo skillz this fifa or next you should make a squad battle 2 glory where you start with a bad team and make a good team with it
Sam Lucas	I managed to hit 33rd in the world this week for Squad Battles best player wa Max Meyer HIDEOUS
joshua khan	2 40 white chick lmao
Joe Eaton	29 1 there â€™ s the math
Tolu Akiode	Went from 18 2 to 20 8
Erlend Johnsen	how is the monthly now
ABOLFAL ASADIYAN	Sold Neymar and buy if Mbappe
jamal caesar	GOT AGUERO IN MY SQUAD BATTLES
Guilhem BollÃ©	I m watching Sabrina a well lol actually a good series tbh
Maank 13	Courtois let in 5 goal in one match and Kepa only let 4 goal this seaosn And Courtois is shit they need Karius
RVMP_Reloads	I played a little bit of squad battle and got gold 3 and packed an inform
Kingkomodo 576	What ever happens get hulit
CC77gaming	I ve stopped playing sb because I don t have time and It make me worse online
Shayur Badal	WAIT YOUR GIRLFRIEND MADE YOU DRESS UP AS BOWSER THAT S AMAZING I WANT TO SEE THAT
Javier Villavicencio	Tell me how I saw the competition on squad battle ending I played two game on legendary and the reward were a halloween card and a bonucci lol
Ben Holm	keep henry
Kevin Hounkpati	Skillz hope u read this I don â€™ t play squad battle cause my level go down when I play online
Angry pug	Thank u that mean a lot about the manger
Rianardo Adel	Sell blanc and buy gullit
Josef Wells	Ur an amazing person skillz I have a season ticket at Leicester and me and my dad we â€™ re travelling home from the West Ham game and on Twitter my mate got tweeted that vichais helicopter crashed and where just sat there in silence thinking is this real We all appreciate the fact that u mentioned ur condolence and RIP Vichai ğŸ’”ğŸ’”ğŸ’™ğŸ¦Š
Lil J	he went 29 and one ğŸ˜‚got 77 Ls before the fast forward type thing then ha 78
IMPRM	Really the â€œ insane walkout â€ wa Sandro ğŸ¤”
Laengersen	I play squad battle but only on easiest difficulty so I can score 5 goal put the controller away an do other stuff meanwhile ItÂ´s enough to reach elite 3 or gold 1 each week
yassine 55	29 1 GG
C & G Productions	I dont play squad battle and FUT champ because I cant afford the game rnğŸ’€
Joel Harrison	If it ain t broke don t fix it
Sam Morrissey	I got gold 3 in fut champ
Dean Tiggelovend	Don t Sell Henry
Jivan P	I got desailly from silver 1 squad battle no lie
PufferRaz	Hot sane in my reward
YOMISAGE	yo fam love all the way from nigeria
Callum Anthony	Easy to say it â€™ s worth it when you don â€™ t work
TeCh KiwizZz	I play squad battle because I suck and it â€™ s fun because it â€™ s challenging for me
Jonno Hicks	I don t have much time to play Fifa so I usually play until I get gold Because I grind rival
TegicTV	Only the real OGs remember Sabrina the Teenage Witch
Mr. Arbaz	We love you to
ph	Bro i just got a gold pack and in that there wa a 75 80 rated player pick and im like yeah yeah classic gold pack and in the player pick there wa SCREAMER DENAYER A SCREAMER IN A PLAYER PICK OUT OF A GOLD PACK
Zack Syndicate	I love your video dude
Finley McCann	14 16
Fred The Red	15 15 in fut champion Yes I know i m bad
Chorn Heng	He get 29 1
PCG FINCH	Never seen anyone more thankful of the position he â€™ s in more than skillz He deserves to do YouTube a a job coz u can tell he love what he doe
Dino Avdic	Bro hug
I_am_that_guy_95	We love you skillz
Ito Alvarez	Gullit Yes please
John Clarke	Did i go back in time when watching this video Skills watching Sabrina haha Duuuuude
Sean Walsh	Wish I had time for squad battle
Eoin Coffey	Ur fye
Danny Linehan	Sell blank
Jelle Olrichs	Watch the video on my channel I packed RONALDO in a two player pack
Atta Rehman	Love your video man you and Nep both Pretty average player here I got 14 14 in weekend league Used to play squad battle earlier but the furthest I can go there is elite 1 so for me it â€™ s too much investment of time and the reward aren â€™ t a fruitful a they are if you play division rival or the weekend league So I prefer just competing in rival and the weekend league
100 subs without uploading	Set up your own pro team you could give young talent a change It would be sick
Rev te P	Hi skill i had the best wl ever with bad server i made it to gold 2 I also play sq battle elite 2 is my usual rank Its free coin and pack
santie hoorst	In end elite 1 in sqaud batlles
Berislav Ivkovic	You went 29 in 1
Will Warren	Thanks skill I m a Leicester fan
mr gamer	Blanic
Kiran smith	Inform mpabbe only We only accept excellence
Antonio Cruz	I used to get silver 1 in fifa 18 but now I make it to gold 2 ğŸ‘ŒğŸ½ğŸ‘ŒğŸ½
LGF	Skills love u bro u inspire me to play more Fifa just to have fun so I play Squad Battles and I â€™ m saving pack for toty
arun rowlandsa	i play squad battle but never get top 100 it feel so fixed
OAMIS	I love fifa but don â€™ t play anymore since I can â€™ t afford a ps4 Portugal Lisboa
samks04	I don â€™ t play squad battle because offline is boring and for some reason I lose but I â€™ m pretty good at online
leothemagnuv	8 53 you named wijnaldium wanyamağŸ˜‚ğŸ˜‚
Sam Craney	I would play Squad Battles just dont have enough time
JH23	Went 25 5 in the weekend league best finish this year ğŸ˜„
Fred Wright	I got 14 16
Zia Ul Haq Hamidi	I finished Elite 2 even I lost an ultimate game while I wa winning 2 0 in 25 minute that s 2200 point and lost 4 other game other wise I wa near Elite 1 and Sunday morning I slept at 5am to finish my game
Turki	DOOOOOO IIITTT
Marcus7	Thank you skillz ğŸ’™ğŸ’™ğŸ¦Š
soccerkillers2313	Love that he â€™ s so humble man
Twitch_ Shazam	I play squad battle coz ok not the best at the game and I can â€™ t afford to buy all the extra so I â€™ ll like the pack and coin but I only get gold 1 and that â€™ s the best I â€™ ve done so next time I â€™ ll go for elite 3 and it â€™ s good that I get to see if it worth it watching a YouTuber that doe it a well
Dwight Schrute	why do player put good attacker at cm
Connor Brown	Please just do a poor man to glory we all want it Like if you want the poor man to glory
Ollie Allen	I â€™ m a Leicester fan thank you for your thought skillzâ¤ï¸
Madhat Messi	Man I love you you â€™ re the best
Irvin Gonzalez	Skillz is into that kinky Mario shitğŸ˜‚
Ry Thompson	Went 19 11 in weekend league
I AM TYLER	blanc anyday 4 gullit
Joshua Dunstone	29 1 is a madness
oli oli	the word insane is there u know it â€™ s a good video
Shuja Rasheed	Blanc for Gullit
Wake Apollo	When is the poor man coming
Jeremiah Walker	I went 14 10 this week in fut champ I don â€™ t ply squad battle because I don â€™ t have time during the week
Theo Paul	Don t remind me about the Aguero goal ğŸ˜«
rodolfo calderon	Rich man to glory More like Cheap man to glory xD All joke skillz
Sean Paul	Blanc for rudd like so aa9skillz can see
Marcos Ortega	I don t play FIFA anymore not worth it
Antonis Lainakis	Elite 2
SoRRy's Clutch	You did 29 1 I did the math
X MKG	Alex sandro go for over 200k on pc I hate the pc market place
Kairos	Guys when do you get ur fut champ reward
Viktor Palmgren	I got 13 17 Dont bully me
Dean Browne	So inspirational skill love it bro
Fxyaz :',	Sell blanc obvs
Sam Ovic	Sabrina ğŸ˜‚
Phawy	I got lukaku in gold 3 hahhahaha I played like 6 game
ITZ KELVIN	Do i suck I got 13 win in weekend leagueğŸ˜ŸğŸ˜¢
bassman 2008	mate alejandro alex sandro ale ale jandro alex sandro mate
Ayoub El Hadrati	Do a road to glory poor to glory
jude dicko	Skills have you tried Stevie G
Ivan Dariksonn	gay ya
xd Kailo	Got 14 26 Im so badd
Blxst Power	Poor man to glory No one can relate to having a god squad
mol van der merwe	Buy lampard
Ur AverageGamer	I would like to play SB but it seems like the gameplay changed i could win every game 3 4 0 now i can barely win and lose 1 or 2 game per set on legendary I can t seem to attack and the AI need one fricking shot from 25 meter and score
Jake Feasby	Yo Skillz I absolutely love FIFA but I can â€™ t afford I â€™ m not aloud to go FIFA 19ğŸ˜¥ Any tip that I could get to improve I currently play FIFA 18 squad battle on Professional difficulty but I can â€™ t seem to improve How can I get better It would be great if you could replyâ¤ï¸ğŸ˜…
Madhav Ganesan	Well you sold Mbappe and Thiago Silva
Matthias Lauwaert	Just keep the team a it is Do fut rival and fut chamions 2 or 3 week and you will have the coin for him Then sell blanc and keep the coin from blanc for future potm
Edward Kitchin	Can someone tell me what that background music is plz Cheers
Mohammad 81105518	the pack opening are pre recorded Lol You would skip the promo pack and your hand are in the air Seems legit Same thing happened with the first top 100 reward
Demize UK	I want the normal RTG now
Funny Fails	Of course you blame her you â€™ re just bad A
Jimmy Moralws	No legacy defending
HardCoreGamerGR	I play squad battle every single week and get Elite 1 I just enjoy playing them and today I packed marcelo I think every week I m getting a walkout out of squad battle reward so I m happy P
Luke MG7	I packed courtois out of silver 1 squad battle reward
duykhanhle99	I play 3 4 Games of Squad Battles every Week to reach Gold 3 and get them free coin and pack But yeah offline is boring imo so that â€˜ s why i only play 3 4 game
Pedro Silva	Mbappe Henry
Joshua Bavin	When I play offline game I get bored and i stick on bad education a it funny
Nils Reinecke	Henry for Gullit you â€˜ d get the same result with IF Mbappe and Blanc is your only really defensive minded Midfielder who stay back which Vierra like you said doesn â€™ t do
Velocity 17	Hi skillz probably won t read I m a Leicester fan and I m devastated I come home from school every day and watch your vids Thanks for mentioning u Leicester fan in this terrible time
Big Badger Tv	fut champ 17 win squad battle elite 1 easy free money Boyyyyyyyyy
Dhruv Sanghai	Yo skillz don â€™ t do a poor man rtg do a schoolboy â€™ s rtg where you can only play an hour a day Monday to Thursday and 2 hour a day Friday Saturday Sunday
IHateEveryoneLots	Mad respect for you a a person Skills So happy that you re smashing this FIFA
VenTionPride	I can tell you why every one watch you you and zwe you guy are just too nice and your video are fun to watch I mean you go 30 0 and you still think you are bad that is how nice you are I guess and I believe most of u here have the same feeling towards we would like to have you a a friend you know the closet thing to that is watching your vids and I just enjoy it
Geoffrey WANE NDEMBO	Sell blanc and get gullit
SÃ¥ de Ã¤r Nice Noel	Like to pack a Icon
Troi Qendro	Sell viera for buy firminio and blanc for gullit
FJ	Most passionate creator out there your video being uploaded are the peak of my day keep it up and never change do what suit you If you don â€™ t wan na play pro don â€™ t play pro You owe u nothing we all owe you
Lewis Summers	Yoo skillz for my squad battle reward I got mbappe and Halloween dost
Yari	Skills show u some full gameplays of your squad battle
pim majoor	Got elite 3 in sb And packed Firmino van dijk And Matuidi
INCREDIBLE MRE	Poor man to glory pls I loved it last year and I ding the rich man rtg quite boring
Bruno TVS	I got elite 2 ğŸ˜”
Abdul Rahman	Playing AC Odyssey and Red redemption 2 Like who else
sean iiams	Me and my wife just started Sabrina it â€™ s not a bad show
hussein Noureldin	MO SALAH SUPER SUB
Zakaria Hmida	Bro bring in prime ballack for 1 1 mill
Igplayz	Why doesn â€™ t skillz get mbappe swap him with neymar put neymar left wing and get Henry â€™ s striker card and sell all the rest Like so he can seeğŸ‘
Adzz	Lol top 100 squad battle is the same a gold 3 fut champ except for coin and fut champ is so much easier
Lorem Ipsum	You should do more than 1 team it keep it more interesting than the same player and icon every time You got enough for 2 team
Benji Galea Souchet	Get IF Alex Sandro PLZZZ
its -rafa	I don t play squad battle because it s boring I would like to see squad battle online some how
Ashley Butler	I listen to the true geordie podcasts when playing squad battle
Jamie Raffan	Your not ugly bro don â€™ t put yourself down like that
The Memezter	11 19 last week i wa 9 21
Ben - Plays	Sell blank
Alfie Partner	Skillz i watch your video whilst playing squad battle haha i â€™ m doing it right now
Zack B.17	Thanks for the support skillz
SooRooJR	Yes Sell Blanc and Henry and get Gullit IF Mbappe
IH8U	I finished 13 4 didn t get to play all of my game ğŸ˜«ğŸ˜«
yassin zeamari	Transfer 69 hahaha
MCH BMX	blanc get rid mathius to good
Jacob Willems-Jacobsen	i thin gullit is so much better than black and mbappe and henry are close to same and then you could play neymar at full chemestry
Anej Horvat	6 04 talking about El Clasico To all my Leister city fan
Razvan HD	I got silver 2 in fut champion 1 game away from silver 1 and in the final match i lost in the 120 4 minute and i lost silver 1 SAD ğŸ˜­
james mitchell	Do you play ultimate or legendary Great vid btw
Ruben Vanwelkenhuysen	I place myself in Elite 1 every week and I think it s totally worth it I learn how to defend better and the reward are pretty decent Keep up the good work bos
Joshua Lewis	Great content skillz Thanks to you for being such an amazing youtuber Watching from England
teaarmo	Got mane in elite 2 Not too bad
mjacfc	He went 29 1
purple hand gang	He got 29 1
The Asperger Gamer	Squad battle Playing only on World Class Can not take the AI BS anymore Legs that bend criminal tackle and no foul bronze player scoring from outside the box with 20 rated long shot the AI having 27 possession with 1 shot on target and win the match Squad battle is so rigged World class 20 match a week Elite 3 That s it
SundayLeague Freestylers	dont have time
Afrim Ademi	Do not sell thiery henry and blanc for guilet just keep grinding and you will get guilet normally
SpiRiT x	No time isnt fun not worth not playing sb
Novalone	Don â€™ t sell Henry
mxl	I already look like bowser without a costume ğŸ˜‚ğŸ˜‚
Ian Quigley	I can â€™ t access ultimate team so I don â€™ t play squad battle like if you relate
Jaak Patat JR	Get Eusebio
Prince of Hallows	sell blanc
FuzzionPlayzYT	Yo Skillz this weekend league wa my 3rd ever this Fifa and I made gold 1 with a decent epl team ğŸ¤—
SniperQ8 HD	â€œ I didn â€™ t t watch it but I â€™ ve seen it â€ Skillz 2018
MOBTASIN FARDEEN	Skillz gave ageoro s example Me a a united fan ğŸ˜¥ğŸ˜¥ğŸ˜­ğŸ˜­
daniel warren	If I have a bad day and u post it make me happy
jgh 98	Can u do formation and custom tactic video please
ADF	â€œ Sabrina the teenage cat â€ ğŸ˜‚ğŸ˜‚ğŸ˜‚ skillz had me dying with that comment
Premier League Streams	You got lucky af
Max De Hon	Yes get Gullit the 90 or 93 rated
Jeffry Jeff	Wait Sabrina the teenage witch Bruh
AO7 SPORTS	I would try it and if it dont work just but the others player again
NinjaDemon84	no dont sell Henry
Jrutr Man	i am poor man to glory and squad battle is best for pack got manolas for 20k
carlos cervantes	Squad batting is rigged AI won â€™ t let you score no matter what Players slow down Hit the post ton per game Momentum is back again
dansmusicproduction	I can easily get elite 1 squad battle but don t have time I got 21 win in the weekend league but only played 25 game
Tomas Gonzalez	16 14 and i started 2 8 but listened to your advice and turn my whole weekend around Thank you Aa9
Olly Pryer	My mannnnn skillz Keep going all love there â¤ I ve supported you since long time And watched you progress Its amazing to see where you are now
Comedy pro' Gamer's	I dont play squad battle because i can just play 1 5 hour a day
garl ole	Buy Eusebio
jackane de jonge	i play squadbattles every day but at fifa 18 i played worldclass highrated team and legendary now i struggle with pro and high rated team i struggle on semiepro EA take away classicdefence and i m use to that So EA give me back classicdefends
Matrix JW	i got 14 win one off half mark squad battle is boring for me
Jamie Smith	Don t get rid of henry
Kideen Owen	I â€™ m a big fan bro but why have you got a CDM in striker
Daniel Hansson	21 9 in the WL My best weekend this year but man my internet is shit Would have gotten elite 1 if it wasnt for my internet
HÃ¥kon VassÃ¥s	I love you to
Connor Hewison	I don â€™ t play because this game is so inconsistent and shit every time I feel like playing a game I do then I feel like breaking my controller and I get so close each time
Arjun Bakshi	You got 59 and 1 in 2 week and you don â€™ t wan na be a pro you for real do some football talk on barca v madrid
vegastjg	So now you re allowing your gf to hurt YOUR CAREER
Raiyan Choudhury	â€œ I didn â€™ t watch it but I seen it â€ skillz
Eirik Rygg	Record in WL 17 11 2 game remain
xAsterTheProATP	I dont play squad battle cause i dont have fifa 19
gabriel hardwick	Go pro and be a content creator
XStingingRogerX	A pack is a pack I play them
Feliciano Torres	How do you get so many point
Aditya  Sreekumar	ripvichai
Joostg 23	my record in WL wa 17 13 it wa my first WL bc I never have time for it bc of school and stuff
Sam Sam	He get 30 0 in Fut Champs I saw it on Castro â€™ s live stream yesterday
Nenad Stojiljkovic	Gold 3 14 7 And stopd playing a always i like gold 3 and dont wana gind and hope for more it cool for me
Callum Taylor	Won 14 lost 8 and got PlayStation took off me for a week ğŸ˜­
××™×ª××¨ ××¨×“	Skillz I m w u in every decision u make bro ur by far the greatest fifa content creator up there Keep it up man you always make me smile
kenj0	PMRTG Squad Battles Elite 1 ã€‹ Messi packed
Lewis robertson	I GOT gold 2 squad battle I GOT inform martial
Diogo Pinto	Gullit and SÃ³crates
Kevin S	I love skillz Such a hard worker and always doe everything for his audience
Diptangshu Ghosh	Spoiler alert 29 1 this weekend
Luke Hathaway	I don t play squad battle because EA are a joke one minute you win 5 0 the next the computer score 3 in 3 minute and you can t win And I won t be playing FIFA anymore because the game is an absolute joke it s awful
Bradley Haggins	How do you have this much time top 100 squad battle rank 1 reward top 100 fut champ and draft like it must get so boring
barzi barzan	Sorry for spoling 29 1 LOL Keep it up skillz
HusBus97	28 27 30 x 114 85 x 114 114 85 29 Congrats 29 1
Sasa Despotovic	get gullit and mbappe
Simon Svensson Engelbrektskolan 9E	he got 29 1 in weekend league you know i can math
Jeepa	You should start a rtg without spending money like you did in FIFA 17
Tommaso Gilardi	He went 29 1
Mayank Gupta	There are a lot of good player doing CHEAP RTG I don t get why people just stop watching and go there
Michael Kenny	I look forward to your video every day keep up the good work looking forward to the next one
Erikgerrard 03	I â€™ m watching you while playing squad battle
akheel X'O 97	Silver 2ğŸ˜©
S Speed	poor man to glory please
Rl Relentless	First fart ReeÃ¨eeeee eeeeeeeee e e see e e e E e
Marin Marinov	Yo skill because of your tip for Squad Battles I managed to finish Elite 2 for the first time and i got Luka Modric and James Rodrigues Thank you bro you are amazing
Chris Ewart	Weekend league 2 28
A10 M	Skills PLEASE put position modifier on your player Mad team but not being in correct position trouble me lot of love xx
Xday -Battlefield	Wtf i watched this video yesterday
EmillioFS	Sell blanc
Tom van Asperen	In Squad battle i missed elite 1 by 1000 point
Barnsley Fc Vlogs	Great vid skillzy
Oliver Beniston	30 and 0
Boo B	Sell blanc and Henry for 88 gullit
reeshad12	Its not free lol Its sooo many game for it too much time
Aristeidis Kountouris	he got 29 1 fut champ
ryan harvey	Brazilan juve MARCE SANDRO
GraÅ¾vydas Jukna	Where is the real RTG
Randall Miranda	I have been watching ure video since career mode I got Gareth Bale 420k and Alexandro 110k in my Elite 2 Squad Battle reward ğŸ”¥ğŸ”¥ğŸ”¥ğŸ‘ŒğŸ‘ Shoutout from Portugal ğŸ’ªğŸ”¥ğŸ‘ŒğŸ‘âœŠ
Lewis Eldridge	Blank
Razorshrp17 TTV	Coincidentally I got a gullit in a 7 5k pack today ğŸ˜Š
MrItara	Hi I ended gold 3 in fut champ with like 6 game missing and elite 1 in squad battle but i still loose alot to the AI lol
joshua khoo	Please get MESSI
RHINOGUY D5	Sell blanc
ABHISHEK NEGI	29 1 nice
Mustafa Waseem	Skills martial will probrably get potm and you should do it
Matt Deez nuts	I hate how cheesy the ai is it feel like they change to ultimate just to beat me some game
RJ Hacker	you are so stupid why u always say im a bad player and u got 13th
mostwantedskn	My man
Ajay Sefu	It â€™ s good to see you happy bro forget those trying to change your content stay winning
Michael VaÄ¾ko	try Messi
Jurgen Games	sell blanc
Trishant Puviranjan	My nigga
Colin Burgiel	Hahah went 11 16 in weekend league because of Halloween with my girl ğŸ˜‚ missed a few set on squad battle too ğŸ˜‚
Malthe Soelling	BLANC FOR 90 GULLIT
TommyGplayZ	Blanc for Gullit put Blanc at CB for Varane
DJ FireWave	I m 0 30 in my first ever fut champ am I doing something wrong
Maksim Vuksanovic	I only have enough time to get to gold 2
Dylan Ashmore	Get Roberto Carlos Amazing offense player and great defender
KylianB	Get gullit
TadGaming 1	do the hazard potm
Giga Ware	I dont play sb because i dont have time
GekZijnIsGezond	my record wa 14 9 didn t feel like playing for gold 2 so i m happy with it
Dion Abad	I went Gold2 this Weekend i â€˜ m fine with that ğŸ¤™ğŸ½ğŸ¤©
Mateusz Zych	Buy Seedorf
Jonatan Austad	GET FIGO FOR HENRY
Frank Taylor	I just find squad battle hella boring
Nathan Hollow	If you want to entertain u then give u poor man to glory we don t care about t100 reward or seeing good player It s fun to go side by side in not spending a single penny on the game and going through a struggle to get good placement in champ I have a feeling you re wanting to go pro no way it s because you want to show u these player because you change like 1 or 2 player every week
Sebastian Wike	Love you Skillzâ¤ï¸â¤ï¸â¤ï¸
Luuk De Busschere	buy 88 seedorf
Connor Charleston	I don t understand why offline is frowned upon Even when you re playing against an actual person 10 11 player on that person s team is being played by the AI You have to understand the AI more than the player
Robin JÃ¶nsson	Sell henry and blanc get gullit and mbappe
Callum Josh	Loving these videosğŸ›‘ğŸ¤Ÿ
Leonardo Ribeiro	I packed Neymarzito on elite 3 SB reward So free pack are worth 100
Samuel Brennan	I use to play squad battle when I didn â€™ t play online but now I play online I just get way to bored playing offline game
SuPerGunZ	LoL Sabrina the teenage witch Ain t that show a million year old From Old school tv show that s so Raven wa dope
II_Tone_II	Recently found your channel you re the man Pulled a baby Cruyff in my squad battle pack Gold 3 crazy Finished 15 15 in the first weekend league i did keep doing your thing
Kazi Mashiate	Would play SB but got no time
Daniel Cullen	I just packed sane and Halloween kalou from my pre order pack
Alexander Bradford	gold 2 in poor man to glory squad battle dont have time coz of school but dont feel the gameplay a fun a online even in holiday
Sonic and rainbow dash Gamer and plash	i want poor man to glory begin
Mw246 S	Skills got 29 1 nepenthez said on his Twitter
Rasmus	I finished 20 10 this week Worst start to Fut champ but came in clutch and finished gold 1 for the first time in Fifa 19 I don t play Squad battle It s just too boring and i feel like i play worse online if i play offline
Jack_1808	I wa 17 win 2 loss then I played against an insane team with 90 henry ronaldo messi bale sol campbell varane courtois etc then after that game I finished on 18 win 11 loss xD had an absolute mare
Conor Cleary	Is there anyway you can get a face cam for your game highlight because your reaction are priceless and make the series
Ozi man	Gullit eazy
paul cox	Keep up the fantastic video m8 Best fifa you tuber out there
Tyler Dale	If it ain â€™ t broke don â€™ t fix it
Topias NykÃ¤nen	I dont play squad battle because for me it s too boring
Filipe Valente Gomes	For once elite 1 reward were good for me packed Kroos Fabinho and Pjanic
Scout Hanna	I got elite 3 missed like 3 or 4 set
Simon Elias	I got Alex Sandro aswell
YesImCornish	I wa at 11 win with 14 game left in the weekend league but I couldn t finish my game which is annoying because this wa the best week i ve had but it wa my busiest one yet too stayed up till 3am doing my game but couldn t do it any longer D
michael osornio	1 7 million of u help skillz show his potential in the game if we don â€™ t watch he can â€™ t rich to glory not taking anything away from him just explaining what he say when he say he wouldn â€™ t be anywhere without u thanks for everything skillz keep it up
Skinny Chilli	I play squad battle because my internet is AWFUL and the gameplay is way smoother and le of a headache for me offline
Romano Walthie	Sell blanc buy gullit Sell henry for now get mbappe Sell 92 maldini buy 94 maldini
Reece Mcmillan	I got lewa if in my
Kaya _04	I like how he go on about watch video while playing squad battle and it â€™ s exactly what I â€™ m doing I â€™ m playing squad battle while watching skillz
Aryan Jha	Pack Suarez in your ultimate tote pack and use your red mane in ur team
Xx_FastCurve _Xx	If hazard is still in sbcs you could sell blank do him put him at lw sell Henry and buy gullit
Rodrigo Ferreira	I packed inform martial in silver 3 reward
Robin JÃ¦gersen	Do the Hazard you will regret not doing him later
Mendi Pashkus	Im watching aa9skills while playing Squad battle
baldy mcdonagh	I don t like squad battle because I find offline boring My fut champ record wa 14 win and 14 loss
Miki _champ	Dont have time to ply Squad battle
Bernardo Correia	Sell blanc
Jackary	I â€™ m a Leicester city fan Losing our owner is dreadful Condolences go out to the passenger and pilot RIP Vichaiâ¤ï¸ onto the future you were a huge part of the club Vichai Gone but not forgottenâ¤ï¸
AHO jj	buy roberto carlos
Abhishek Mehendale	Don t sell Blanc please he s key in your midfield bro don t make that mistake yo if u really want gullit sell Matthaius for gullit like for like sell like if u agree m8
Max Conrad	29 1 right
SaÃ¢d SQ	he finished 29 1 this weekend
Axly	6 46 walkout
Dylan Moss	mbappe guilit neymar prime
Lior Tal	What about fifa 19 ps4 rtg
Fighting Athlete	Last week I packed inform alex sandro from squad battle reward 100 worth it
FaintCrawdad321	RIP Vichai S LCFC
Beni 2K	He went 29 1
Jazzy McKenzie	Do you recommend bronze pack method if you only have 10 000 coin and bad player
Pure_ Savage	Change your play style and try out messi
Akh Shurra	Sabrina the teenage cat whaaaat
Gustav Sparup	Why always the same background Music
H FIFA	Please if you can go to any fifa tournament please for u go and we will be supporting you
Dennis Iliopoulos	hey skillz sell blanc and get prime ballack look at his stats he is goatarinooooo
Miguel Abrego	Squad Battles are just too boring I just make sure I play some match on Legendary just to hit any gold and get a couple free pack but other wise who need SB when you got Rivals and Champs
Adfer r	I don t play squad battle cause it s too many game I can t keep up
Alfie Matthews	I only play squad battle cuz my internet to doo doo
Jack stamford	professional and world class are to overpowerd for the point you get and is boring I usualy get elite 2 not worth it for
Tim Aalbers	Ajax beat Benfica in clğŸ˜
ryan dol	The squad battle top 100 reward is gold 3 reward in fut Champs bruhh
George Goodyy	I play Squad Battles for the reward averaging gold 3 every week of fut champ and rank 2 rival so lot of reward from different game mode every week is worth it
Gabriel Kojan Meisingset	Could u start a Road to glory without using money plz Like if u agree
Connor Jay	I got gold 2 and missed 3 set I think I can get into elite if I play all the game
Fares S.H	He got 29 1 damn
OhSnazzy	I got elite 1 wich is 2 rare mega pack and my best wa morata lmao my pack luck is so bad this year
QXD NInjA	Keep Henry
corey last	Skillz your description of Sabrina is the best thing ever I love you man keep doing you and absolutely bossing youtube with every uploadâ¤
Whip Tag	the teenage cat wtf
Amaysing1	Blanc would have to go before The German machine
Khaled Ayadi	Been a fan since fifa 14 man â¤
RobinsonLuke	14 27 we click on your video because your classğŸ˜‚ğŸ˜‚
Callum Dean	Skillz you â€™ d kick as in the pro scene
Julian-Specific Sportgames	Great video skill i packed messiğŸ’ª
JSD skills and more	Hey skillz Love the channel and love watching your content I can see you killing it in fut champ atm and wa just wondering if you could drop your tactic player instruction etc in a video to help me improve the way I play fifa
JoeProGamer	Hey just wan na thank you for all the tip you â€™ ve given me I wa a trash player that couldn â€™ t get more than 3 win in fut champion I â€™ ve seen all your vids and listened to your advice and last night I wa able to get 15 30 win in fut champ I am able to upload better content to my channel Big thanks ğŸ™‚
Ahmed Nadeem	Buy Messi
Arthur Thompson	is their monthly reward
Jayden Dabral	wow i didn t get a board from elite 1
MT9 football FIFA	He won 10 out of the eleven game
Ryan Lombardo	Wanyama ğŸ˜‚
Kris88 SPARKS	I dont play squad battle cuz i dont have a console
KB BOOSTED	Use Finisher chem style on Neymar dude he s fast enough to not need Hunter
Uzair Siddik	dont play squad battle coz i dont really have time but i got bale from preorder pack soo it chill
Diogo Ferreira	I don â€™ t play because I don â€™ t have time
Teo Wei Lie	You â€™ re by far one of the best youtubers in the fifa scene keep up the good work
Hector Roberts	I play squad battle so I can gain fitness on my main team by putting them on the bench it great because i can gain fitness for my main squad and get free pack a well
6ixtian	My game glitched during fut champ check out recent video ğŸ™ğŸ½
Leon Allouane	Sell Henry and blanc
Latinshot	How can you be a football fan and not watch el clÃ¡sico ğŸ¤
abtinwizzy	buy roberto carlos
Ensar Baran	I dont play squad battle because it to much fitness for fut champion division rival and squad battle to much fittnes
Dylan Hayes	The pack are bad in squad battle compared to division rival I only play to like gold 3
Will John	Sell Henry and Blanc and pick up prime Ronaldinho and Frank Lampard
FIFAgromlingHD	You should 1 v 1 Castro I â€™ d love that you both playing decent
Borcovinky 17	29 1
Kylo	love your vids
rudy azhari	Everytime I watched your video it always motivate me Hopefully you see this comment
Pritish Karmakar	You are just a beast in this game Skillz don t go for a pro be a YouTuber
Mark Haven	If you qualify you should gowith your GF and make a vlog and add some sightseeing etc Make a seperate channel for it like spencer and alex do
Î£Ï„ÎµÏ†Î±Î½Î¿Ï‚ Î¦Î¿Î¹Î½Î¹ÎºÎ¿Ï€Î¿Ï…Î»Î¿Ï‚	Do the move Gullit Is insane
Parkin it slow	We need poor man rtg
Omar Valencia	I don â€™ t do squad battle cuz I don â€™ t got time
WhyMeBat 2	D
Hidde Elbers	Why do you have an hunter chem style on Neymar Thats such a waste
maxime bergiers	Weekend league i went 17 13
Alon Slom	Pls change your bronze on the bench to gold your rating will be so much better
Maximillian Pekal	I got gold 1 and LM bailey
Bravado Wass	I don t really enjoy offline to be honest Even though the reward are decent
Dan Courtney	Does anyone feel like they can â€™ t improve at the game I play a lot of fifa and a lot of champ but I always seem to end up in gold 3 and in every aspect of life you can say practice make perfect yet I play this game probably too much and can â€™ t improve just wondering if anyone else ha experienced this
Nicholas Martinez	Yo skillz keep Henry don â€™ t sell gullit is around 3 6 million and Henry is a game changer for you don â€™ t sell him man
BLACK MAMBA	MAMBA
Mukul Yadav	Get gullit and mbappe and remove mathaus and henry
antonio martin	I got 12 win in the weekend league but I happy with that cuz I got a shit team lmao
GTG KIRI	because offline is boring brotherğŸ”¥ğŸ¤˜ğŸ½
draft ok	Blanc for gullit
jacobsson 1	i dont play squad battle cuz is boring
Laskaãƒ„	I said that I wa gon na be determined to do squad battle and get elite 1 but it s so insanely boring
Artjom Suhoveiko	I got gold 2 in sb and packed a cheeky Tony Martial
Dylan Capparelli	Get mbappe and gullit
Harishen Rao	Roses are red Violets are blue Go get gullit And mbappe too
Kevin Duong	Hey skillz just wondering why are u always wearing the Aleti jersey in the thumbnail when u don t really wear it
Î”Î·Î¼Î·Ï„ÏÎ·Ï‚ Î‘ÏÎ³Ï…ÏÎ¹Î¿Ï…	C Mon
Nicki Mundev	Can someone please tell Skillz that his name is Idrissa Gueye and not Ghana Gueye
Zack Tranter	I only play a couple of set like 1 just for a few pack co it boarding
CaptainBlue 252	Where is the Poor road to glory A come on we wan na see that
Evyatar Levi	Mbappe and gullit for sure
Yon Andelman	Please do the Hazard SBC Don t know whether to buy him or not and would love your opinion or just do the loan
nobby goose	He got 29 and 1
Jonatan Osland	Do POTM Hazard He â€™ s the best player in the game for me
Jake Power	I don â€™ t play squad battle because I do believe it is rigged to a certain extent If the AI want to score on ultimate legendary they will score unless you can defend like Skillz doe
Wayne Mccabe	11 16 weekend league only started Fifa 3 week ago since 2008 ğŸ˜¬
Struner FC	Bestt YouTuber ever I wan na play a game against you â¤ï¸
Marco de Roos	14 win 13 loses in WL I don t play squad battle because it make me worse in online game because I get used to the AI in stead of online opponent
Jamal Rody	im sad cuz i packed ucl version of varan and sell him for 399k i should have kept that card
BigLarrikin Plays	Aa9skills â€œ I didn â€™ t watch it but I seen it â€ 5 58
Ben Hayes	Skills going 29 1 â€œ if it ain â€™ t broke don â€™ t fix it â€ ğŸ˜‚
the best channel	26 30
NightCore ~ TempZ	i m watching the sabrina show atm it quite good so far most people in my work are hooked on it
Not Wolfy	Only change to gullit if you could get if mbappe
Glody Mbenga	He went 29 1 I â€™ m guessing
joÃ£o Vieira	I would do it I would sell Henry and blanc and buy Gullit and gold Mbappe Gullit is a beast
Ryan Madge	I forgot to redeem my fut champ qualification chip Had all weekend to play a well Absolutely gutted It â€™ s silly that you can â€™ t redeem it when the weekend league is active
Ollie Clark	Squad battle is boring tbh and I don â€™ t have time especially playing the game alongside weekend league
Tom Wales	Offline is boring you cant make people rage quit and not good enough reward
Alexander Ramsay	What up skillz love the content Continue the great work
Edwin Blok	18 win 12 lose and not have time to sb
TheRealFatGreek	I don t play squad battle because offline is boringggggggggg
Elad K	He got 29 1 in fut champ
JSL 05	I mean that squad battle is borning
joel preston	Everyone saying do poor man he â€™ s done it 2 year in a row now he obviously enjoys rich man to glory and want to get more top 100 â€™ s so what â€™ s the problem
FragWas	Or sell Thierry anry and buy messi
Sabercats Nevarez	Sell Neymar and get Messi please
Gabriel Gomide	spoiler 29 1
