Danny G	Is there someone drilling your wall?
TW Dylza	I respect your content because you are not like the others and dont have editors etc
Uros Grbic	what camera settings does sklillz play on ?
Lewis King	Respect bro‚ù§Ô∏èüíØ
Twan van der Leest	Buy prime Gullit i have him to (90) and he is beast as you buy prime Gullit you are Gonny end 1st in the weekend league
In Gaming	Which camera does he use?
Siege	Uhh something weird just happens me and my friend just subbed to AA9skillz and I got 93 Eusebio and he packed Suarez!! I‚Äôm legit crying  LIKE ON THIS COMMENT AND YOU WILL PACK A WALK OUT
George Harsini	Just a question but do you have to time the button press for headers in this Fifa ?!
JacksTV	Skillz are u doing finesse shots when u are shooting from out of the box or are u just using the normal one
H -playz	Jeez he is committed
Yousif 100	Buy Nedvd
Jonathan Guzman	do what makes your happy bro ! at the end of the day thats why we‚Äôre all living.
j.R.o Reyes	Woo u suck.
Alex Nebrig	Audio not work for anyone else?
Michael Wilson	Hi Skillz i see your point with not wanting to play at the pro level but i feel like your missing the point i don't think it be about playing at a pro level just for the money or feeling of winning for that matter in your case id think it be about growing you as a brand getting yourself more out there
Irri Ales	Be real bro it is all about the youtube  money you dont give  a shit about fifa it is that you are a pro player and nothing more than that be real
Idontgiveafuckdoctor ?	Guys who should i buy manzikic informe, hugain or immobile!! I really need help!(;)
alfa dog	skillz could you please do a timed finishing tutorial video plz plzzzz
Killian Courtney	Is xbox better than playstation
Renzo Renteria	I love your content brother! Subscribed!
JAMES Ogilvie	Much respect üôèüëè
sam sony	This man needs money.... He still didn‚Äôt pay off his house, that‚Äôs why he doesn‚Äôt want to miss a upload.. No hate.
thevikingkris	Why don't you stream the pro tournament?
Finley Edwards	Get neymar if
F4TE	Great vid
Diego 7 Lamont	U made it 30-0
raheim you know me	AA9 I rate your grind and your quality at fifa keep it up for ya bros
Arul Uma	It was a good  choice picking up mattews but next time pick up pele
Tom Wales	do u ever rage on fifa
Infantino	What camera settings is he using
Truelsen	Legit you said 1 or 2 videos ago that you didnt play FUT Champs because of the rewards you play it because you think its fun to play. And now you are saying you play FUT Champs for rewards. You are changing what you say every video.
Simon S	Great vid, but why ronaldos number 4 üòÇ
Daniel Walker	Get Stevie g back.   Please
Tim Steinhauer	you should do that potm reus for super sub hes amazing but around 400k i think
Osmanlispor06	You guys know how the ultimate scream promo works? Is busquetts going to lose his 90 pace soon? Thanks guys
Sander Blaauw	Buy Cruijf
Koendh _	Ajax-Feyenoord is this weekend, and there Will be a marque matchup for it, so u need to buy Ajax players bc they also Will be in the champions league sbc‚Äôs, rare gold players are the best
Fran Huzjan	Can you at least make an effort and change your shirt in the thumbnail?
.	Why has he got Fifa points on a rtg
Marcus Iversen	Please try the new Busquest, he looks so good
Ben Hopkins	Love his enthusiasm !!
Dennis Martinez	Damn you‚Äôre annoying
yesKemik	You should get Seedorf, he‚Äôs the perfect CM
Josh Sharples	Just make multiple videos and stagger the release of them whilst you play tournaments
Archie Cloutter	Scammer
xLeBLADEx	who wants 50k coins? I have 5 million and still not enough. lol
Omar77HD	I uploaded my rewards please check it out!
Arshan Lotfinia	road to glory skillz!!! Come on man
Adam Bennett	whats his camera angle?
Reid Labutte-Seddon	What camera angle is that?
Viggo Kaliff	Try Emilio Butragueno
Ahmad Ismaiel	Great 30-0 this week bro, SIIIIIIIIII
Tracy Lattimer	Dood skillz save up for eusebio
Joshua Josh	Skilllllz, we want to see you play pro
Walter Maturana	Hi Skillz, i want to know what tactics do you use?. I need a little help to get out of silver 1 u.u love ur videos man. Cheers from Argentina
Deniz Sanli	whats the problem with Prime Gerrard? buy him!
James Weatherborn	Hey chat and Double A. I am eventually going to buy Mbappe when I get more coins, but should I sell my Yedder, L. Hernandez, & Meunier all IF to have him now. I run basically an all france team.
Bob Marley	Skillz I like your videos a lot but there are alot of ads
Charlie Greenhalgh	Look at that Eusebio card like if u want skills to take a look at it and see if he can make it fit
SFGONEPOSTAL	Been watching for years! I finally got in to FUT Champs. This year is the first time playing online and I got Silver 1. Thanks for motivating and teaching me a lot about FIFA!!!!!
Mitch Trewin	Just making excuses because he would get killed in the tournaments lol at least admitt it and stop thinking of all these different excuses every single time
Randolph Morgan	No lie i started watching ur vids and thought you were loud an obnoxious but this vid was a real turning point, big up you bro. I rate it
ThonieAjax	you're shit scared of flying just admit it dude
Erik Hernandez	horror nights?
Arsenal fan	Skillz you should put coin boost on its in the catolauge and you can get up to 1000 coins a game. Like so skillz can see and earn more coins
iTz Sam l94l	Spoiler alert 29-1 ;)
Hamza Assyad	Vieira CF and Ronalfo CM. Whadafuck
Axronnn18_	We want to see 30-0 boiiii
Christian Ramirez	Is 12 wins in your first FUT Champs ever decent? Keep in mind this is my first time since FIFA 15 playing a current FIFA.
Sanjay Khan	Hey skills I am playing FIFA in ps3...  But it's really difficult to defend in legendary...  Can u give me any suggestions
Jorge Salomon	You are just scared of getting smacked. So stop the excuses
Alfardy Ali	Compete for us at least once this year please
Alexander Seyde	Skillz, thank you man for doing what you do.
Zaid Abo Al Haija	He doesn‚Äôt wanna go because he fakes his gameplay and would get exposed like fifa 17
Kasper Wandel	Yessss your new icon Matthe√ºs is a beaaassstt
Kayden Brown	Keep up the great content
Bobby Cooper	The way you title this is so deceiving man thought you packed  an icon
Oliver Snaer	Skillz poor man to glory?
Hlynur 787	Can you stream on youtube or twitch
Gianni ter Braak	This amazing team need a way better kit!
K2 Clan	Love ur vids been watching am for 3 years now
Craig Stevenson	U better be a pro
xLaksa	What kit is skillz using?
kieran HD	What camera angle is this?
minihitch 11	U need to try dybala
ThoseCanadianGuys	GET EUSEBIO
TuffPlaya	Should‚Äôve got gullit
Crazyborn Soccerdude	Skillz u should‚Äôve put a chemistry style that would‚Äôve made Steven gerrard faster.put a chemistry style mathuis
Wade Ragsdale	I won 8 games in a row with my cheap prem team till I came across some guy with this blue Ronaldo card I lost 5-3 :(
Nuno Marques	I would like to see you play in Europe bro maybe it would improve your game alot
Louis Moss	Bring back the vlogs
FDC- FORTNITE	squad batles are so boring pls go to pro tournament you are so good youtuber so don't post videos but play it
Alexander Grimsbo	Has aa9 zoomed in his camera angle on fifa? looks different
rain_577	When is the RTG coming please?
Alfie Baker	The amount of edge of the box finesse shots ...
Hector Rivadeneyra	NExt episode... "We Bought the GOAT"... This gets so annoying
MauroMD Costa	Really like the videos bro..keep up the good work... I would recommend you getting eusebio he really good.. Really fast and never misses one on one chances
Benjamin Marsden	Lotta respect bro
tavor giat	what kit is that you using
Tom Wolstenholme	I've got 700k. What icon should I buy?
Aiden Smith	Skillz we all wanna see you go kill it at the pro events! Yeah we'd miss some uploads but we'd all understand. Also if you were really worried about missing uploads you could maybe vlog the event to make up for it!
Adam Johnson	You bottled the qualifiers bro just be honest
King Karl	Do what you want to do, it dont matter what others want.. If you not going to go to the event let someone else who wants it more to have the chance. Don't ever let people pressure you into stuff you don't want to do..
Bentekersaurus FC	In fut champs I always get 13 wins and choke gold 3
Ethan Hollis	from this I've leary skills is one of the realest guy out there
iiTz Retro	"If it ain't broke,don't fix it" - AA9Skillz
Marcus Ekenberg	Is Blanc working at cdm position?
In Valid	This vid was amazing , keep it up üëå
hector cuevas	Skillz, when are you going to marry this girl. You guys been together for like 4 years or so, that's good time to make it serious. Just being together without marriage is kind of waste of time because if you guys break up at any time and its just wasted support. Don't be scared man, she makes you happy and she's always there for you. Make her yours forever man, don't be stupid.
Jooa Vuorisalo	My team Gk lloris Rb walker Cb sanches Cb varane Lb alba Cm alli Cdm casemiro Cm dembele Cam potm hazard St mane St jesus  Start 4-3-2-1 In game 4-1-2-1-2(2)
FIFA SMITH 7	Skilz can you please read this comment  Most people who are playing fifa 19 now are have a lot of mega teams with a lot of good players and not everyone can afford fifa 19 as yet.. I still enjoy playing fifa 18 ultimate team, but the problem is the transfer market is dry because most of the players are sitting in some clubs and not using them.. if you guys could tell them to atleast list some of the players on the market so who ever is playing 18 can still afford enjoy the game..  thumbs up if u agree
FifaFam 987	Do what makes you happy mateü§òüèª
Anthony Achar	Stop being lame, just play
Mr Donkey58	In ur next video try alexis sanchez he is realy giod
Blvck Iverson	Best cm no cap.
d0oN	What camera does him use?
Olly Rudge	Get prime rijkard
jaime arciniegas	Follow what makes you proud and what makes you happy skillz, watching you, is not only entertaining, but i personally learn from watching you play. Keep it up bro. Much love from the NA<3 keep getting those rage quits lol
Alfredo P√©rez	Skills I think you shouldn‚Äôt worry about the reward as much, we want to see all the cool players and new players like Eusebio, Socrates, ballack. This is what this series started for, to display all cool players, not to get the best rewards.
ZachAttackk	my mans went to KD ?
sebi_ vb	Yo skillz did you go to Fields of Fear!
J B	No wonder you don‚Äôt pick up Messi, so concerned over height in Fifa lol
Aslan B	No! F pros, just do what u enjoy to do, don't do anything that some "subscribers" want u to do
SEon Mamba	Show us your custom tactics bro pleaseeeeee I also play 4 1 2 1 2  and it don't help as much
Jamie Burstow	Keep doing you skillz and we will keep supporting!!
haximan mascarado	I was realy hoping you buy Socrates he is such a huge legend to brazil
Nasser Als	I swear you‚Äôre the best bro..
Meko Hasani	Can you please show what camera settings you are using in the next video? I like it. Love your content keep up‚ù§Ô∏è
sarthak singh	the GOAT youtuber, we get ur decision love u always!
marvmg _04	This your job skills, and just like every other job if u miss a day, u dont make money, I personally respect your decision of not going pro 100% ü§ô
Smitshuysen	I want you to play what you want to play‚ù§Ô∏è
meshari abdulsalam	skillz said he is more passionate about making videos than making the pro scene so as his audience we should respect his decision. I know that most of us would love seeing him in this tournament but think about him for a second, he wants to do youtube and not miss a video more than going to the tournament so lets all respect his decision and stop pressuring him to go  to any tournament any more
Chaz Fox	Bet AA9skills won‚Äôt pin this
Eli Pierce-Haig	Get prime gullit or cruyff
T Wiz	Skillz if you ever read this could you do a timed finishing tutorial, seeing you do it your finishes are far more consistent to mine
JamesGiddens YT	I‚Äôm new here and I‚Äôm loving this content and seeing how much you care about your youtube
John Smyth	I like FIFA but I get burnt out playing I can't imagine playing professionally that would take out the fun plus with a full time job and going to the gym sometimes I'll feel issues w my hands bothering me at the gym when I do to much FIFA which worries me long term and I don't even play as many games as most.
KrisAndAmber	Why don't u try baby Van der sar in goal? Or a icon keeper, maybe middle Yashin or Schmeichel or someone
Ethan Weinberger	Getting a disconnect when you‚Äôre winning isn‚Äôt fair. Can u tell ea to fix the or discuss it
Swifty	Bro you said if we want you to play in the pro thing you would and we said we wanted that but now your explaining why your not.
◊¢◊ô◊ì◊ü ◊ô◊†◊ß◊ï	AA9 what is your camera settings?
mi 2301	I know that you are passionate about this but like you can make Vlogs of the pro     things we just wanna watch what you do and we want you to be happy in what you do
Bruno Oliveira	Eus√©bio is a beast in fifa 19, fica bem skillz, portugal love u, √©s o melhor
Devine Andrade	Quit playin and get Eus√©bio reppin Benfica out hereüî¥‚ö™Ô∏è
Weecal 72	Should I start a RTG
CROBOSS	Pasaport
Elias Holm Thylgaard	U could always male a vlog og you go
Jake Amaya	What‚Äôs this mans background music? I can‚Äôt find it anywhere.
mohamed asri	Hey skillz i am a amatur FIFA player can i send u two games i played today so u can analays it and say What i need to improve. Like for some help. If u see dis hook me up on insta: asri_32
Ben Harris	Is he from uk or us
ps4 computing	First ever weekend league is 17-13 with a meh squad. How‚Äôs all of your Weekend League going?
GioBettor Agency	Let‚Äôs be honest you just scared of getting into an airplane lol
Superior Gaming	U didn‚Äôt even consider gullit
AqurazZ N7 v GT	i got prime blanc for free
Regggie Btw	Can u do custom tactics video
Macca	When‚Äôs the road to glory coming out
Stefan Andrei	12:50 rap god
thug Gamer	Yo! Bro buy lloris Hugo he is op
RobertYC 11	Didn‚Äôt you also say you hate flying?
Chase Gauldin	Aa9 lectures
Alfred Kraml	your girl is more important than any competition. Love your contet keep up the great entertaining work :)
Almar Stam	Skillzz wear the ajax kit. The most beautifull in the world!!
Mike Dolan	Don‚Äôt focus on squad battles
Eduardo Vera	Why didnt you buy prime gullit instead
Matthew Lourenco	how do u not have eusebio yet?
BenFUTPR	Do what makes you happy skillz
JuanAle CV	Matheus was a good idea
Cooleos Productions	Mattheus looks like a beasttt
marko Konomi	Wich camera does he use in fifa ?
Jens Vanfleteren	Why don't you trie if lozano as supersub?
Marcos Junior	just making goals with long shots, that type of gameplay is ridiculous
BakE Byrd	Hey skillz I love your videos I was wondering if you can give me some tips on how to beat legendary I can beat it but just 2-0 3-1.                 And sometimes I lose not all the time I mostly win.     Thank u
Marv Ellous	Rey Rey >>>> Fifa pros
CO STEPOVER	Y no guillit
Tyler Fedruk	stop being like this and just compete
RudY RD	Why ur not trying to get Eusebio skillz ? Nice vid brother
Harsh619	Aa9skillz I was so excited about FIFA 19 just because of your rtg but now man u are not making one that's just depressing.
Klaas Jan Huntelaar	Am i the only one that lost interest because it‚Äôs not a rtg? It‚Äôs more of a rmtg and he uses bronze bench with this squad, blocks most pros to avoid them
Parkour Fox	I think he means rich man to glory
Isac Rosell EK18B 363KAGY	When is the road to glory coming?
Rich Green	I feel the community strives to get to an event, dreams of winning and having the 'glory' of being the best at fifa, I don't think you should bother calling it 'a road to glory' seeing as you've taken the glory away by not competing, this is just my opinion, obviously it's a free world so do what you want but why bother asking us? And what's the fun fair gotta do with anything?
Dattaraj Naik	finesse shot compilation
Max F	Did you go to screemfest?
Atomic	Mate look at Eusebio this guys a rank like look at his stats
Danny Koning	Your channel your life bro. Choose for whatever feels right‚ù§Ô∏è
AKBAR TARIQ	I like skillz but let's face it he pays someone to play for him, therefore no live commentary and most importantly he doesn't . wanna play pro tournament. PROVE ME WRONG SKILLZ
Milan Campbell	We don‚Äôt mind if u don‚Äôt want to play the pros! Keep doing what u love doing
Tony Ocampo	So many outside the box finesse goals!
Hi Hellow	look, just go to the event and dont upload for like a day or 2. pretty sure the booyah gang wouldn't mind and this will also help u get better since ur playing against pros
Victor Massoni	I love that you are part of my day a day routine, keep going bro, good job
Alexander Ascencio	He likes more $$$ then fifa simple lol
Bilal Ahmed	So if you're not competing can you start the actual RTG?
Ivan Dariksonn	skillz plz change CR7 kit number to the #7
TomMC	I‚Äôve never played online before what do i do? I‚Äôm not that good either
Larry Vanios	You bitch way to much
Adam ungier	Why not Gullit?
Adam Watson	If he‚Äôs not a Liverpool fan and loves stevie g must be a rangers manüòâ
Brian Mars	Can anyone tell me what what kit the red/black is used this episode? Loving it
andyF	do what you think is best skillz! we will always support you no matter what!
Leon Cook	You keep going on about how good your defence is but you never show us any tackles they make so if you add them in it would show us how good some players are and also how you defend as a professional player
Michael Knots	Why didn‚Äôt u pick up gullit
Andres3Stacks	You could replace FUT uploads with vlogs of the pro scene and still make YouTube money at the same time bro
GuoCai Christopher Ng	IF Mandzukic (86), Immboile (87), Icardi (87) or Higuain (88) for my two ST?I have Mertens as my CAM.Thanks a lot champs! (:
A Govender	Yo skillz...buy Eusebio...beast of a player
joshua khoo	Please get MESSI!! he‚Äôs amazing this year
Jack Hancock	We see you score a load of goals and great attacking play, however when we see you defend you always concede, can you show us you defending well to learn from that
Juan Buniva	AA, its easy to understand why you don‚Äôt want to go to that tournament. You‚Äôve got a life man. And although you are a great player, lets face it. You aren‚Äôt a Pro but a great youtuber
druwinka brickston	matthaius good  pro scene =(
Yousef Zaza alghamdi	Get middle petit HES INSANE
Jake Budge	Love all your vids skillz, but you say you do this for your audience, but your audience wants you to play in the pro scene otherwise youre just gonna be getting top 100 every week and then not progressing anymore which means there will be nothing more to achieve
Konner Hoot	What does he switch to ingame
Tray Diedrick	Wasteman
Jon Moniz	How have you not picked up eusebio yet smh #benfiquista
Papi Chulo	Why don‚Äôt you vlog it
umaro seidi	It‚Äôs becoming more and more boring
Ryan Elston	Skillz bro...real fans want you to do whatever you really want to do keep up the quality work brother great video
Curtizoo	So let me get this right.  You think we love watching you play squad battles - imo dead You think we DONT want to see interesting videos of you going to events - imo dead  You don't care about the fans just a steady income and not leaving the house - imo true  is what it is.....not hating just saying what I/we think
Hector Flores	Yo u are the best YouTuber broüíØ,  i watch ur vids almost everyday at work on break n when i play fifa, i enjoy ur videos foreal, and getting better in fifa too
Zain Naseer	He just doesn‚Äôt want to compete in pro tournaments as he would get thrashed and embarrassed
Tank 0578	Wy not Gullit
Enzo Colantuoni	You have proofed you are good at game now do a poor man before the game dies you retard
Luqmaan Shekhuna	U have a nickname for every play, I love it
Harry Priddle	Get gullit
TheGamingCheese	Why don't you buy gullit
abachos	Hey aa9, been watching your videos for years. Recently I just can‚Äôt get better at fifa and don‚Äôt know what to do to improve.
Fortnite Gamer3	great vid üí™üí™üí™strong passion for youtube
King Haynes	Die panzer what a card good choice skillz
John Cena	Skillz, I beg you change Ronaldos number to 7
WowL	If it's about posting a vid every day and not taking a break you could have done a vlog or give us your thoughts about the pro event and you would have still had time to go with your girl P.S No hate just saying my opinion and I understand that skillz doesn't what to play in the pro event
Filipe	EUSEBIO FOR THE CULTURE
JustNotGaming	Is skillz with ray
Tristan Webb	I respect that you want to go out with your girlfriend bro ! I went to that scary park last week and it was pretty good. Keep it up bro
Blake Bell	Try get cafu
Ozi man	You are the besttt
Armbale	Try out the man Raul
Gg Ggy	Chat with me on YouTube! https://youtu.be/addme/S5Ud2HUleLUumo2k7kHP27Oq6i4hvA
Chris Umunna	Get depay or Gueddes as super subs
ms swali	Get prime gerrard
Fool Tool	I fking hate socrates
oJaZz93	why don't u just get Seedorf
Liam Maybury	Nice skillz fair play for sticking to YouTube ü§ô
ali king	you are amazing
Forhad Majid	When fifa 19 came out i saw your channel noww I can‚Äôt stop watching it. Also your pack luck is absolutely heaven for you whereas me not even a board :(
liam Southgate	I like your vids but Fifa will always be rich get richer play with a average team you don't get near top 100 fact sorry but someone needs to say it
Ben - Plays	Weird question but what camera setting do u play on on ultimate team does anyone know
Mohammed azhar Cassie	Pay to glory ü§®
MOHAMMED ALANSARI	Skillz just vlog it and if you can‚Äôt let ray vlog and upload it here so that you don‚Äôt miss a day
Omar Lala	Skillz pleeeeeeeeeeeeeeeze do it for the booyah nation        Like so skillz can see this
BHM MUSIC	You and your brother should do a video like twosync I think it would be sickü§ô
Alan Alban	Love your commitment Skillz. We appreciate ya!
Doukanitus	Stubborn but you do you man, do what makes you happy üí™üèΩ
Brad Smith	make vlog abour pro scene is enough
Criminvvl	stevie g is a nice guy! hard to hate him unless youre an evertonian or a manc
Timotius _10	Pay to glory
Yukesh Thapa	He will sell matthaus after 2 or 3 eps for sure.
ProvenPAYNE05	Your just the best youtuber!
Javier Alvarado	This is me during his speech üò•üò•üò•üò≠
Stefano Napolitano	Whenever I get disconnected in squad battles, it let's me resume the same match after
JackBT13	more like AA 9 thousand excuses, don't be scared to step out of your comfort zone and try something new
Nico ConCellas	If I‚Äôm honest I like aa. But after the last event he did, considering his team, I don‚Äôt think he wants to get smacked again.
FIFAKing 013	can you start a channel where we can watch all of your full games like if you want this to
AA7	Yo Skillz try buying Raul.
MrPaddyman123	he scores some of the worst goals ngl. not even hating its just a fact tbh guy just holds b with Ronaldo from anywhere, doesnt even work good goals most of the time
S F	Skillz I like you and been watching you since Fifa 13 but you said you wouldn‚Äôt take someone else‚Äôs spot in the event , then what‚Äôs your motive? You could be taking someone else‚Äôs spot by getting 27-28 wins every weekend? AmIrite?
Shin Koh	Seedorf!!!!
Cole B	Get the lampard card
Rawa Alipanah	Yo skillz what camera angle do u use
Jesperhot Pedersne	When i play sb on ledgendary i always WIN, but they always park the bus, why dont they do that against you bro
scg	Skillzy, I am saying skillzy cuz you obviously think like a kid sometimes... You always say you want to deliver fresh content to the channel... What the hell would be more fresh than a tournament? Squad battles rewards (on a pay2win) Vs a tournament... It's a no brainier for your audience... Should be for you as well...
GTG KIRI	gullit
Adambraz Braz	How Do you put coins to your team
Niels Prinsen	Skillz follow your heart! If you want to make YouTube vids because you love it, just do it! F*ck the tournament!
Aidan Brennan	I‚Äôm having a pretty bad weekend league has anyone got any tips
Seif Abdelatty	Skills i miss the poor man to glory Still love this though Keep it upüí™
XB1 Smystz	Hey    Read More
Samuel Resendiz	So you got a life that‚Äôs what I like man,quality content and a quality person,you don‚Äôt force yourself to play like some of these other trash youtubers respect for you man
Preboys VL	This series got real boring real fast bro, we don‚Äôt care you getting 29 wins with that team...
Fifa stream Nsnsnsnss	You're not going to the event because you might walk away with no money made but your staying to keep dat cash flow, be reaaal bro.
B Dg	Why don‚Äôt you get gullit
FUTFinder	One of the most humble and down to earth YouTubers, never change Skillz, never change.
Kwame JayGH	It feels good to accomplish top 100 the rewards are just doodoo
AbdelRahman Elnajar	Just keep doing what you do man. Much love.
Edin Malic	We appreciate u skills wether u go or not. Your awesome and your vids are Aa1 lol
Ninja Pajamas	I think im gettin better ... before it was losing like sh1t againts legendary now its 1-2  ... atleast I didn't lose too bad ... my Gundogan is so shit and i need better coordination lol ...
Dragos xD	Get Thierry Henry
JRC 18	Get de gea and Ramos instead of varane and courtouis
Blxst Power	Dead series.
Hassan Al sain	What editing?
Mr. Arbaz	Please  go bro
Ewe B	He makes too many excuses. Just play in the damn tournament. Stop being scared
Fabio Kibonda	Skillz get Eusebio he is amazing and he played for benfica
Steven Arnold	I wanna see MARADONA, Petit, Henry
Morgan Steele	Vlog the tournament
Erik Alsgaard	People that still make jokes about Steven Gerrard slipping is bad people. Too much is made about the slip. People say that cost Liverpool the league title that year, but it didn't. They lost 2-0 to Chelsea that game, AND what really cost them was the defense. I mean CMON NOW! Skrtel and Sakho in defense in a title winning team? No chance. With Van dijk and Gomez that year, Liverpool would have killed the title race a long time before the Chelsea game. Gerrard was not the one who cost Liverpool the title. He was immense that year as ALWAYS. What a legend. What a captain. And even tho I'm not a Liverpool fan, I admire that guy so much. The loyalty, the desire, the shots, the passing, the passion. The guy was immense his whole career. He didn't win the league, but he won every other trophy possible, and he turned down Chelsea, Milan and Real Madrid to play for his boyhood club. Stevie G was fantastic, and I dont care what anybody says.
Shira Shoham	Lozano is a god
TadGaming 1	RTG edition boyaah nation
Sim√£o silva	His he a Benfica fan?
TheVeryHarsh	When Skillz talks, it feels like he is rapping. No Offence.
Du vet yahia	I didn't know that other youtubers have editors, so from now i'll watch all your videos one after another
Jarule Mk	Best youtuber
Elliott Sampson	What‚Äôs your camera angle on fut ?
Fifa Wilde	When did u move to America skills
EthanMcc 2003	Get potm reus he‚Äôs the goat üêêüî•
daniel marshall	Ayoo skills, you are a top man no1 cares about pros... your 100% classy keep doing your thing  nice clean clear content!
frederik aka the beast	Keep up the good work  Love it
Its Bazm	you tried prime cryuf? hes insane
Conor Anderson	i think you should try paul scholes
Hello11183	Drink a shot of tequila for every time AA9 says ‚ÄúWith that being said‚Äù :)
Behzat Efe Senyildiz	Which team is his red jersey
S Coulty	What camera angle does he play?
timothie goodshaw	What happens when you are older and no longer relevant tho? Being involved in the pro scene makes you more relevant on YouTube !!! It means more followers and more future revenue
sg GuASGSD	Can someone tell me what camera settings he use?
Peter Van	Can you make a video about your tactics and formation?
Moustafa Baratali	Rigged account
DiamondMask HD	fifa this year is about long finesse shots
Vine FM	You do what you want to skillz we‚Äôll still watch you
Andrew Mason	My best player atm is insigne
Maj Playz	Love the vids I have 11 wins and 3 left I was hoping for silver 1 by some miracle I may get gold 3. What formations do you change to
Samer Saleh	You could've got prime eusebio and play 442 with him and Ronaldo up top, mbappe and Neymar as Rm and LM, and Viera and blanc as cm's
Ali Fleming	What's up skillz been watching for years now and top 100 rewards is mostly what i come to your channel for, keep it up bro
Decisive FIFA	Dont worry skillz as a fellow youtuber who edits his own videos. I fully understand it takes alot of time to do which isn't easy. We support what ever decision you make skillz
Golden Peanut Butter	I respect the fact that u don‚Äôt want to go to the pro scene, but if u go u could record the content and post com itüåö  If u still aren‚Äôt interested much respect ‚úä ‚úä
AceTheNutHead	Do what you want to do man. You dont owe us your happiness.
Dj Arau	Skills check how many for swap player u have to get el sharawy as a super sub
Ben patterson	*dont put rtg in the title*
Wagner Mendon√ßa	Skills how do u time shoot???? Show us pls
Oreo ForU	Buy Eusebio he was ur childhood legend benfica beast like so he can buy him üî•
Mxtch	Should‚Äôve got eusebio
Thomas Plays	Great video, do what makes u happy and what u enjoy
simon youtu	Please show your custom tactics and gameplans
Olle Walin	When you are searching for a 2 mil icon you shouldn't be searching for specific positions. For example this Matth√§us when you searched CM, he could have been on the market at CAM or CDM for 1.9 u know wham sain
Hady hady	If you could get gullit instead of blanc you'd have the best team in fut.
Itsnotme	You should have got gullit also do the poor man to glory on ps4
MercurialRacer 7	He's scared of the pros...üòÇ
VSAT ORBITZ	Hey skillz, I was just wondering if you could possibly do a video for what to do in certain situations mid game Fifa. Thank you and good luck in the weekend league!
yacine ff	Skillz pick up TOTW mbappe
Alddin Gaming	Start a Poor RTG
Joshua Pienaar	Is pele better than ronlda
Joe Stevens	Nice u  listened to me told u to get mauthaus
GAMIXX	Guys , i am new to fifa , i play on ps4 , i want to know how can i remove the thing above my player when i shoot , it's annoyinig . and please be helpful not childish
Nils Reinecke	I don‚Äòt even care about the pro stuff if you wanted to do it i‚Äòd support it but i think it‚Äôs perfectly fine if you don‚Äòt want to do it
ÿ™ÿ±ŸÉŸä ÿßŸÑÿ¥ŸÜŸäŸÅŸä	Why you shoot only finnese shot
Red Neck	Next episode: WE SOLD OUR PRIME ICON!
Mohamed	bro buy prime gullit he has no mercy
Jack DP Rich	At least u can get his manager card
Joseph Rothschild	Pls skillz do pro tournaments your do good at fifa and pretty much doing it for free when you could be getting big bucks for it . I‚Äôm just saying if your good at something never do it for free
Kahlen Orcutt	BRING THE VLOGS BACK! you made my day with the vlogs they were just so good! Love you Skillz
Jordan Pullon	You should‚Äôve bought prime gullit
Rhuraidh Meechan's	I respect your decision skills
Assassins Expert	good video and how do you make all those long shots?
Tom Harrison	Y not prime gullit
Kotha SohanReddy	u have my respect
Jakobinius	Ay AA you are my fav youtuber! Please keep doing what you are doing! Love it bro
LJ	Does this guy ever livestream? If not I would bet money that he pays someone to play the games and he just comments over the top of them...
Orangeboss	So we just gonna skip that he sold coutinho for 67k
Zamppa86	I bet Stevie G is gone because...He let it slip! :D
ProEdward 2014	Continua assim. Apoiamos te!!! Good job
Marko Hunic	Can you do a tutorial on how to do certain passes or shots in fifa 19
Reece Mellis	SkillZ I respect your decsion bro, but nobody will remember a few career mode episodes but everyone will remember you going to an Event
Laurens Wilbrink	If you don't get what he says about 'passion', you don't get life, I'm sorry
Erik Cedervall	Play PRO
21smoothcriminal	Skillz ,  you do you and i think we will be just fine  If you don't want to go to events , don't go ; you must be the most passionate Fifa youtuber and we are thankfull for that
Two sync Unofficial	This is the worst scream promo ever
Jake.Wainman	YES! IM SLOWLY INCREASING VIEWES EACH WEEK BY ABOUR 15K!!
Cazerox	Get Ballack!
Matt Harris	Do what you want to do man, you work harder than anybody else on YouTube and you deserve the subs, you can play whenever you want and choose what you want to do with the way you play in terms of competitions man, loving the videos man
Kevin Seves	I got 19-11 1 win of gold 1... rip
ÿπÿ®ÿØÿßŸÑŸÑŸá ÿßŸÑŸÇÿ±ŸÜŸä	please change the pic you but it in in all your video
Edward ‚Ä¢	Tbh, of all the players and pros that I've watched, skillz is legit the best player when it comes to being creative in attack and simply just scoring goals
CHELSEA FC HIGHLIGHTS	What if some one else is playing for your gameplay and when you go to pro scene your gonna get lose after lose So it can be a reason why you don't wanna go
Choose Me	At this point I‚Äôve given up on getting a poor man to glory
TripleTribute	Play with a 100k team if ur good. ur dead, of course ur gonna win when u have the best players in every position
Fraser Ross	I know you won‚Äôt see this skills but do u think that timed finishing makes a difference?
Mr BIIG	Your a twat your love making footage for us then go and get footage for us
TELF	Great choice on the icon bro
CaptainThor2000	YESSS! I was just saying the other episode to get the GOAT himself and he does it!
David Kwok	What ever u pick. It is your choice. I feel that u should do what u want to do.
S Speed	please poor man to glory!!
DutzuB DutzuB	Play in pro scene pleaseee.. You are our guy out there!
Flukex1001	Took a disconnect and lost after i beat some dude in Fut Champs on pens. Missed out my WL target by one win. F*ck EA
Tchyeah	Guys, what's the current best formation ? I used to play 41212 (2) and win every game but now I feel that it's been patched
Max Mayles	Like and u wont pack bender ever again
George Davis	Camera settings ???
Alex Dwyer	Real rtg
a.k.s *	Guys skills is not saying it as it is to not sound like a dick but bottom line playing pro not worth the video money income and may lose viewers and that's fare enough in my opinion
Jo√£o Maduro	n √© matheius crl, √© m√°th√°us
Ricky Holly	0.44 secs in Skillz and very Dissapointed üòâüòÇüòÇ "He ment everything to my child hood so i sold him" thats not very nice üòâüòÇüòÇ As i big Liverpool fan and Gerrard being a absolute Legend for you to sat just nope tada thats not good üòâüòÇüòÇ Banter aside Skillz keep up the good work,TOP GUY OUT
logan king	What about 90 Gullit
Chris Casserley	This game is fucking shit, servers are shit, sbcs are shit, gameplay is shit
Mustafa Mohamed	When is the pmrtg
Yung Lap	Guys please can you tell me what camera settings is AA9 using?
genischivas	Hey skills check out this new series yea? https://youtu.be/Z8Plj-uFEsw
Rudes Druh√ΩDych	Why you playing CR7 as CM and Vieira as ST ? And then swapping them.. explanation please
Jo√£o Monteiro	I'd love to watch you play with some of the portuguese icons, like figo, eusebio, rui costa. I feel like your getting too attached to your front 3. Its only the beggining of fifa, try different solutions and you may even like it more :p
Moaaz F	Best RTG Maker :) Thanks for making me happy
PC PC	Love u skillz!!!
Samuel Fahlgren	Hey Skillz please go back to doing Vloggs, I really love them and especially now when x-mas is coming up. Please Love u
Kreng Lowe	You should do whatever you think is gonna boost you career. Playing pros will make you better and also you could possibly be payed more but do whatever you think is best for you
Michael Heveran	You should have got gullit
Hussain ahmed	Keep doing what you do skillz well always support you (always follow your passion)
FluffyDoesGaming	Hey you guys got any tips for me? I‚Äôm trying to buy Neymar but I am currently at 250k I was at 450k but I decided to make the team around him first then buy him. Just need tips to get coins faster
Aiden Robson	Skillz I think you should do what makes you happy with the pro tournament
jesuscruzchuy07	I was 11/11 on Friday n on Saturday 14/ 30 I just couldn't score on Saturday for no reason at all. My St we're either hitting the gk or missing completely on 1v1
Ashley Comerford	Anyone know the kits skillz is using
Stone Cold	‚ÄúStole Stevie G... se... soll Stevie g‚Äù
Scott Lowe	Why register for it in the first place if you had no intention of going then the questions wouldn't be asked. Because not only did you need 27 wins you had to sign up before hand.
habib khan	Buy messi please
jesse casdorff	Any1 got
Rana Shahmeer	Skillz please compete
Michael IItengula	get Auba
Dominik Decker	When comes the real "RTG"
steve rajan	Do what you want i support you bro
Ggg Mm	Like and the next 10 packs you open you get 85+
Anirudh Krishnan	song at 6:21 pleaseeeee?
Villads Jensen	All your goals are just finesse shots from outside the box! How
xiLo	I'm so confused...why does skills talk bout having cr7 in striker when he's in cm?
inonk69	Talk too much
Vivros	loving the vids bro!!!
VVDL	When do you start the poor man road to glory?
Ido Hevroni	Woww
Fredrik Dinesen	5:08 new prime icon
[spacebar]	It‚Äôs great that you‚Äôre so passionate about youtube, props to you man :)
Mukul Yadav	Why didnt you get gullit?
TheJameson7	Low key skills doesn't want to get slapped by pros üòÇ
Bernardo Rosa	Does anyone know his camera settings?
Jack Mc Donald	Next event vlog  it and upload it
banter	Seriously, why do u still play squad battles?
Gareth Steen	You bought an icon, sick of your rich man account the rest of us will never even afford one icon
Gaius Ukaegbu	too easy for you guys on Xbox
123pannenkoek 123	Skillz do the reus sbc
james shooter	What kit is he using
Joel Knott	How does he do like the insta skip when he scores
Mohamad Reza Soltani	buy prime gulit man, his outstanding performance in futchamp
Alexander Kirov	You are so stupid man... You play fifa every day for like 5-10 hours for 10years and you have 0 game knowledge. Your gameplay is amazing, but that is because you played for sooo long. Nep and Nick are so much better than you as youtubers in general
Lamar McGregor	Don‚Äôt play squad battles anymore
luke piercy	Why didn't you get prime gullit?
pietiever	He isn‚Äôt going to do a poor man rtg guys, it‚Äôs obvious.
Gabe Curry	AA you‚Äôre a great player, any chance you‚Äôll bring out some tutorials??
ibi the gamer	Pleaaaaaaase upload the poor man rtg, no body watching this can afford these players so we don't care about you testing out the 500k plus players. EVERYONE wants the poor man rtg so please
GMH	Skillz last episode: "don't sink all your coins into one player"  Skillz this episode: "so we bought matthaus for 2 million coins"
Malo Lud	6:01 i heard ronaldo say siiiiii
Nathan L	YouTube is dead, go mess with the pros for a bit
Ohad Levi	Big respect men you're the best
Oliver Di Mauro	Who saw the guy who packed two icons
NO ONE YOU KNOW	What stadium and camera angle do you use?
Questionable Gamers	Lampard
Tom Kelly	The game has lagged me out twice now after I‚Äôve already won a game and caused me a two losses...not bothering anymore! Should be 8-2 which for me is great
the fifa players	If anyone needs a good striker, go and get Lewandowski. He scored 43 goals in 22 games for me this weekend league. His shooting and positioning is amazing
Shahzad Ahmed	I was 10-1 & all of a sudden i started loosing every game and now its 10-10.. Dont wanna play any more.. I dominated most of the games i lost but even after 20 shots i cant score more than 1 goal and my oponent scores 2 goals with 2 shots.. That sucks!!
PJ GAMING	Its Yaboy double p9j
Jonathon Hossack	but gulit
lewi ki	Why dint you get gulit
Arsen grujic	dont purchase anyone until you have money for 90 gullit
Jamie Emery	Sick vid but please get gullit
nahoj_rydne YT	Why don‚Äôt you get if mbappe or if Neymar?
jasperhoekstra	If you wouldn't earn a penny doing youtube you probably would not do it
Luis Martinez	does he take any other shots besides finesse shots
TwistedMind	Whats up youtube it‚Äôs yo boy double A 9 skillz
Ante Pralija	when i shot there is never a color how can i turn it on
Ziyaad Arumugam	Skills try to fit in the fifa 18 goat big boy Thierry Henry
Stahlz_XI	Matthaus is hhhhhhhhuge
Allen Morales	5:10 Sorry AA9 92 defending  90 defense lol
big nigga	You have been dropping videos daily for us, you should go and have an awesome experience in the pro scene brother
Benjamin	AA9 = FIFA GOAT
Kieran McAlery	Skillz you should try prime Gerrard
Yousef Al Shehri	Watching you from saudi arabia
Gordinho m8	I‚Äôve spent like ¬£600 already and my best player is VVD and I‚Äôve only made maybe 2m? I wish I had this luck üò≠ great content man!
Mohd Firas	"BLANC IS OUTSTANDING"  NEXT EPISODE "BLANC FEEL SLUGGISH" JUST ANOTHER EPISODE OF THIS CHANNEL. ALWAYS
Pro65gamer	Hi random person hope you have a good day      Please help me get 100 subs you don‚Äôt need to thougn
THAT .GAMER	Why don‚Äôt you just buy gullit?
MR Perfect	You should have bought Socrates and gave him an shadow
Joris Visser	Why didn't you get prime Gullit? He is a beast man
Rhys Jones	On twitter, the excuse for not competing yesterday was because of squad battles, which personally confused/upset me because the opportunity for more competitive content far outweighs average rewards for squad battles, especially since squad battles gameplay is dead. However, a personal life with your girl and family far outweighs all of those things, so fair enough. Most of the audience doesn't really care about squad battles, so I would personally recommend putting that lower on your priority list. All love tho, keep it up
jag virk	you sold stevie g........ :((((
ARSH ABDUL	Skillz when are u buying prime eusebio he is a monster for me
Herman Friess	Please do RTG without money
JamppaJ	Can you show some defending clips as well becouse I would like to see how good players defend. My defending is trash I would like to gte better at it
Don Corleone	By far the Best fifa youtuber. Keep the good work, and stay positiv bro
pes mobile 2018	Do what you want skillz
james byrne	Hey skillz, really enjoying the videos I was wondering if you could try Sol Cambell icon because he looks like a GOAT and I'm saving up for him and want to know if he's good ! Keep up the great work !
littleterror03	You should try Frank lampard in your team üëç
THE Drumkiller	You should of got gullit
Billy McDowall	Get stoichkov the goat
Prince of Hallows	If you fo to events more people will know you and your video views your increase
dezmond 757	Skillz I'm disappointed that you didn't go for the pro event, but I understand the reasoning.  I just want to say you can do both.  You can do anything you put your mind to.  I would love to see you on the pro scene because I know you can do it and the booyah nation would love to see you succeed but I support you no matter what. BOOYAH
Fafo Gamer	Love your videos
Rrezon Beqiri	Why do you put RTG on the title when its suppose to be Rich Man to glory, would'nt it be RMTG
Berdzz	When would you start PTG (Poor To Glory)
Goncalo Loleee	If its possible you could try Eus√©bio
geelong44	What view is he using?
Diogo Gon√ßalves	Buy Eus√©bio for striker
Unsuboi	Bro it's easy, just say that you wanted to do what you wanted to do, which isn't wrong? You started YouTube because you enjoyed it, you didn't do it because of your subs and fans that you didn't have, just so you could meet their expectations? Because when you started, the only person with expectations was you. If you change that and stop doing what YOU want to do and start doing what your subs want, then the channel becomes less yours and less you, and that what everyone is here for right? They like YOUR channel? Keep up the good work bro, been a sub for years, don't change shit! :)
Jake 07x	Reminds me abit of the faze censor situation
diaz terpstra	Why not 93 Gullit?
# gamer	Give ronaldo the number 7 not the number 4
ColonelPhilip	My man Skillz, are you going to pick up Eus√©bio? You know it's your duty as a Portuguese and a Benfica man.
Ahmed Nadeem	Buy messi
Ben Spargo	You should upgrade Neymar and mbappe to inform
Steven Sender	How do I get a team like you skillz
Kurt Neyt	You are the nicest guy in the world and I love your gameplay it really helps me
Mr. noob	Why youre to negetive be confident your a pro broüòäüòä
Zm Videos	What is the best formation to use can someone help me out
Rodrigo Correa	shooting outside the box os too OP. it's a bit annoying in my opinion
Joban rai	Congrats bro
DeagleLord	Do whatever u want, we will still love and support u !!! btw can u make a Custom Tactics video, please? I am really interested in how u play the 4-1-2-1-2 Narrow! Thank u for everything!
aidan carr	skillz could you show the player stats for your club
Moui Moui	go away from comfort zone bro
fifa vids	Get gullet
Delix	Best icon for 1 million?
S Meras	skills mate your fuckin sick
JackFFA	pick up van de sar
EZ Jay Dalli	How dare you come to us with your win 299 more wins than losses, could have atleast made it a round 300 üòÇüòâ props bro I'm weljel
migboss	Buy EUSEBIO
Jack stamford	guys stop telling him to go to the pro tournament its like asking you to quit your job and go gambling
chris ramirez1115	Why not Gullit skills?
Wys	No one cares about squad battles
Daniel Alkurdi	Buy gullit
Muizz Khan	Do the POTM Hazard SBC
Zlatan	You already have plenty of size in your midfield Skillz. Matthaus looks fucking insane, so I don't think his size will matter, if he can make it up with being so well rounded. Gullit is probably the only player that can match him. I also run a 41212(2), and what I found worked for me is having 2 big middles, in my case Dier, and Doucoure, and then having Ox (5'9, 85 pace, and H/H work-rates). The smaller, agile, and quick mids are super OP when it comes to chasing down players, and making runs forward.
j Edwards	Can you show your custom tactics
Kim-Jani-Ung	Next episode he sells Matth√§us because he is a high/high
stian sand	gullit why dont he use him
MUHAMMAD ZUNAIR	If you play on ultimate in carrer mide why dont you play on ultimate in squad battles ? ;(
Will Strachan	Why is the bench full of bronze players?
Karadabra	Love it skillz, keep up the amazing work
ŸÜÿßÿµÿ± ÿßŸÑÿµÿ®ÿ≠Ÿä	Bro I have this problem when I switch my tactics in game m my players switch positions permanently. Even though i have them in their right positions. My fabinho stays at st and my st at cdm. So I cannot attack or defend. When i see my game plan from the players rating option, i can see this thing but I cannot do anything. This glitch is fucked up. What am I supposed to do?
Fin M	Like and you'll pack CR7‚öΩÔ∏è!!!!
Aaron Wagstaff	doesn't matter what RTG you do it's the best content on YouTube keep it going big man üí™
are fremmerlid	Buy Sokrates
Aidan Trenbirth	360K who should I get?
stijn lahaye	Dubble A, you're definietly not letting us down. Your content is f‚òÜucking aweasome and you should do what you want and we love it. Keep on going
anthony 123	ballack and ronaldo are the guys that i watched the most in my childhood
Hugo Chisman-Duffy	clickbate like the previous vid
omario	This Fifa sucks
Dubb Official	Give cr7 the no.7 plz
bang	Try to get Eus√©bio
lamTimmeh	Pass - A - Port? someone has been playing some fortnite?
B x 7 iOS	Why not gullit?...
jefflin bond	Dude why not prime gullit
connor reilly	Do what makes you happy love any content you post man
Henry Nicholls	Skillz we all respect the fact that u want to make us videos, but we want u to go and make yourself proud by smacking some pros that aren‚Äôt as good as u man
Bell	Your not playing pro scene because u know u will get smacked
dwijden e	Isn't middel gullit a option, don't know the price on xbox
ivan gombar	why bot gullit!!??
Eesaa Allie	Stevie G slipped
Sean	dong the pro event wouldn't mean you miss out on uploading to youtube, you could record the pro tournament and tell us your thoughts on the tournament
Yout ube	RIP the real RTG, gone but never forgotten
nxughty	Scholes is insane, try him out
RamboGaming	Had the easiest games if someone good was playing on my account 30-0
Athanasi Piponides	Bro try Prime Ronaldinho.. you won‚Äôt regret it. Mine is phenomenal bought for 2.7m on Xbox
Lewis duncan	Got silver 1 first ever fut champs
Kieran Falcus	Like if he should do a no money spent
yessine kraiem	Did they remove low driven shots
xSonnyDayz	This game is so so trash
Joseph Taylor	Hey skillz wherrs the ptg still love the vids tho man im a long term sub
JOLLE plays	Buy matthaus
Johan van Rensburg	super chilled that your not competing skillz, Ninja made a similar decision the other day. Makes a lot of sense. Love the channel bro
Ola Omotolimobdalomminkimlshhd	Bro show us ur custom tactics
Alexandru Vicol	That team at 11:03 . What the hell xD
Omar Khaled	can you please try cruyff or stoickshov there amazing and i got top 100 with them
Reilly boy 10	What‚Äôs ur custom tactics
TMT_DiSaSteR TMT_DiSaSteR	Man I would love to see you play pro but I understand you
Daniel Cleaver	What camera angel/ formation do you use? Love the vids keep it up
Tomas Bond	What camera settings are the best
anastasios gastriotis	Ffs you made a rich man to glory to show us how good the new players are and now you just keep getting the same god damn players.. we know Matthias is good we know Viera is good buy something new tho there are sooo many new icons in the game and you keep buying the same damn players
Ajay Sefu	Lmao he‚Äôs passionate about he‚Äôs bread, he‚Äôs not missing a post because he‚Äôll lose out on a checküòÇüòÇ I respect the grind skillz don‚Äôt let them make you do anything just do you.
Fionn McFall	You said last video you played fit champs for the love of the game
Duh_Dawg	I still don‚Äôt understand why you say you‚Äôre doing stuff with your ‚Äògirlfriend‚Äô... just say ‚Äòmy sister‚Äô
Beetlejuice !	So, no more low driven shots? This year it's finesse shots outside of the box? Haha, I'm so happy that I didn't buy this piece of shit this year. I've been playing since 03... I'm not falling for this scam anymore.
Eddie Mkala Chris	Man Aa9Skillz show us how many goals you've scored with CR7 Mbappe and Neymar
Fitzsimons Robert	When is he going to start the actual rtg c'mon man
Luuk De Busschere	buy gullit
Frederik A Eriksen	MY VIDS ARE BETTER THAN YOURS!!!!üëäüíØ
Thomas Bailey	Get cruyff or eusebio
alisson becker	change ronaldos number to 7
Slinky Slouk	Why dont you upgrade mbappe and neymar to informes  Because you will have an extra vid idea that their gold cards are betterüòÇüòÇüòéüòú
Walshiess 02	Make ronaldo no.7 plz
TheGamingClub	Wheres the RTG???
James Holden	I have a 120k but don‚Äôt know what team to make can someone help
Trschekz Tjernobiel	Oof early
RablewisPlays1 Lewis	My favourite YouTubed by far. Best fifa YouTuber by far
Hazza Khan	Go pro tournaments and vlog it then u can still upload
Eivind Hjelle	What a video you‚Äôr bestü§ôü§ôü§ô
BossiestCarrot	Should I buy prime Larson  or baby seedorf
Mohammed Thabet	Can we see the players‚Äô stats
ReaLteC Funny Moments and Stories	YOU SHOULD GET 93 EUSEBIO. he is straight a god
OJhdGamer	Hey Skillz - give Petit a try - best CDM
Bruno Griffin	‚ÄúBlanc blanc blanc‚Äù he only talks bout him ü§∑üèº‚Äç‚ôÇÔ∏èü§∑üèº‚Äç‚ôÇÔ∏è
Andrea Dimech	You And Nick28T are the only Youtubers I follow these days. Love Your Content!
»òtefan	Buy Messi as a super-sub. Like so skillz will see this.
Leon Mc	Skillz is all about that guaranteed money from clicks, he doesn't want to risk going to a tournament, losing, & leaving with nothing. That's the real reason he won't take part in the pro scene.
jackane de jonge	gullit?????
Kevin Rodriguez	Skillz if you want like shooting and passing why not get lampard
noel semlan	just played wl, were 2-0 down until the 83 min then turned to 3-2. i listened to your tips man and god they really help dude, Love you channel bruv
Baylen Walden	Hey aa I just packed messi on my birthday #luck btw love the series
Loze	Gullit?
Mustafa Noor	congrats skillz 1.7 million
Elliot Harris	Yo skillz what the kits u use?
Aiden Mostofi	Why not gullit
MyDadLeftMe 123	Do whatever makes you happy skillz! Btw where the Wolves career mode on the second channel?
Holtys kid	I‚Äôm 16-5 right now I need 7 wins out of 9 games for elite 3
D R	Skills when u doing the poor man?
mohd ameer	What stadium do you use?
wicked skengman	Sell ur America de cali, Orlando pirates, Lincoln city and Plymouth argyle players they all go for like 9.5 k each I made 230k from it
Jacmar _	U are the best
Samuel Escamilla	This fifa is so different bros
Leifur Steinn	85th
rachad khairallah	skills whats your in game camera
James Wilson	Gerrard is shit
JonYT	Nice
TheOneYoshi	I have 1.5 mil and lucas potm can anyone suggest a team for me to use
Joe Shep	Should have got guillit
Emmekai Green	Did you vlog the theme park for the 2nd channel ???
Cristobal Correa	Put the actual numbers to your players (Cristiano number 4?üòÇüòÇ)
James Tran	MVP MVP MVP
AF10	F to pay respects for stevie G
Kivan Jahangiri	I hit gold 1 for the first time ever, I went 20-8. I know its bad but its a huge milestone for me
Jacob Hollyoak	You so good!
Daniel Rounce	I live for your videos, it's like my religion to watch them everyday
crispy-Z Ibn	skillz get leroy sane
Duckoslorous 123	Fthird
A.T A.T	Were are the "so early the video is still private" comments
IP Daily	BOOYAH Nation stand up
Jamie Raffan	Means a lot to all us rangers boys aswell love Steven Gerrard we do
Amit Moskovich	Show your custom tactics !!
sorucha	Wassup booyah
Chaotic _kai	63rd
Vito Tomas	WE WANT A POORMAN TO GLORY
Kxeran	Get inform Neymar
Marcus J√∏rgensen	Stop talking just to talk...
Eric Sabou	WHERE'S THE RTG POOR MAN EDITION?
Ali Masoudi	LOVE THE CONTENT SKILLZ! Kepp going!!!
Sonsen18 Hansefrans	Nice vidio
Ashley Farnaby	Get Lampard
Jack Beirne	Is mbappe worth it
Cam sandhu	Streamer loot
Julian-Specific Sportgames	Insane card Matthe√ºs  is great icon really nice video skillzüëä‚öΩÔ∏è
Maybe Just a Fail	Buy icon left back petit
Arjun Sansi	‚ÄòIf it ain‚Äôt broke don‚Äôt fix it‚Äô
TheSpecialOne15	What are his camera settings?
Joshua Ponce	lets goooo
Zain Yasir	Actually 1st        I‚Äôm joking         I‚Äôm not but who actually cares we come to support skills and he entertains us
Samuel	Like - PS4 Comment - Xbox
Javier Leiva	First
Gaming Warrior 75	Unsubbed u sold Gerard
Erlend S Skiftestad	Yes
FBI123	LEGEND
Henos Habtab	1st like, view, And comment
Haig Conroy	Great vids
Pang303	Roses are red violets are blue subscribe to me or I‚Äôll shank you x
Hish	Just buy Guillt and win everytime..
One Shot226	Everybody up this late?
Lawson Agar	I finished in silver one
dave hea	FIRST VIEW LETS GOOOO
Tamer Nasrallah	Reply pls
SkillKid - Tricks - Flicks - Gameplay	Like and you‚Äôll pack prime gullit!
Alpha Batch	Donkey batch
Dogs with Sunglasses	Shove it up me bum
Suhayb Ahmed	Your a legend
Scott Hosick	Skills the beast‚ù§Ô∏è
yepthatisagreenpeanut o	Yooo big fan over here
Victor Sveistrup	Hej skillz
Dylan Moran	Nice vid skillz keep it up
Legaming49	First comment , love ur vids skillz
Rehan: KSI	Yo
Radu Alexandru Groza	nice
Mohannad Faris	Aa9skillz
Leandro Pereira	First
Kenny Coker	First like and commer
Ahmed Salah	Love you man
Jure Gornik	Yooo
FATALxGAMING	Second
J P R	It‚Äôs your boy double a nine skillz
I Bazza	Hello
Chandler Cash	My guy
Cass Llama21	Legend
joao pires	first
