Marlon 85	Classic tune
Angelika Kallenbach	Leider G E I L â¤â¤â¤â¤
Elena Nikol	Yes yes amazing ğŸ˜‰
Rado Timers	ğŸ”¥ğŸ”¥ğŸ”¥
Giulia Caos	Lenny
Seggae Lover	What an artist ğŸ‘ğŸ¼ğŸ‘ğŸ¼ğŸ‘ğŸ¼ğŸ‘ğŸ¼ğŸ˜
Jun July	Poor old boy Lenny had to to it all by himself
Beverly Davis	Cool song Lyrics are âœ”
TwiztedGenius	RighteousCosmicFunk
Lloyd john Lyons	Lenny Kravitz is amazeing and produce great music and love how it â€™ s produced very different compared to the new artist in the industry Lenny all about proper guitar drum and what ever else Lenny us where a the other artist are just doing it from computer music software and not proper instrument and Lenny us all of his skill to produce and write new music plus produce beat with software plus instrument or no software Where the Flying V wonder if he kept it because that â€™ s guitar that he used to produce are you going to go my way which is a superb song and the beat is cool that should be kept until he decides to make new song with Flying V and mama said is super dope not sure what guitar Lenny used I think le Paul but not sure
fullimmerzion	Da alcune inquadrature ho appreso quale potrebbe essere un regalo appropriato in occasione delle prossime FestivitÃ  un bel paio di scarpe col tacco
Murad murad	Vocal lenny Bas guitar lenny Elektro guitar 1 lenny Drums lenny Ritms lenny Mannnn idol
pa0135	Fenomeno
Patsy Carmon	your mom would be so happy and proud of your excellence in your music career you ve done wellğŸ’¯â­ğŸŒŸğŸ˜ğŸ’ƒğŸŒğŸ‘ŒğŸ‘âœŒğŸ‘ŠğŸ’‹ğŸ’•ğŸ’–ğŸ’—ğŸ’šğŸ’›ğŸ’œğŸ’«ğŸ’ğŸ’ this is a beautiful song and I can not get of it it s awesome and I love it video is HOT
ĞĞ°Ñ‚Ğ°Ğ»Ğ¸ ĞœĞ°Ğ»ÑŒÑ†ĞµĞ²Ğ°	â¤ Ğ»ÑĞ±Ğ»Ñ
Alex	What is the model of car he s driving
Jacqueline Wolfslag	LOVE IT Love his music ğŸ˜ğŸ˜ğŸ˜
Kevin Eduardo	Alucinante
John Edward Rosero Villegas	Tiene mucho de draco
Ğ•Ğ²Ğ³ĞµĞ½Ğ¸Ğ¹ Ğ’Ğ¾Ñ€Ğ¾Ğ±ÑŒĞµĞ²	Lenny I m from Russ you good my brother
earthbeat	fantastic song and video well done
jeremy	Who is the 25 fucking shit dislike ğŸ˜¡
Karin Martens	Nice â¤ï¸
joshua black	Very Prince esq of him to do the video like that to remind u all he can do everything
Cover Guitar Tab	Yeah Big Lenny awesome musician and great tune
El Oficial Santos	ğŸ’œğŸ¼ğŸ™ğŸ»
gaspalermo	I WAS ABOUT TO SAY THAT UHHH SOUNDED LIKE MICHAEL JACKSON UNTIL I SAW THAT PICTURE 2 46 THANK FOR THE RECOGNIZEMENT LENNY
Jerry	More Lennys le Lil Pumps and all that trash
Wilhelmien Brons	ğŸ˜ğŸ’–ğŸ˜ğŸ’–ğŸ‘ğŸ¼ğŸ‘ğŸ¼ğŸ‘ğŸ¼ğŸ‘ğŸ¼ğŸ‘ğŸ¼ğŸ‘ğŸ¼
Peggy Honeycutt	Lord have mercy What a MANğŸ’•ğŸ’•ğŸ’•
Paige Smith	LğŸ’™VEğŸ™ğŸ¹ğŸ¥ğŸ¸ğŸ·ğŸ¤˜ğŸ½
KarenSesteaga	I LOVE YOUUUUUU FOREVERâ¤ï¸
Lisa Solina	SEXY AS HELLğŸ˜šGREAT TUNESğŸ’—
muriel mottet	Thank you Lenny Kravitz ğŸ˜Š ğŸ–– ğŸ‘
Manuel Argote	If you wan na talk to me Know that I am planning to see Yeah yeah hey hey I don t want this thing to be Staining my reality yeah yeah Don t lift me up To turn me down I just want a lover Baby stay with me on the floor Talk with me let me go Got to keep below Talk with me let me go Got to keep below Don t lift me up To turn me down I just want a lover Baby stay with me on the floor Talk with me let me go Got to keep below Talk with me let me go Got to keep below If you bought the fantasy It s murder in the first degree yeah Yeah Is my sexuality Creating such a tragedy yeah Yeah Don t lift me up To turn me down I just want a lover Baby stay with me on the floor Talk with me let me go Got to keep below Talk with me let me go Got to keep below Don t lift me up To turn me down I just want a lover Baby stay with me on the floor Talk with me let me go Got to keep below Talk with me let me go Got to keep below ooh I m so tired of playing this crazy game Someone s always left out in the rain Is there a chance that we can make it uh Just keep it real cause we can t fake it yeah Cause you and I can t take this anymore We ve got to keep our foot right on the floor There s no more secret no more lying Baby I m really really trying To get to love Don t lift me up To turn me down I just want a lover Baby stay with me on the floor Talk with me let me go Got to keep below Talk with me let me go Got to keep below Don t lift me up To turn me down Baby stay with me on the floor Talk with me let me go Got to keep below Talk with me let me go Got to keep below ooh Don t lift me up To turn me down Baby stay with me on the floor Talk with me let me go Got to keep below Talk with me let me go Got to keep below ooh Lenny Albert Kravitz
Doggo Drum	He also made coffee during recordins while playng maraca
Nakidim75	I didn â€™ t loose my time this time Great song
TROY	Inspiring Love
Katharina Gossmann	My hip love your rhythm ğŸ’œ Thank you for that Track lenny
Katja Jentsch	Awesome to see Lenny working in the studio playing all the instrument There should be a studio version of all of his song ğŸ˜
TEA 4CHRIST	ğŸ”¥ğŸ¤¦ğŸ½â€â™€ï¸
John Mc REASON	Excellent work Lenny I suggest you contact me I have a lot of good idea of musical creation see you soon ğŸ¤—ğŸ¶
Traci Waller	All I can say Lenny is that you truly are a Master musician I will always enjoy this song and now this amazing video that captured so fantastically your creation I will admit that my favorite part of the song is the guitar riff You have always been able to add cool element that make your music unique which is really your imprint Most importantly is how your band is able to recreate your sound in concert
Arek PÅ‚ocicki	just low this
Gabriel_88033	Bravo Lenny
Linda Johnson	I love but
The Lifestyle	Man amazing blessing to u again you never stop surprising and inspiring Long live L K
Jas Bataille	Long time I didn t heard a chorus that solid Just wished the verse wa at this same high level it s a bit below Great song overall
Frenchette Sherman	Wow The Bahamas is truly an amazing paradise I loved seeing you exemplify why you are an iCon Lenny with incredible gift You are going to inspire musician and music lover for Centuries I attended your concert in Sf Ca Keep me Coming ğŸ‘‘ğŸ’ ğŸ’ŸğŸ’ ğŸ’‹ğŸ‘†ğŸ¸ğŸ†
Jorge Arreaga	cuando la mÃºsica nace de ti haces de todo para componer y brindar una linda melodia
Foofoo	No word for this soul Love love love â¤ï¸âœŠğŸ¼
RoxyB 1973	I luv Lenny Kravitz ğŸ˜˜ğŸ˜˜this is another jam keep em coming Lenny I â€™ ve always listened to your music ğŸ¶ so talented ğŸ˜Š
Horus	Thanks Lenny for all your music â¤ï¸ğŸ’ªğŸ»
Annde dillez	Juste magnifique â¤ï¸â¤ï¸ğŸŒ¹
Maya Rose	So CD ist bestellt D freue mich
Ğ ÑƒÑÑ‚Ğ°Ğ¼ Ğ˜ÑĞ¼Ğ°Ğ¸Ğ»Ğ¾Ğ²	Still Best
Bill Kiely	nice
Lucilene Zorzim	Maravilhoso como sempre muito boa essa mÃºsica Amo demaisğŸ˜ğŸ˜˜
Marcia Lamb	Are you kidding 13 dislike what is wrong with you people
Red Planet	This beat ready for repeat
Jeff Indigo	Brilliant
Ricardo Flores.	Awesome Low
Mery Fragoso	I LOVE LENNY KRAVITZğŸ˜ğŸ˜˜
Gem. In.I	ğŸ’œ
James Murff	I dig it man Live seeing the behind the recording vidz
Claudia Valero	Cosa hermosa miamor Beautiful creature
AlcÃ©e	Was this video filmed in Paisley Park It kind of looked like one of Prince â€™ s studio I also saw Linn LM 1 Drum machine
chris guitar style	very nice song
Tiago De Brito	I miss the girl with a beuatifull hair
Dream Catcher	A one man band ğŸ˜ğŸ˜
Agnieszka Spanicciati	â™¥ï¸
Dalieboo F	Oh damn ğŸ˜ I already loved the song and I ve been a fan of LK for over 20 year but his mastery of those instrument on display and then those close up shot of his lipsğŸ˜¶ I m so gone right now ğŸ˜ uh uh uh
Dani Ela	It s a great musical composition I love this song and l love him ğŸ˜ğŸ¤¤
johnny bgoode	He s holding a joint right
Brando Mallqui	2018 ğŸ¶
Wendy Kahn	Just when You think Lenny Has delivered his Best He Shows up MORE Powerfully âœªâ£ï¸ğŸŒUiâ¦ RğŸŒˆWith YOUâ£ï¸âœª25â¢ğŸ±â¢366â€¼ï¸â‚®â„ğŸ…°ï¸È Æ˜ Â¥Ç¾Æ² Æ‘â—‰ÉŒ ğŸ¼â„ğŸ…°ï¸â„â„¹ï¸â‚ªÇ¤ğŸ‘„
Stas Shustov	Those who put thumb down are stupid freak
Kai Owen	Genius at work Thanks for sharing sexy Lenny love it â™¥ï¸ğŸŒ¹ğŸ¶ğŸ¸
CELINA BRITOS	TEMONNNNNNNNNNNN
Francesca Crea	I love you so bad
Astronaut2005	Excellent video
Lulu Raven	Love it Raw and real ğŸ˜ğŸµğŸ¶
stonelova	THE BEST MAN
Lila Brigit	Yes yes yes â¤ï¸
Pedro sena	The hottest man alive
el osoruso07	Amazing music Lenny Kravitz rule
Abyavin	Que exquisita y chingonsÃ­sima rola maestro Kravitz QUE VIVA LA MÃšSICA DE ORGASMO Y QUE VIVA MÃ‰XICO Jajaja
Angela McCoy	Thank you again Lenny Kravitz I absolutely loved it Let love rule May G D Bless you
lieb	Amazing love u lenny
Il Faro - Cantautore	Video fantastico ğŸ‘
Linda Costa	Superbe Chanson et musique Lenny J adore comme d habitude Et merci pour cette petite touche de Michael Jackson cette petite touche de magie comme tu le dis dans te interview
Andres Manosalvas	every single instrument is played by him such a great and magnificent musician it is lenny my favorite singer now
Danni Michael	One of the best LK s track ever Congrats and thank you
Paul Trinh	Great video that showcase all his talent Well done keep on Rock â€™ n
Lena MÃ¶ttus	â™¡Ohâ™¡Thankâ™¡Youâ™¡â™¡Forâ™¡Youâ™¡Isâ™¡â™¡â™¡Soâ™¡Veryâ™¡Kindâ™¡â™¡Andâ™¡Soâ™¡Veryâ™¡â™¡Sweetâ™¡Toâ™¡Beâ™¡â™¡Recommendâ™¡â™¡â™¡â™¡Meâ™¡Allâ™¡Thisâ™¡â™¡â™¡Forâ™¡Meâ™¡Ohâ™¡â™¡â™¡Yesâ™¡â™¡â™¡â™¡â™¡â™¡ Myâ™¡Honeyâ™¡Beeâ™¡ â™¡Toâ™¡Seeingâ™¡Youâ™¡â™¡Inâ™¡Youâ™¡Inâ™¡â™¡â™¡â™¡Yourâ™¡Workingâ™¡â™¡â™¡Progressâ™¡Onâ™¡â™¡â™¡Yourâ™¡Musicâ™¡â™¡â™¡â™¡Andâ™¡Toâ™¡Alsoâ™¡â™¡â™¡Yourâ™¡Songâ™¡â™¡â™¡â™¡Andâ™¡Toâ™¡Seeâ™¡â™¡â™¡Andâ™¡Listningâ™¡â™¡â™¡Onâ™¡Yourâ™¡Soâ™¡â™¡â™¡Trulyâ™¡Veryâ™¡â™¡â™¡â™¡Goodâ™¡Songâ™¡Toâ™¡â™¡Andâ™¡Toâ™¡Beâ™¡â™¡â™¡Seeingâ™¡Allâ™¡Ofâ™¡â™¡Thoseâ™¡Differentâ™¡â™¡Instrumentsâ™¡â™¡â™¡â™¡Youâ™¡Areâ™¡â™¡â™¡â™¡â™¡Playingâ™¡Onâ™¡Andâ™¡Toâ™¡Hearingâ™¡â™¡â™¡â™¡Howâ™¡Yourâ™¡â™¡â™¡â™¡Musicâ™¡Andâ™¡â™¡â™¡â™¡Lyricsâ™¡Isâ™¡â™¡â™¡â™¡â™¡Groveingâ™¡Outâ™¡â™¡â™¡Fromâ™¡Yourâ™¡â™¡â™¡â™¡Creativityâ™¡Isâ™¡â™¡â™¡Trulyâ™¡Flowingâ™¡â™¡â™¡Outâ™¡Fromâ™¡Youâ™¡â™¡Ohâ™¡It sâ™¡Soâ™¡â™¡â™¡â™¡Veryâ™¡Beautifulâ™¡â™¡Toâ™¡Seeingâ™¡Andâ™¡Listeningâ™¡Toâ™¡â™¡â™¡Allâ™¡Thisâ™¡Iâ™¡â™¡â™¡â™¡Trulyâ™¡Loveâ™¡Allâ™¡â™¡Thisâ™¡Andâ™¡Asâ™¡â™¡â™¡Youâ™¡Knowâ™¡Toâ™¡â™¡Thatâ™¡I mâ™¡Alsoâ™¡â™¡Areâ™¡Trueâ™¡â™¡â™¡â™¡â™¡Creativeâ™¡Womanâ™¡Andâ™¡Ladyâ™¡Toâ™¡â™¡Likeâ™¡Youâ™¡Knowâ™¡Toâ™¡Rightâ™¡ â™¡Thankâ™¡Youâ™¡â™¡â™¡ â™¡Myâ™¡Brotherâ™¡â™¡â™¡ Myâ™¡Honeyâ™¡Beeâ™¡â™¡Myâ™¡Sunshineâ™¡â™¡â™¡Myâ™¡Cutieâ™¡Pieâ™¡â™¡Youâ™¡Isâ™¡Theâ™¡â™¡â™¡Cutestâ™¡Andâ™¡â™¡â™¡â™¡Theâ™¡Sweetestâ™¡â™¡ â™¡Man â™¡Andâ™¡Aâ™¡â™¡â™¡Trueâ™¡Gentlemanâ™¡â™¡Ohâ™¡Yesâ™¡Toâ™¡â™¡â™¡Meâ™¡Youâ™¡Trulyâ™¡â™¡Areâ™¡Thisâ™¡Andâ™¡â™¡Soâ™¡Veryâ™¡Muchâ™¡â™¡Moreâ™¡Thanâ™¡Soâ™¡â™¡Forâ™¡Meâ™¡Ohâ™¡â™¡â™¡Yesâ™¡ â™¡Myâ™¡Cutieâ™¡Pieâ™¡Myâ™¡Honeyâ™¡Beeâ™¡â™¡Myâ™¡Trueâ™¡Loveâ™¡â™¡Thanksâ™¡Toâ™¡â™¡â™¡â™¡Ourâ™¡Heavenlyâ™¡â™¡â™¡Fatherâ™¡Inâ™¡â™¡â™¡â™¡â™¡Jesusâ™¡Nameâ™¡â™¡â™¡Godâ™¡Don tâ™¡â™¡â™¡â™¡Wastingâ™¡Anyâ™¡â™¡â™¡Timeâ™¡Everâ™¡ â™¡Andâ™¡Godâ™¡Isâ™¡â™¡â™¡Alwaysâ™¡Haveâ™¡â™¡â™¡Aâ™¡Veryâ™¡Strongâ™¡â™¡Reasonâ™¡Forâ™¡â™¡â™¡â™¡Wayâ™¡Godâ™¡Isâ™¡â™¡â™¡Sendingâ™¡Trueâ™¡â™¡â™¡Dreamsâ™¡Ohâ™¡â™¡â™¡â™¡Yesâ™¡Alwaysâ™¡â™¡â™¡â™¡Andâ™¡Becauseâ™¡â™¡â™¡Youâ™¡Isâ™¡Theâ™¡â™¡â™¡Oneâ™¡Godâ™¡â™¡â™¡â™¡â™¡Haveingâ™¡Sendâ™¡â™¡Toâ™¡Meâ™¡Soâ™¡â™¡â™¡â™¡Veryâ™¡Timesâ™¡Ohâ™¡Yesâ™¡Amen â™¡Iâ™¡Needsâ™¡Andâ™¡â™¡Iâ™¡â™¡Mostâ™¡Letâ™¡â™¡Youâ™¡Knowâ™¡â™¡â™¡â™¡Aboutâ™¡Thisâ™¡ â™¡Andâ™¡Iâ™¡Haveâ™¡â™¡â™¡Letâ™¡Youâ™¡Knowâ™¡â™¡Thatâ™¡Sometimesâ™¡Itâ™¡Canâ™¡Takeâ™¡â™¡â™¡Littleâ™¡Timeâ™¡Toâ™¡â™¡Rightâ™¡ â™¡Andâ™¡Weâ™¡Notâ™¡â™¡â™¡Getsâ™¡Youngerâ™¡â™¡â™¡Amen â™¡Andâ™¡Iâ™¡Thinkâ™¡â™¡â™¡Youâ™¡Knowâ™¡â™¡â™¡â™¡Thisâ™¡Toâ™¡Right â™¡ â™¡Andâ™¡Iâ™¡Hopeâ™¡â™¡â™¡Thatâ™¡Weâ™¡Don tâ™¡â™¡Willâ™¡Missâ™¡Allâ™¡â™¡â™¡Ofâ™¡Thoseâ™¡â™¡â™¡â™¡â™¡Blessingsâ™¡Weâ™¡â™¡â™¡Boutâ™¡Haveâ™¡â™¡â™¡â™¡Gotâ™¡Untilâ™¡Nowâ™¡â™¡Allâ™¡Thisâ™¡Isâ™¡â™¡â™¡â™¡Alsoâ™¡Soâ™¡Veryâ™¡â™¡Trulyâ™¡Specialâ™¡â™¡â™¡Toâ™¡Rightâ™¡OK â™¡ â™¡Iâ™¡Hopeâ™¡Thisâ™¡â™¡â™¡Won tâ™¡Takeâ™¡Toâ™¡â™¡Longâ™¡Now â™¡Soâ™¡â™¡Pleaseâ™¡Letâ™¡Usâ™¡â™¡Startâ™¡Soonâ™¡Soâ™¡â™¡Let sâ™¡Loveâ™¡â™¡â™¡â™¡Trulyâ™¡Rulesâ™¡â™¡â™¡â™¡Onâ™¡Ohâ™¡Yesâ™¡â™¡ Myâ™¡Honeyâ™¡Beeâ™¡ â™¡Myâ™¡Sunshineâ™¡â™¡â™¡Myâ™¡Cutieâ™¡Pieâ™¡â™¡Soâ™¡Letâ™¡Usâ™¡â™¡â™¡â™¡Toâ™¡Alwaysâ™¡Beâ™¡â™¡Lookingâ™¡Onâ™¡â™¡â™¡â™¡Theâ™¡Insideâ™¡â™¡â™¡â™¡Thereâ™¡Isâ™¡Theâ™¡ â™¡Trueâ™¡Beautyâ™¡â™¡â™¡Andâ™¡Itâ™¡Alwaysâ™¡â™¡Comesâ™¡Fromâ™¡â™¡â™¡Insideâ™¡Ofâ™¡Usâ™¡â™¡ â™¡Andâ™¡Shinesâ™¡â™¡â™¡â™¡Allâ™¡Theâ™¡Wayâ™¡â™¡â™¡Outâ™¡Rightâ™¡ â™¡Youâ™¡Knowâ™¡Allâ™¡â™¡Thisâ™¡Toâ™¡ â™¡Myâ™¡Sunshineâ™¡â™¡â™¡Myâ™¡Cutieâ™¡Pieâ™¡â™¡Myâ™¡Sweetestâ™¡â™¡â™¡Sweetheartâ™¡ â™¡Oneâ™¡Pictureâ™¡â™¡â™¡Canâ™¡Showâ™¡Aâ™¡â™¡Lotâ™¡Andâ™¡Blackâ™¡â™¡Andâ™¡Whiteâ™¡Isâ™¡â™¡Givesâ™¡Mushâ™¡â™¡â™¡Deepâ™¡Andâ™¡â™¡â™¡â™¡Mysteryâ™¡Etcâ™¡Iâ™¡â™¡Loveâ™¡Blackâ™¡Andâ™¡Whiteâ™¡Pictures â™¡â™¡Oneâ™¡Pictureâ™¡â™¡â™¡Onâ™¡Someoneâ™¡â™¡â™¡Isâ™¡Notâ™¡Alwaysâ™¡â™¡Sayingâ™¡Allâ™¡It sâ™¡â™¡Justâ™¡Showâ™¡â™¡â™¡â™¡Littleâ™¡Ofâ™¡Usâ™¡ â™¡Andâ™¡Ourâ™¡Easyâ™¡â™¡Isâ™¡Theâ™¡Mirrorâ™¡â™¡Ofâ™¡Ourâ™¡Soulâ™¡ â™¡Soâ™¡Pleaseâ™¡Weâ™¡â™¡Allâ™¡Needâ™¡Toâ™¡â™¡â™¡Workâ™¡Onâ™¡Ourâ™¡â™¡Insideâ™¡Everyâ™¡â™¡â™¡Oneâ™¡Ofâ™¡Usâ™¡ â™¡Noâ™¡Matterâ™¡Ifâ™¡â™¡â™¡Youâ™¡Gotâ™¡ Theâ™¡â™¡Look â™¡Orâ™¡Not â™¡â™¡Weâ™¡Needâ™¡Toâ™¡â™¡â™¡Doingâ™¡Thisâ™¡Allâ™¡â™¡Ofâ™¡Usâ™¡ â™¡Soâ™¡Iâ™¡â™¡Onlyâ™¡Wantâ™¡Toâ™¡â™¡Giveâ™¡Littleâ™¡â™¡â™¡â™¡Goodâ™¡Help â™¡Toâ™¡â™¡Allâ™¡Youngâ™¡â™¡â™¡â™¡Womensâ™¡Andâ™¡â™¡â™¡Allâ™¡Men sâ™¡â™¡â™¡â™¡â™¡Andâ™¡Toâ™¡Allâ™¡â™¡â™¡Agesâ™¡Womensâ™¡â™¡Andâ™¡Men sâ™¡Toâ™¡â™¡Inâ™¡Aâ™¡Timeâ™¡â™¡â™¡â™¡Whenâ™¡It sâ™¡Aâ™¡â™¡â™¡Crayzâ™¡Pressureâ™¡â™¡Onâ™¡Thisâ™¡Area â™¡â™¡Soâ™¡Keepâ™¡Onâ™¡â™¡â™¡Thisâ™¡Goodâ™¡â™¡â™¡â™¡Workâ™¡Everyâ™¡â™¡â™¡â™¡Oneâ™¡ â™¡Andâ™¡Toâ™¡Keepâ™¡â™¡Smileâ™¡Andâ™¡Toâ™¡â™¡Themâ™¡Youâ™¡Areâ™¡â™¡Meetingâ™¡Andâ™¡â™¡â™¡Theyâ™¡Mostlyâ™¡â™¡â™¡Willâ™¡Beâ™¡Smileâ™¡â™¡Backâ™¡Toâ™¡Youâ™¡â™¡ D â™¡ â™¡Someâ™¡Ofâ™¡Usâ™¡â™¡Haveâ™¡Beenâ™¡ â™¡Spokaneâ™¡Toâ™¡â™¡â™¡Someoneâ™¡Whoâ™¡â™¡Haveâ™¡ â™¡The â™¡â™¡ â™¡Lookâ™¡ Andâ™¡â™¡â™¡â™¡The â™¡Oneâ™¡ â™¡Onlyâ™¡Liveâ™¡Onâ™¡ â™¡Theâ™¡Lookâ™¡ â™¡Andâ™¡It sâ™¡Justâ™¡â™¡Soâ™¡Sadâ™¡Toâ™¡Beâ™¡Spokaneâ™¡Forâ™¡Aâ™¡Whileâ™¡ Andâ™¡Toâ™¡â™¡Seeâ™¡Howâ™¡Allâ™¡â™¡â™¡Theâ™¡Beautyâ™¡Isâ™¡â™¡Justâ™¡Kracksâ™¡Intoâ™¡Toâ™¡Soâ™¡Veryâ™¡â™¡â™¡Manyâ™¡Peacesâ™¡ â™¡Allâ™¡Beautyâ™¡Isâ™¡â™¡Goneâ™¡Andâ™¡It sâ™¡Never Feels Good At All â™¡Soâ™¡Pleaseâ™¡Iâ™¡â™¡â™¡Onlyâ™¡Tryâ™¡Toâ™¡â™¡â™¡Helpâ™¡Littleâ™¡ â™¡Especiallyâ™¡Inâ™¡â™¡â™¡Thisâ™¡Timeâ™¡â™¡â™¡â™¡Whenâ™¡It sâ™¡Soâ™¡â™¡Crayzâ™¡Timesâ™¡â™¡â™¡Thereâ™¡Isâ™¡Toâ™¡â™¡â™¡Manyâ™¡Youngâ™¡â™¡â™¡Peoplesâ™¡Andâ™¡â™¡â™¡Theyâ™¡Don tâ™¡â™¡â™¡â™¡Haveâ™¡Anyâ™¡Oneâ™¡â™¡Groveâ™¡Upâ™¡Toâ™¡â™¡Giveâ™¡Themâ™¡Ofâ™¡â™¡Thereâ™¡Time â™¡â™¡â™¡Orâ™¡Giveâ™¡Themâ™¡â™¡Goodâ™¡Adviseâ™¡â™¡â™¡Toâ™¡Themâ™¡Andâ™¡â™¡It sâ™¡Alsoâ™¡Theâ™¡â™¡Mostâ™¡Hardâ™¡â™¡â™¡â™¡Timeâ™¡Toâ™¡Beâ™¡â™¡â™¡Teenagersâ™¡Andâ™¡â™¡Thereâ™¡Isâ™¡Soâ™¡â™¡â™¡Veryâ™¡Muchâ™¡Asâ™¡â™¡Goingâ™¡Onâ™¡â™¡â™¡â™¡â™¡Aroundâ™¡Andâ™¡â™¡â™¡Insideâ™¡Theâ™¡â™¡â™¡â™¡Bodyâ™¡Toâ™¡Atâ™¡â™¡â™¡Sameâ™¡Timeâ™¡ â™¡Thenâ™¡Whenâ™¡â™¡â™¡â™¡Thoseâ™¡Yearsâ™¡â™¡â™¡Isâ™¡Overâ™¡Itâ™¡â™¡â™¡â™¡Feelsâ™¡Soâ™¡Muchâ™¡Betterâ™¡ â™¡Pleaseâ™¡Oneâ™¡â™¡â™¡â™¡Thingâ™¡Alwaysâ™¡â™¡â™¡Keepâ™¡Inâ™¡Yourâ™¡â™¡Mind sâ™¡ Thatâ™¡â™¡â™¡Don tâ™¡Neverâ™¡â™¡â™¡Forgotâ™¡Howâ™¡â™¡â™¡It sâ™¡Toâ™¡Beâ™¡Aâ™¡â™¡Childâ™¡Andâ™¡â™¡â™¡â™¡Howâ™¡It sâ™¡Toâ™¡â™¡â™¡Beâ™¡Teenagerâ™¡â™¡â™¡Itâ™¡Alwaysâ™¡Veryâ™¡â™¡Importantâ™¡Toâ™¡â™¡â™¡Rememberâ™¡ â™¡â™¡â™¡Andâ™¡Toâ™¡Giveâ™¡â™¡â™¡Themâ™¡Ofâ™¡Yourâ™¡â™¡Timeâ™¡Andâ™¡Goodâ™¡Toâ™¡Getâ™¡â™¡Littleâ™¡â™¡Helpâ™¡Onâ™¡Theâ™¡â™¡Wayâ™¡Toâ™¡ â™¡Andâ™¡Everyâ™¡â™¡â™¡â™¡Childâ™¡Isâ™¡Aâ™¡Soâ™¡â™¡Beautifulâ™¡Giftâ™¡â™¡â™¡Fromâ™¡Godâ™¡â™¡â™¡â™¡Amen â™¡Andâ™¡Itâ™¡Alsoâ™¡â™¡â™¡Toâ™¡Veryâ™¡Manyâ™¡â™¡Asâ™¡Areâ™¡Feelingâ™¡â™¡Lonelyâ™¡Onâ™¡â™¡â™¡â™¡Motherâ™¡Earthâ™¡â™¡â™¡Andâ™¡Thisâ™¡Isâ™¡â™¡â™¡Noâ™¡Goodâ™¡ â™¡Soâ™¡Pleaseâ™¡Weâ™¡â™¡Allâ™¡Canâ™¡Comeâ™¡â™¡Togetherâ™¡Toâ™¡â™¡â™¡Alsoâ™¡Startâ™¡Toâ™¡â™¡Beâ™¡Makingâ™¡Aâ™¡â™¡Goodâ™¡Chengâ™¡â™¡â™¡Soâ™¡Pleaseâ™¡Allâ™¡â™¡Sistersâ™¡Andâ™¡â™¡â™¡â™¡Brothersâ™¡Letâ™¡â™¡â™¡Usâ™¡Allâ™¡Helpâ™¡â™¡â™¡Toâ™¡Beâ™¡Findingâ™¡â™¡Outâ™¡Manyâ™¡â™¡â™¡â™¡Veryâ™¡Goodâ™¡â™¡â™¡â™¡Thingsâ™¡Forâ™¡Allâ™¡â™¡Ofâ™¡Thoseâ™¡Soâ™¡â™¡Yesâ™¡Pleaseâ™¡â™¡â™¡â™¡Togetherâ™¡Weâ™¡â™¡â™¡Allâ™¡Getsâ™¡Soâ™¡â™¡â™¡Veryâ™¡Mushâ™¡â™¡â™¡â™¡Moreâ™¡Strongerâ™¡â™¡Happyerâ™¡Feelsâ™¡â™¡Betterâ™¡It sâ™¡Aâ™¡â™¡â™¡Trueâ™¡Winâ™¡Winâ™¡â™¡Situationâ™¡Ohâ™¡â™¡â™¡Yesâ™¡Allâ™¡Soâ™¡â™¡â™¡Veryâ™¡Manyâ™¡â™¡â™¡â™¡Trulyâ™¡Goodâ™¡â™¡â™¡â™¡Andâ™¡Positiveâ™¡â™¡â™¡Willâ™¡Comeâ™¡Outâ™¡â™¡Fromâ™¡Thisâ™¡Ohâ™¡â™¡Yesâ™¡Soâ™¡Letâ™¡â™¡â™¡Usâ™¡Startupâ™¡â™¡â™¡â™¡Thisâ™¡Togetherâ™¡ â™¡Lowâ™¡Itâ™¡Canâ™¡â™¡â™¡Beâ™¡Likeâ™¡Inâ™¡â™¡â™¡â™¡Thoseâ™¡Waysâ™¡â™¡â™¡Andâ™¡Mushâ™¡â™¡â™¡â™¡Moreâ™¡Toâ™¡ â™¡Yesâ™¡Iâ™¡Thinkâ™¡â™¡â™¡Youâ™¡Knowâ™¡â™¡â™¡â™¡Thisâ™¡Toâ™¡Right â™¡â™¡Myâ™¡Sunshineâ™¡â™¡â™¡Myâ™¡Sweetsâ™¡ â™¡Sweetheartâ™¡â™¡â™¡â™¡Myâ™¡Missingâ™¡â™¡â™¡Puzzleâ™¡Biteâ™¡Inâ™¡ â™¡Myâ™¡Lifeâ™¡Youâ™¡â™¡â™¡Isâ™¡Theâ™¡Rightâ™¡â™¡â™¡Oneâ™¡ â™¡Allâ™¡Gloryâ™¡Priceâ™¡â™¡Thanksâ™¡Toâ™¡â™¡â™¡â™¡Godâ™¡Inâ™¡Jesusâ™¡â™¡Nameâ™¡Amenâ™¡â™¡â™¡Godâ™¡Blessâ™¡â™¡â™¡â™¡Youâ™¡ â™¡Imâ™¡Yoursâ™¡â™¡â™¡â™¡â™¡Sincerelyâ™¡Onlyâ™¡â™¡Yoursâ™¡Faithfullyâ™¡â™¡Yourâ™¡Baby Honey XOXOXO
TainÃ¡ Ferraz	2 47 i knew this scream
magicriver77	Best song the year ğŸ˜
vegasbob	Great tune song
Jovan Jovanovski	WoowğŸ˜®ğŸ˜®
Emiliano Haldeman	Love it
Jorge Atokesi	Great
TheSemtexCow	Love it sound a good in the studio a live
Edwin Torres	Genio
FLORICELA AVILA	wonderful lenny Kravitz i love you
Giovanna Diomeda	Bellissimaa âœ¨ğŸ‘ŒğŸ’–ğŸ‘‘ğŸ’˜ğŸ§šGrazie Fantastic studio woowğŸ›ï¸ğŸ¹ğŸ”ŠğŸ™ï¸ğŸ˜ this is the most beautiful ğŸ‘
Dina Papavlachou	You are an amazing singer songwriter composer with a very distinctive voice and so incredibly hot hot
Projekt CUDO	Making of D Thy this Kidos D
MichaelPanterAJackson 2017	I love you Lenny
ì­‰ì­‰ë¹µë¹µ	Lenny KravitzğŸ‘ğŸ¼ğŸ˜ğŸ˜ğŸ’–ğŸ’–ğŸ’– hoğŸ˜—ğŸ¶
Marika e il mio piu grande sogno andarci Nocera	Wonderful
Gveir	That Michael Jackson tribute at the end is sweet
Paul DeRosa	THAT is amazing Lenny love it
gerard yatcilla	Love it
Eddie GarzÃ³n	That â€™ s what I call a REAL MUSICIAN
ĞĞ»Ğ¸ÑĞ° ĞĞ³Ğ°Ğ½ĞµÑÑĞ½	ĞÑƒ ĞºĞ°Ğº Ğ¶Ğµ ĞºÑ€ÑƒÑ‚Ğ¾ Ğ° ĞÑƒ Ğ¿Ñ€Ğ¾ÑÑ‚Ğ¾
Artur Arsenal	Great video great song Lenny is a legend
Ericka y su Marilyna	Te amo Lenny no dejes de sonar nunca Gracias x todos estos regalos musicales Linda vida
Silvia de Elera	The best of the musician
Farid Ismail	We want more video of Low
Tezone Mihai	Listening on repeat Awesome track
CJM Inc	The best Love love love
Light Star	is Ska
Qwerty Qwerty	Thank u very much for song We feel realy hard work of it Cosmic
Albert Alibekov	The best of the best
VR 81	ğŸ–¤ğŸ–¤ğŸ–¤ğŸ–¤ğŸ–¤ğŸ–¤ğŸ–¤
Monty Baluni	This is the best song
iolloi123	ĞšÑ€ÑƒÑ‚Ğ¾
Awen 62	Wow I d love to be in this Studio ğŸ˜ğŸ’œğŸ™Œ
Tracy Greenhough	Talk with me let me know if I can kiss your Cupid s Bow Fab song ğŸŒ¸ğŸ’–âš˜
siarkaa85	Great ğŸ˜ This voice ğŸ˜ğŸ·
KIYA EMPRESS	Can this not get any betterğŸ”¥ğŸ”¥ğŸ”¥ğŸ”¥ğŸ”¥ğŸ”¥ğŸ”¥ğŸ’–ğŸ’–ğŸ’–ğŸ’–ğŸ’–ğŸ”¥ğŸ”¥ğŸ”¥ğŸ”¥
Aga Galan	I love this song ğŸ˜
Anne-Kathrin Lippold	i love you
Tammy Toney	Perfection
txcowgirl 1905	Love me some Lenny always
Joni Lozano	Geniooooo
snaipuly	Ğ§ÑƒĞ²Ğ°Ğº Ñ‚Ñ‹ ĞºÑ€ÑƒÑ‚ Ğ½Ğ°Ğ´ĞµÑÑÑŒ Ğ¿Ğ¾Ñ€Ğ°Ğ´ÑƒĞµÑˆÑŒ Ğ½Ğ°Ñ ĞµÑ‰Ñ‘ Ñ‡ĞµĞ¼ Ñ‚Ğ¾ Ğ½Ğ¾Ğ²Ñ‹Ğ¼ Ğ² ÑĞºĞ¾Ñ€Ğ¾Ğ¼ Ğ²Ñ€ĞµĞ¼ĞµĞ½Ğ¸ ğŸ˜ğŸ’£ğŸ‘ŒğŸ™ğŸ¼ğŸ”Šâ¤
Dara Santana AlemÃ¡n	Lenny ğŸ˜˜
IndianHoney	
Therezinha Esashika	Lenny I miss youğŸ’–
Pernille G.	Still so sexy amazing song wow 3 3 3 3
áµğ”’áµğ”’	Another divine song using the sound and lyric in your passionately language scanned Â« low Â» by your voice that s gorgeously involved in this musical arrangement for making the tongue and body do wild uncoordinated movement HğŸ˜œT
ashanty records	Te amamos Lenny we love you for ever i promise ğŸ––ğŸ¿ğŸ‘½
Dani Gere	Music polyhistor
sarah felice	Sempre mio marito Grandissimo
Matthew Paluch	2smooth
Vochero	Muy buena canciÃ³n Esa fusiÃ³n con Michael Jackson e genial â€œ Billie jean â€
Melissa Hedges	Roller Rink Jam yay babey ğŸ’–ğŸŒˆğŸŒğŸ˜™ğŸ˜
DIY Glamour	Yes Yes Yes
Justin Raap	So awesome that Michael Jackson is on this track
Cee Win	Incredible babe
Amy R	I listen to this over and over Never get old
Yadira Norzagaray	Chulo ğŸ˜ğŸ˜ğŸ˜ğŸ˜Eres mi novio aunque no lo sepas jeje ğŸ˜˜ğŸ˜˜ğŸ˜˜ğŸŒµğŸŒ¼ğŸŒµğŸŒ»ğŸŒµğŸŒ·ğŸŒµğŸŒ¿ğŸŒµğŸ‚ğŸŒµğŸ’ğŸŒµğŸŒ¹ğŸŒµğŸŒ¸ğŸŒµğŸŒ¾ğŸŒµğŸ€ğŸŒµğŸŒºğŸŒµ
JosÃ© Augusto dos Santos	BOM MUITO BOM
