Michael Athanasakis	Big Love from your friend Michael from pefkos 3
Justin de Guzman	overcompressed
YJ Beatz	Too much reverb but aightttt
Hassan Ali	This is a banger
Touro Beats	This beat is a mazza
Jack Sparrow	Auto tune com
Prince Samateh	No lie some fire ğŸ”¥
Acesiz Official	ğŸŒŠ
sara Nahar	ğŸ”¥ğŸ”¥
Predator // Road to 1k	2 2 5
HAMZ_69_X #GANGSHIT	HE S WEARING ASCO S GLASSES
Riaz Bawa	BIG TUNE WAVEY MESSY FIRE
TheRicksta89	ğŸ”¥ğŸ”¥ğŸ”¥ğŸ”¥ğŸ”¥ big tune
Khaled salehimajd	Cringe
OutGunnd	Forest gump btec edition
Leon Sesay	This is the lick ğŸ”¥ğŸ”¥ğŸ”¥ğŸ”¥ jheeeezze
Reah Mckenzie	SO PROUD OF YOU KEEP doing your thing little bro ğŸ’ƒğŸ‘ğŸ’£
Erick Patrick	This is a banger love this song bro do your thing head high and keep going soon blow ğŸ”ŠğŸ”Šsoon blowâ¤ï¸â¤ï¸â¤ï¸
mohamed aden	mad ting if you like this song put a like
Queen. KJ	Ummmm good
Nouh Abidar	â¤â¤â¤â¤ğŸ‘Œ
Guleid Ali	ğŸ™†â¤ğŸ‘…
Co Hort	baby can I get your i g ğŸ™„ Why not ask for her phone numberğŸ¤”it s quicker than getting reply from your D msğŸ˜
Shaya Warren	so good
TjFerroVEVO	50 view ğŸğŸŒğŸ’•
Agartha Frimpong	Here b4 all the snapchat hoe put this on thier snap
500 Subscribers without A video Challenge?	banger
yusuf abdi	Okok
SpartanBeatz	YouTube â€™ s broken again 35 like 23 view
Nona Nena	Ù†Ø¬Ø¨
Music 2018	Here before 1M view
Rana Uarbe	Frist
Nicole Frederick	Ay this is lit ğŸ˜
GewAway Playz	First to like
Harvey Dierden	Tune
Smallz DRudeBwoiOfSoca	Second
Eesa Gaming	First So sub to me If I sub to me you â€™ ll be very rich soon
rui Andrade	Number 1 my g make me famous
Luke Shh	First to Day how your day wa
Jennahhh Ayy	ğŸ’—â˜ï¸âš¡ï¸
young warren	Love this song 10th
Demi Jade	First comment xx
Queen Selma	ğŸ¤©ğŸ¤©
Mickz.2bunny	First
Shot_dem_down Fortnite	First
shinya the ninja	Second
XLewis Matthews	Lit
Harri Hanley	First
Zain Faisal	First
