Beard Man	Wow this is almost spot on The only thing missing is someone screaming in my face
Ben	Allie why can you not understand that if you let the left destroy GAB like they did alex jones it s a matter of time until they come for you
Larry Keel	This is exactly what the Democrats are about I love it I m glad I m REPUBLICAN all the way
Avg Joe	Nothing fake about this
MiShellF2003	We will question your intelligence sanity
Michael Andrew	Not gon na lieâ€¦ I â€™ m sold
gailen carothers	Flapdoodle and blonde to the bone
RoxySit	You have my vote
Apollos 02	Fake She s to hot to be a Democrat
KidBlueRB27	CNN approves this message
Martin Price	Democrats Domestic terrorist
Default Name	Absolutely brilliant And true
carmello12	Good job Allie
Steven Stritenberger	Perfect lol
Harjaz	man the glass
John Sagnella	Fairly accurate
Ben Joiner	Socialism because every person in the country should give every penny they have to Bernie Sanders I m sure that ll be just fine
Jew Slayer	The left can â€™ t meme
jbw5485	The accuracy is so spot on
Erth Mann	Actually she may be a little too far to the right for some of the actual drone in the new democratic party
Bo PITBULL	Awesome I m sharing this
Johnny DiPP	Brilliant And sadly true but hilarious Lol
Jadin Andrews	The only problem with this ad is that you didn t disclose your 0 01 Cherokee ancestry then it would have been 99 91 accurate
Olivia Oreilly	Hilarious
Craig foo	Well doneğŸ˜€
James Li	Oh hahaha I love this video and this girl so smart
Mortox	the first honest Democrat Party advertisement I ve seen in decade
tpm369	Right on
SpearChuck777	In 1962 the US Supreme Court judged the Bible unconstitutional in public skoo That act of rebellion gave the Legion of Lucifer see Saul Alinsky s forward to his book Rules for Radicals permission to socially engineer God out of the life of His child What followed wa Studio 54 the drug culture free love AIDS STD s crack coke out of wedlock birth Margaret Sanger Playboy Penthouse Swank magazine ganstuh rap and the KKK A generation later Liberalism enjoys what it did to create it base voter
Adolf Hitmaker	I m shocked they haven t removed this yet
Cuck-a-Cola	1 40 It s time someone wa finally brave enough to say this for the billionth time Republicans are racist
nathanlief	Love the Clinton thumb at the end
CNN	This is treasonous
Friedrich	So tolerance will fed you
Fredrik BjÃ¶rklund	Hilarious So much truth in this
Bruce Snell	PRAYING Jesus Christ Jesus show yourself mighty to your people Lord there seems to be no way out no way to fix thing no way of solution but Jesus you are the solution you are the truth you are the love and forgiveness you are the author and finisher of all great thing Jesus if you can raise a nation up and take it down in a day then Jesus can you not heal our nation and our people Yes you can we praise the name of Jesus Jesus quickly reveal yourself to u that is best for each one of u touch u the only place that you know and can touch Jesus can you not minister individually to each person the only way that they can be ministered to Jesus are you not greater than any and all calamity and evil Jesus where a man see no way out your spirit testifies that you Jesus you are the only way out Jesus you are the author and finisher of all thing great and small Jesus help u receive your perfect and perfecting love and forgiveness of the cross Jesus you told me that if we could fully receive and understand the love and forgiveness of the cross we would be transformed a a new spirit a useful witness for Christ Jesus Jesus we pray that you answer this prayer that we receive THE FULL PORTION of your perfect love and forgiveness of Jesus Christ Jesus we praise your perfect love and forgiveness Jesus we pray for personal and professional revival Lord Jesus not only doe it have to happen in our heart it ha to happen in our family and in our workplace Lord bring u to where your people are there s no greater ministry then in our own family in our own workplace Jesus show u the way to your fullness Jesus you said to pray for the greatest gift to prophesy to strengthen encourage and comfort our people to help raise them up Jesus we repent of godless chatter a lack of faith Jesus we need the faith the size of a mustard seed to plant our faith at the altar Jesus you will grow our faith Jesus help u be the great communicator of your love and forgiveness your faithfulness Jesus Christ we pray that you come quickly we need you and praise your mighty name Jesus our Lord and Savior Jesus come quickly Jesus we cry out for repentant heart and spirit seeking the perfect love and forgiveness found only in Christ Jesus Jesus is not the simple gospel can be a simple a the perfect and perfecting love and forgiveness of Jesus Christ Jesus is this not available to all people saved and unsaved Jesus we pray for this great awakening correction direction pointing to Christ Jesus a Lord and Savior The name of Jesus is above all name the name of Jesus identifies the God we serve the God that can save forgive u of our sin and love u into eternity now and forever Jesus can not the zeal of the Lord accomplish this great revival harvest this great harvest and free our people from captivity of the world and the evil one Jesus not all is lost but always gained we hear that this is the greatest time and harvest that the world will ever see Jesus Jesus quickly come Jesus we are standing in victory and not in defeat because the victory wa won on the cross let u praise your great name the name above all name Christ Jesus our Savior and Lord amen and amen I AMen
FIXIT THIS	I now am a dumbassacrat Sold on BULLSHIT WHERE ALL MY FREE STUFF AT
asdfasdfasdf	That s the longest ad I ve ever watched
Berrot McMusing	I don t know why dems wouldn t use this video a is a a campaign ad
Enervated Gamer	Is this a joke
Antney Fatts	I LOVE YOU That wa insanley awesome to say the very least
BSME2010	Brutal And absolutely on point Well played
Kokozo	Awesome Sending this video to all my acquaintance MAKE SURE TO VOTE AND VOTE REPUBLICAN
Mata Pendejos	As the day pas and I witness the insane deranged and criminal behavior of the liberal left I am convinced more than ever that the election of president Trump wa the right thing for the future of America Trump 2020
100fredkrueger	This is amazing The Dems make me sick They hate America and they hate all of u I can â€™ t believe there are so many idiot in this great country
crunchybobjones	LMFAO
Dan Rush	you forgot antifa sending out pipe bomb to democrat
F Ramsey	Now that s telling it like it is I send link to a liberal friend I am now permanently banned from her life Oh well
Exit13	I only wish the repubs had ball enough to run this on Nat TV
Sgt. Airborne	Lol
gregman01	Wow Thats about in encapsulate in a nutshell wrap it up and take it home
Kimberli Carter	Are you kidding me Your a joke
scrumb	No due process Fuck off go to Canada
JOHN EDWARDS	I love this go Democrats
Jacob Galvan	would a Democrat admit this is their behavior
Rev. Gunn	LOL great commercial
Cowterminator	ya won my vote
Todd Karrick	Now that wa a great way to start my day Good ol humor
The Shocker	3
Eric Zabinsky	She nearly lost me when she related democrat to peace and goodwill Maybe some but not the one s in the street constantly whining protesting and tearing crap up Great vid
Paul Cavigliano	Now thats a slice of fried gold
Robin Johnson	SAVAGE BUT ğŸ’¯ ACCURATE VOTE RED 11 6 JOBS NOT MOBS ğŸ¦…ğŸ‡ºğŸ‡¸ğŸ¦…ğŸ‡ºğŸ‡¸ğŸ¦…ğŸ‡ºğŸ‡¸ğŸ¦…ğŸ‡ºğŸ‡¸ğŸ¦…ğŸ‡ºğŸ‡¸ğŸ¦…ğŸ‡ºğŸ‡¸ğŸ¦…ğŸ‡ºğŸ‡¸ ğŸ‡ºğŸ‡¸ğŸ˜ğŸ‡ºğŸ‡¸ğŸ˜ğŸ‡ºğŸ‡¸ğŸ˜ğŸ‡ºğŸ‡¸ğŸ˜ğŸ‡ºğŸ‡¸ğŸ˜ğŸ‡ºğŸ‡¸ğŸ˜ğŸ‡ºğŸ‡¸ğŸ˜
wt f	FANFUCKINTASTIC LOVE IT WELL SPOKEN WELL WRITTEN BRAINS AND BEAUTY
Van Tastic	Terrific work Allie and soooo true
todd taylor	Perfect
LaFmAn9	Nailed it ğŸ‘Œ
Saturday Morning	As npc3214532 I support this ad It s so good I am literally shaking
Vox Quod	If there â€™ s one thing that tie all Democrats together it â€™ s hypocrisy Vote Red The Left is Dead
Mark Smith	Perfect
mclive25	Daaaaammmmmnnnnnn Shit just got real
Charles Fox	I dunno I don t think that she is a real democrat because she is speaking the truth
Osvaldo Maysonet	Brilliant
Chuck Littleton	Spot on the best political explanation I have ever seen in my 75 year Now I fully understand why the democrat have a jackass a a mascot and used a a party representation
Sean L	Democrats reject Christianity and Judaism They are cool with Islam though
Robert Vongartzen	This is the truth and reality of the socialist communist radical party of the pathetic Democrats the party of loser And the sad part of it they are loser the party of crony capitalism of loser and winner
I am His & He is mine	One of the best parody I ve ever seen well done Their hypocrisy is displayed perfectly
Martin Taggart	Awesome Can we get Hillary in this one She d guarantee a conservative win
Bellerophon2200	The thick rimmed glass were a nice touch lolol
Doofacis 27	Allie Awesome 493K view but only 8K subscriber shadowban
Astroknott 58	Love it And so accurate
A B	demo rat should be their name lol
Mark Molter	Actually correct characterization
RJ	Perfect
Ronald Foose	Rofl good stuff
Nathan Strickland	Lmao THIS really could be a democratic campaign add at least they would be telling the truth for once Lol
Ultimate Warrior 77	Hahahaha
Bob Dunchad	Hilarious
omaxman1	This is maddening because of how true that is
beachlover	Truth in advertising
Alex	This is truly the most honest representation of the current state of the democratic party
Ivan Shivolski	The funny but scary part this is so real
Cliff Mccutchan	As of 10 25 18 235 butt hurt snowflake nonamerican baby murdering lefty hate this real life ad Why Because it is So true
Becky Ringkamp	Ha ha ha ha hahaha
Chris Edwards	This is gold 100 spot on with their agenda
Lyle Rural American	New sub Good job
Malicxy	This wa such a great add It now make me want to get out and vote on November 6th 100 all Republican I m not a Republican or a Democrat Though I can t stand the leftest agenda To all Independents unless you have a great Independent candidate running in your area Get all the Dems out of office
Bruce Biggs	BAAAAAHAHAHAHAHA tagged up on every point Hilarious sarcasm enjoy it while we can
Denver Hardin	If this were real I d actually believe the Democratic side for once
Western Horse Watchers	Well done
Mike Lintner	I wa compelled to become a subscriber Your messaging is genius ROFLMAO
Joe Rockme	Demorats is the dumbest people on earth
Steelers Superfan	All lie ALL LIBTARDS DO IS LIE
Sergio Braga	Great ad Party of Love and Tolerance LMAO
JWL 2002	Spot on
James Lundberg 2	False bull shit go away
chico	Lol funny vid but I couldn t say I wa representing those fuck without some serious medication Bill Clinton is a rapist
uare you	Put this ad on television
cr500mike	Oh look there are 226 democrat who didn t like this Dems you should report her to youtube and try and have her banned for telling the truth
Ronnie Stanley	Im offended that she placed a flag on the end porch scene Thats racist and insensitive to immigrant A real Demacrat campaign ad would never have a racist American flag in it what are you thinking
SonnyGTA	Hahahahah SUBSCRIBED
Don Altemus	How â€™ s come all the conservative woman are smart and attractive
Adrian C	Damnnnnnnnnn That go straight to the nerve Beautifully paced and nuanced More picture of the downtrodden mass in Hollywood though That is such a killer point and need more signposting It s Orwellian
Darren H	Nailed it Bravo
eyedonschott	Blue Meanies not this season
USA FIRST	DEMORATS FUCK U AND YOUR ILLEGALS ğŸ–•DIRTY RATS MEXICANS LOLğŸ–•ğŸ–•ğŸ–•ğŸ–•ğŸ–•ğŸ–•
Joey546	The subtlety of a semi truck
Anton Monteleonus	Totally false You are fake Lmfao
The Crack Cat	Wuuunderful You Go girl
Zip Zenac	The party of love and tolerance then this feminist butch say fascist with such hate ha ha
ã€LÑ”lÏƒÏ…cĞ½ VÎ¹ ÆÑÎ¹Ñ‚Î±Î·Î·Î¹Î±TMã€ Æ¬Ğ½Ñ” ImmÏƒÑÑ‚Î±l DÒ½É±ÏƒÉ³ EÉ±ÏÒ½É¾ÏƒÉ¾	So cringy
easy rider	LOL that is terrific
Duel Sixxguns	The funniest thing about this ad is that there are probably some libtards who aren t smart enough to know that this is satire and genuinely agree with everything that wa said Lol
Lorraine Butcher	I laugh so hard
John bryant	Love this but she should ve dressed in a Maxine Waters costume
talltexan64	I going to be a Demonrat for Halloween but I could not bend over far enough to stick my head up my as
Purple Pick	You re a star in my book Brilliant ad LolğŸ˜Š
PIGGY WIGGY	fark ha ha ha ha
RayCanisLupus	LOL
Captain Brimstone&fire	This need to be spread before it is removed Share this video with everyone So honest on point Great video
Ken Jett	Dont you just love true honest advertising
PJS B	ROFL Perfect
Bud Wiser	I m Republican When I saw the pop up I thought here we go again Not going to like this WoW so true I actually liked it LMFAO
James Conner	Your a lie lady Trump one because he s for Americans true value
Crazy Snake	Irony is this ad will do more for the Democratic party than anything Pelosi Warren Clinton or Booker ha said in the past month
T. L.	Nice pant suit
Chris Hill	HAHAHA BRILLIANT
Les Motley	So honest so true where will you be hiding when they come after you
jackakhan	Priceless
baggerchic forever	Awwww I wa really getting into this lmao to short needed to be a half hour special at least but at least you made me laugh for 4 minute great job
V 4 Vendetta	Lol when I first heard this on the War Room with Owen Schroyer I got mad at first because I couldn t believe anyone could be so hypocritical but I thought to myself well she is a Democrat But then I realized it wa a spoof and boy oh boy wa my face red Lol
Janice Poole	I m a Democrat We have feeling too Vote Democrat on November 6th
Ryoko Habuki	Democrat party doesnt seem right
Bob Jazzman	Well since you put it that way
Ben M	This is to good
Azurulia Claremont	And people wonder why the democrat are so dishonest They really don t want you to know what they really think or want lol
GamerDaddy	Love the sarcasm ğŸ˜‚
cutwormsmith	As accurate a this video is roughly half the country will still vote for them
Michael Oporto	It s so accurate
Charles Essex	LOL Awesome
Alberto Ortiz	Awesome video We want more better than SNL by far Funny
Beast Mode	This is awesome Thank you Subscribed
Perry Lee	Demorats You can t fix stupid Stupidity is forever
joebaseball17	Awesome
Hardin Joyce	Fuck you democrat
neth ; nethanel mas ; masters	Good make me want to vote Red even more
ImperfectCitizen	Viral Worthy
mike Carr	All that s missing is the celebrity Hollywood elite in here endorsing this video Liberals dumb dumber ğŸ‘ğŸ‘
Bob Diaz	You forgot the part where We care so much about you that we ll vote for you after you are long dead
brian walrod	Liberals don t understand sarcasm and humor there s probably some Dimms applauding this
lib ural	Sadly liberal watching this are saying yeah what she said
david wilson	Making fun of Antifa and making a fake video can confuse the voter I demand that every 5 second Allie inform the viewer that this is a parody Also Allie Stuckey should have submitted this video to the government for congressional approval I guess YouTube fell asleep on this one
itscork	So accurate it â€™ s scary
Eunoia Vision	This is the sort of parody that facebook ban during an election cycle
MrUndeadEd	Brilliant
Greg Swallow	Democrats still have one good purpose get thrown in front of President Trump to stop a bullet
James Guthrie	All liberal are TRASH
Chris Nolin	sacrifice yourself on the altar of progressivism haha good line
austin styles	Damn ğŸ˜‚ This girl is good She just roasted the lunatic left YouTube will demonetize video and call it hate speech
Elaine BB	I just hope all these people who are giving this a ğŸ‘ will be voting red in November and bringing everyone they know to vote a well
Larry Shanks	lol dem s are LIARS thief s and deceitful in their intent a the old sane go better RED then blue in the face dead Vote Red
raj cruze	I sadly have only one like to give i wish i had a 1000 more
Sold to be Diers	Hell Fuzzy Satuday Night Live couldn t have done a better job As a Republican you can bet your Soy Latte Ass I aproove this message former recondo sgt rock 82nd abn 11b4p 1 504 inf bn 71 74 102418 Tell a Republican the Truth you ll make them Happy Tell a Democrat the same Truth you ll make them Mad Ronald Reagan
Jeff Eastman	Haaaahaaaahaaaahaaahaaahaaa Now thats funny
Ernest Turnage	This should have hit the air at least ten time a day nationwide
Bee Keeper	30 second in aaaaaand SUBSCRIBED
Ken Brown	No normal npc will understand they are simple bot globalist clone
Bill Myers	The Femocracy a A commune where Liberty is cuntfused with security and WHITE Heterosexual MEN are subjugated to only Building EVERYTHING and Paying for it
DARIVS ARCHITECTVS	You NAILED it
UncleEarl97	This is so spot on and true I love it This will drive any wavering Democrats that have reevaluated their position away from far left Socialism and Facism and hopefully get them to think with their brain instead of emotion This SHOULD be aired a a campaign advertisement
coho slayer	Hey honey Yes dear Want to vote Democrat this time Go f k yourself dear
pgravelle	Love you Allie Keep up the great work that is the truth
Insolent Stickleback	I just now found this channel and spit beer onto my keyboard D Brilliant video
Jack Crow	I love it
dangle0921	That made my night Well done ğŸ˜‚
Gavigg75	orange man baaaaad beep beep now let s say it all together so we sound like sheep
Charles Bishop	I love this young woman Couldn t figure out if she had a dinner ring engagement ring or wedding ring but if it wa a dinner ring I would love to introduce her to my single businessman son who ha been too busy collecting mound of money to look for a pretty intelligent and funny young woman
John Lansing	Yep that cover it nicely
NPC CHAD	We are the Democrats we will assimilate Resistance is futile
Mustang .308	Hilarious Because Brevity is the soul of wit ğŸ¤£ğŸ˜ƒğŸ˜„ğŸ˜…ğŸ˜†ğŸ˜‰ğŸ˜ğŸ˜€ğŸ˜ŠğŸ˜ğŸ¤”
Lynn Sager	ğŸ˜†ğŸ˜†ğŸ˜† oh look rainbow and unicorn ğŸ¦„ love pea and bullshitğŸ’© ğŸ˜†ğŸ˜†ğŸ˜†ğŸ‘ğŸ‘
Cheryle Cooper	Perfect Free stuff over Freedom Yes ğŸ˜‚ğŸ˜‚ğŸ˜‚ğŸ˜‚ğŸ˜‚
/\non/^\ediâ‚¬	Don t know you But I freaking love you Thanks for the lulz
Teemo Jungle	mccarthyism would be better than communism better to be authoritarian about the right of individual in capitalism than the right of government in socialism
krono069	Terrifyingly accurate
eloidor	The idiot are still going out to vote thinking all they saw on this â€œ add â€ wa real
Sasha Zigrino	ha amazing
Anthony 911	Hahaha What a joke
digital . death	Subbed Let s bring back the comedy to help with all the tradgedy
josh portie	Was this Anna Kasparians ad
Mr. Jim	Boy I do hope all Republicans get out and vote in November or this mock ad won t be funny any longer
T Stelle	Ah the spokesperson for the NPCs Well isn t that special ğŸ˜‰
Roy Cox	It is so sad that it is so true
Farshid Yazdi	Clever funny and extremely well done Everything about this from the way you look glass attitude to script politics is 100 on point The exact type of offensive we need Reds lack people like you big time
Paradox Meddler	Nailed it ğŸ˜‚ğŸ‘ğŸ»ğŸ‘ğŸ»ğŸ‘ğŸ»
Madelyn Anderson	JUST THE BEST thanks for the laugh
Morden Geist	Nailed it
Dar Lawrence	This wa not funny Humor is based on truth Instead you told the Truth I mean literally You told the Truth In fact it wa disturbingly accurate
Trust But Verify	LOL good stuff
tyler gray	Try running this ad on mainstream television and see of it happens Its too real Not PC
tryithere	Sad part is it s all true
Sean Briggs	WHAT A JOKE Couldn t be further from the Truth
Thomas Blevins	Spot on Haha
michaelinminn	GREAT SATIRE
Right Side News	I ve met my troll match
Da'kinebud187	Oh I get it Irony ğŸ˜‰
khemkas lehrling	Well that pretty well nail it
geomaz35	Wish I won Mega Millions so I could pay to have this aired on every channel all day long
Commander Osis	This is scathing I love it
Yves Marthe Poinson	The best political add ever
ClumsyRoot	Not funny â€™ s not funny
lazyAZ dog	Dems Reeeeeeeeeee Me smile all smile
John Floyd	In case anyone missed it this is AMAZING satire
nemonucliosis	I m voting for Ocasio Cortez because unemployment rate is down because everyone is working 2 job
Truth Teller	All fact
reggie miller	Love and tolerance is that why your rep Madmaxine Pelosi and others are calling for being physically aggressive toward conservative Why your going after people in restaurant why a guy in Texas grab a Trump cap off someone s head and throw a drink in his face Your party is a joke and the entire world is laughing at you your a circus of clown witnout a tent
Tem S	I just found out that I m going to register a a demoncrap it s true this ha made me believe in myself again my wokeness is wokened woke now i am an evil white man I also have some ocean front property in Arizona wan na buy
Conrad Quagliaroli	I love it
xxxSPETSNAZxxx	I couldn t even tell apart if this wa a true democratic campaign ad or not pretty much sum up what they stand for
Ugh caveman	And that s how you earn a sub
Joshua Goodell	I love it so funny but so true
Art Smith	You better copywrite that before a dem steal it
Chad Gearing	I m convinced finally a Democrat who ha the gut to make an honest campaign ad
Joe BLOW#25FH3975361B	FELLOW HUMAN YOU FORGOT MOBS NOT JOBS
julzee2	Omg that wa awesome Thanks wwg1wga
Blind Squid	Oh God that wa marvelous Absolutely splendid I m in ğŸ’˜ love A great video the perpetrator s should be rewarded with free foot wash or something Brilliantly creative Wonderfully executed Flawless
sum12see	Bravo
Trey Williams	the only thing that would make this better is if that ocasio coretz gal wa doing the talking lol
Skip Pallo	Thank you Allie Well said the party of coercion a new low for humanity right next to Socialist Communism Fidel Castro and Joseph Mangala You make them proud
Gregory Brown	Cut Print It s a take Bravo Well done Thank You
SupremeHorizon	Forgot to say Orange man bad How else are people going to know you ll do anything to oppose Trump including hoping for a recession
David Ashenbrener	Haha At the time I liked this there were 201 demo that thumb saw it downed haha
Jun Acebedo	NPC crowd wouldn t like this
Crusty Marine	Small detail 3 17 3 24
Heath Mixon	I think that s the most truth I ve heard so far
StormyPeak	So far 201 illegal immigrant gave this a thumb down
David Giles	Love it
Kurt Rickerd	It s one of the big reason big government is losing a a concept everyone can see how corrupt the actor in high ranking position of these bureaucracy such a the CIA FBI really are All the while they try to act legitimate and moral The most obvious thing no one talk about is how u little people are forced to PAY them They call it taxation They try to convince you it s necessary and even legal So tell me is extortion legal Then why would taxation be legal Because they say so Ever ask any bureaucrat to provide EVIDENCE to PROVE jurisdiction Try it See what they got Nothing but avoidance of the question is what they got
Isaiah Dillard	This is awesome
jayc821505	Billy bad ass
WILL HOLYGONS	Liberals This is so FUCKING rAciST
James Arceneaux	Maybe Soros or Bloomberg will fund to put this on one of those Democratic news channel
b101aa2 (Drew Blair)	HAHA accurate AF 100 â€œ The â€œ progressive â€ who today masquerade a â€œ liberal â€ may rant against â€œ fascism â€ yet it is their policy that pave the way for Hitlerism â€ said classical liberal Ludwig von Mises 1940
nguyen van be	Never vote for DEMONRATS again ğŸ‘ğŸ‘ğŸ‘ğŸ‘ğŸ‘ğŸ‘ğŸ˜°ğŸ˜°ğŸ˜°ğŸ˜°One for LIFETIME only ğŸ˜±ğŸ˜±ğŸ˜±ğŸ˜±ğŸ˜±
Scout 805	The sign post up ahead read The Twilight Zone Nice ğŸ”¥ Burn
luckynorm100	B there ruthless lie cheat false news will let anybody in the country terrorist they don t care they re just looking for more voter that s all I can figure the Democrats have everything they need right in front of them but they don t know how to use it the complete idiot s
Mister Deplorable	because well feminism priceless
Scott Schroeder	After the day I had that wa AWESOME Sadly while I found it hilarious I â€™ m sure others will have their feeling hurt and have to find a â€œ safe space â€
Mr. Nick	So true
Dave	Awesome
amycammel	Sooooooo hilarious and insanely accurate
Swan CSS	im goona run to the poll and vote blue ğŸ˜‰Wink wink
Matthew Fox	ğŸ‘ğŸ¼ Brilliant
LancerMyMan	Hysterical Because it â€™ s true
Barbara Petersen	Thank you for pointing out how stupid the D party really is
America The Free	LMAO
Jessica Solomon	Perfect
Mary M Van Kampen	You are Awesome Alley
Magnum Mountaineer	BWAHAHAHAHAHA I saw this on James Munson s channel and loved it and wondered where to find it Now here it wa in my recommendation Hahahaha SCORE
Chris Broadway	Yup That all make sense
MAC CLIFF	Allie Stuckey you are Awesome I wa laughing the whole time That wa clean well delivered truthful and hilarious Keep up the great work Too bad Ocasio Cortez wasn â€™ t empowered enough to debate you
RaspingPompano2	You re going to have a lot of Triggered NPC
Chevy SparkEV	Did Allie join the Democratic party I thought this is a joke but what she say would appeal to Democrats a a real ad
nineball26	lol
80's Nostalgia Guy	Pretty
JackPackage	Haha good shit
Beverly Sharp	DEMOCRATS ARE DELUSIONAL VOTE RED
MmXtreme M	I want to Marry this woman â™¡â™¡â™¡â™¡â™¡
TheMaster5150	This is clickbait I m so triggered
Super Dave	Sad but true
T Sabo	Demonrats are such loser
ray konga	MAGAğŸ‘ğŸ‡ºğŸ‡¸
Eric Vonzipper	You Rock
calvin meyer	Is this a young drunk claire McCaskill true thought
Jim Lewis	Fanfrickentastick
Truth facts Logic	That wa some funny shit right there
jetsers jets	Love it
Ugitzu	Way better than SNL or funny or die
Shane Lewis	DEMOCRATS KILL THEIR OWN BABIES
R N	You produce mob and racism race baiting and corruption
Kil Uma	Subscribed
fiddlemuse	Gosh my snowflake heart YES We need to get back to the greatest of American Democrat value like slavery abortion and inner city tenement YES Saul and Marx we still love you
R. L.	Want to bet a lot of NPCs were agreeing with this up until they noticed the crtv in the corner
Jeannine Johnson	Democrats took their party over a cliff then brought the caravan to try and save it Was it not enough they tried to rip off 2016 Election
Faggotaboutit	I LOVE YOU
Jeff Carpenter	I m an Independent and I approve this message lol
Losifer	I would like to buy the people responsible for this a beer and give them a high five ğŸ˜‚ so good
Alvin Prettyman	thanks for posting it took a minute realize it wa sarcasm
SV GITANA	Hilarious and so damn true keep on preaching it ğŸ¤£ğŸ¤£ğŸ¤£ğŸ‘ğŸ»
Peter Michalski	If it wasn t so true it would be oh so funny LMAO By the way you forgot glaring hypocrisy from the list of demoncrap virtue
KSM Studios	You got a new subscriber
Mark G	I really needed this today thank you Allie
DreamVisitor	Love it Very funny also true LOL
RATED	Can â€™ t wait to vote democrat after I â€™ m dead
Stephen	HATE SPEEEEEEEEEEECH
Mildred Bradway	Dems are racist too Used to be Dem but after Obama Nany Polosi took my health insurance away Dem party can go fuck themselves in a hole in the ground
Paul Piche	LMAO
the Patriot	Dems are a wasted life I d rather take my on life than to be loooers like a Demacrap So burn in hell with the rest of your kind
Brent Winter	Very good and true
For REAL	There is not one demoncrat running for office that should get even one vote The party is nothing but traitor and terrorist
john hale	The SNL skit you ll never see
XavierKatzone	Perfection
HumbleHalfAcre	Accurately espoused
Mark Halle	Long ad A great ad to further alienate both party We could talk a long time about this But let just piss everybody off This is sooo positive Very cleverly written tho did it solve anything No Did it suggest a way to reduce the defecit No Does trickle econ work no As a middle class citizen did your tax go down or your wage go up I d like to see idea to solve some problem Wouldn t you
Tony D	That wa great you just got yourself another subscriber
Lil Rip	Well done Subbed
Nick Koski	Perfect
Thomas Scott	Yeah they re inclusive a long a you don t disagree with them then you re a Target EXCELLENT PARODY
Patrick McCarthy	Ow nothing hurt like the truth
james53721	the first sentance i had to pause it because i though i wa gon na shit my pant
MMAoracle	Jesus why am I not married to this woman
Richard Kohl	There go the red wave Dems are going to rally around this ad While I don t advocate violence I would die laughing if it wa a hoax bomb theat and it wa a dem who wa behind it Get out the sympathy vote those racist islamophobic and etc etc are attacking u
none l	I did not see any sarcasm
Mike Burch	Wow I m completely convinced They got my vote
Billy JEAN	Nailed it
Earl Styles	Love it
Billy Murray	Ahahahahahahahahahahahahahahahahahahahahahahahahahahahahahahahahahahahahahahahahahahahahahahahahahahahahahahahahahahahahahahahahahahahahahahahahahahahahahahahahahahahahahahahaha Fuck you dems
Melanie Wojak	HAHAHAHAHAHA
Americans First	Lol Absolutely hilarious
Ali Starber	ğŸ˜›â¤â¤â¤
Cary Butcher	Absolutely brilliant
Post Cancel	Best â€˜ absolutly â€™ authentic ad campaign yet not a single shred of falsehood in all three minute and forty nine second of it Straight to the point and the truth Man all of those Slave owning Woman hating Republicans should feel ashamed of themselves I say we round all of them up put them in the boxcar of train and swap out all of the minority that have been rotting in prison ALL of whom did nothing wrong and were setup by White Republican Police officer and put them in their cell their place under the crime of just a few year ago when when the Republicans owned all the African Americans Hispanic native Asians Australian Aborigines Eskimo Middle Easterners especially every single Muslim and made them labour while they raped their wife â€™ s and sold their child to even richer white people who let their white child play with them like doll Man if I only had more space to write I would list all of thong that the Republicans have done even the one prior to 1854 when they first became the party that they are and wrote all the law that make the Democrats look bad and how they forced the Democratic Members of Congress during those period not to vote for the 13th and 14th amendment Women â€™ s Suffrage Civil Rights Legislation Voters Rights Legislation Public School Integration Interracial Marriage and the protection of child to be raised by the same equal system that the majority of nuclear family espouse when adopted a infant Actually Satire above
11bravo 01A	that s not a democrat hair color all wrong matter of fact she us to many word to be a libtard they just scream cry and attack people who use fact logic and the way you walk upright total sign you re an imposter
Broussard's Trinkets	LOVE IT
Geraldine Hallelujah	LMAO
J W	Truth is the best and most effective humor
Purebredbrute	Intelligent and Beautiful Marry me please
NPC 110110001	This is the highlight of my year I think the democrat need to change their mascot from the donkey to NPC
Russell K. Bonney	The problem with this Democrat add is that it might work
Delta Foxtrot	Great GOP ad Too funny
Nexus Six	The glass are a perfect NPC touch
SSHitMan	Has Facebook put a fake news warning on it yet
L Gal	And I wa going to vote RED ğŸ˜¦ Sooo glad I saw this ad ğŸŒŠ here I come Using the word constitution and freedom are just to far over the line
Lloyd Hamilton	I m from the south A democrat lived with me I got tired of housing him Paying for his healthcare and feeding him I shot that mut LOL
Life-Row-Toll	I m pretty sure this isn t a parody
The Loose Moose	Free stuff What exactly can I get for selling my soul and becoming a lazy bastard Let me know I m very interested
The Kilo 23 Group	Marry Me Allie please
Thor Abraxas	FUCK OFF DEMOCRAPS GO TO HELL
Martin Dawson	Priceless
Justa Djimmi	About time the Democrats got a campaign message Vote Democrat or you â€™ re a Nazi racist bigot sexist bad person in need of the same taxpayer funded final solution a unwanted unborn
One mans plan	Hahahaha Screw the blue and VOTE RED
Jim Spencer	As soon a I realized she never said orange man bad I knew it wasn t really a Democratic ad Lol
Mindchapter	And you get a sub I only wish I had more sub to give
Mike D.	Allie is gorgeous
Nika Obolashvili	This is priceless
Sheila Koch	Oh no This is not at all oh my this is sad actually
ogenmatic	Four more session of electro convulsive therapy scheduled in the next ten day I â€™ ll be ready to vote a straight democrat party ticket Someone please remind me when it â€™ s Election Day tell me how to get to where I can cast a ballot
shel W.	Allie girl you killed it Love you babe keep it up
Jack Bridges	Just great
Femi Fadiran	It â€™ s better than the Democrat ad I have seen so far
Raymond Remillard	LMAO point on
Brad Martisius	Best political ad since 1980 â€™ s â€œ The Democrats are out of gas â€ I hope this appears on broadcast TV
PlasmaBurns	Trump is Hitler Only Government should have gun NPC Logic check Pass
Holly Nuckols	this is SOOOOOOO GOOD I posted multiple time She is CLASSIC
Adam Dailey	I love it
chris miller	Omg This wa the best
Absaalookemensch	I m a Democrat We re the party of slavery the KKK bigotry prejudice segregation oppression of human right When we re around lock up your child and livestock We care about you unless you re not me then to hell with you
Stalinx20	Democrats suck
J Neely	If only the left would be that honest
claridiva2000	That wa spot on
A K	I gazed in my crystal ball and I see a big strike in your future
Dwayne Carroll	Nicely done
1cor127	It bother me that some of the comment say Yeah defend the Republican moral high ground followed by And wear a short skirt next time I m definitely Not on the left and this video highlight many of the reason why but they do have good reason to see hypocrisy on the right It would be great to see both side admit their own fault instead of doubling down for fear of losing the moral posturing game Whoever doe that first just might find themselves with a lot of new supporter
JessiK	Sounds about right
Bart Swihart	LOL
Nicholas Paskauskas	Nice
Kenny H	Hahahahaha So true
yveslo lou	She said it all
BRIAN ROGERS	JUST OPEN THE BOARDER REGULATE TAX AND BE THE FOOL DEMOCRATS THAT YOU ARE THIS IS A VERY NICE PARADY KEEP VOTN DEMOCRAT AND SCREW YOUR CHILDRENS FUTURE
Pete bobcat	Just like fake news lol
BadVector1	Sad that this ha more information and a direction than a real Democratic ad doe
Scott Hill	Truth Spoken Here
Rich Santoro	I LOVE IT
Sam Baxter	Up your Ass
AKI	WOW Abolish the electoral college I consider that hate speech
cheesegyoza	I love the â€œ Bill Clinton â€ thumb pointing
Brian M	Haha This wa stupid
GardenGirl1956	Love this Well done Ad LMAO too
Selie Visa	Allie I can not find your other video Were they taken down
Scott Gecias	Can t tell how real that is the only time I heard a demacrat try to tell the truth hahaha hahaha
Eric Hoagland	I love the point thing that tied it all together Anytime anyone doe that I immediately disregard what they are saying a bullshit
OvoJ	Brilliant
NPC 30030	Orange man is racist vote blue to stop Orange Man
William Rittenhouse	I don t think the left would understand this ad So out of touch
LaVell Weathersby	Take it down Democrats might actually learn something other than a chant
Dnister Dnister	love and tolerance You hate Trump you hypocrite I WALK AWAY FROM Dems Join the movement
The Luth	That IS A spot on democrap ad
Frank Rodriguez	Very funny Jajajaja the Democrats will be very confused
Robby Helfer	Loved this Allie
Abundant Life	LOVE THIS You are Spot On â¤ï¸ğŸ‡ºğŸ‡¸
Chris Holman	Amazing
devkam13	Well since woman should always be believed 100 of the time everything she just said is true every word
Willard Lentz	NICE lol
Kraig Gustavsson	Blond Go figure
billywilliamjr	the bomb were probly paid for by Dems to take the spotlight off their radical American value hating base
Olga Macrimek	FUCK COMMIES
Hugh Montgomery	THIS IS BULL DEMOCRATS AIN T THAT COMPASSIONATE ğŸ‘ŠğŸ˜¡
soundspartan of the basket	LIKE LIKE LIKE LIKE oh and by the way I LIKE this
Keen Artist	Fan bloody tastic stuff Good on Ya An Aussie Digger from Oz
Toni Winchester	I m I Democrat and I think this is HILARIOUS
Je m'appelle Cihan	I had to mute you because it wa harder to jerk of to it while you minged Now go make me a or forget it just bend over
Audemosha	You d think by now leftist would take a different approach to their losing and divisive strategy
Workoutwithrob	I think i missed the sarcasm
Rodney Hendrix	Wait what no way a honest demorat add I can get behind Hahaha
Antonio Chiappetta	Trump 2020ğŸ‡ºğŸ‡¸ğŸ‡ºğŸ‡¸ğŸ‡ºğŸ‡¸ğŸ‘ğŸ‘ğŸ‘ğŸ˜˜
Dennis Dolley	Somebody get her off my screen
susan petrarca	Instant classic
Pro Patria	BRILLIANT
Everson1969	Democrats are the MOB
RangerCaptain11A	i feel the love
Coletrain	Wish she said the altar of the state instead of the altar of progressivism
ken karish	This should have been titled Democrat add tell the truth I think that it would have gotten 1 million view
Acton Bell	I LOVE IT so true so very true Now this need to be on mainstream TV
David R	awesome
Ohioguy 3	This so good
Silver Skater	Does anyone know how true this is It â€™ s easy to tell who are the Democrats and Republicans watching this video look at who liked and disliked the video ğŸ˜‚ğŸ¤£ğŸ˜‚
Kyle Pounds	You re not gunna change anybodies mind with that low iq nonsense Just gunna be something to make fun of for year to come
touring3d	Lol this is accurate
J  Mayse	Sarcasm sarcasm
Robert Oeser	Real life consequence http www youtube com watch v n9QW jRFmwQ
Jason Guthrie	Love it
Seung	THIS WAS PERFECT Just like Allie ğŸ˜ğŸ˜ğŸ˜ğŸ˜˜
Bayou billy	Awsome
sunsetz72	Hahahahaha yes Finally someone put it into word
Matt	So funny and accurate Then u think about it and realize how not funny it is So I am going to prayğŸ™
craigmactown	Horse Face 2 0
Barry Monaghan	Is this a joke atta girl allie Funny funny
Robert Walters	Love this True to the core
Steve Mahoney	While Republicans promise freedom we promise free stuff Simply brilliant
BleusmommyIsA RedBloodedAmericanWoman	Brilliant ğŸ‘ğŸ¼ğŸ‘ğŸ¼ğŸ‘ğŸ¼ğŸ‘ğŸ¼ğŸ‘ğŸ¼ğŸ‘ğŸ¼ ğŸ‘ğŸ¼ğŸ‘ğŸ¼ğŸ‘ğŸ¼BravoğŸ‘ğŸ¼ğŸ‘ğŸ¼ğŸ‘ğŸ¼ğŸ‘ğŸ¼ ğŸ‡ºğŸ‡¸ğŸ’¯ğŸ¦…
Mike Harrison	Wow finally a truthful campaign ad
Trump train	I love it No truer word have ever been spoken We laugh about it but the scary part is she s not lying This is 100 percent what the demoncraps stand for Vote straight Republican this November or you may not recognize our country in a year
Daniel Snedden	Very funny Thanks for the laugh
Dale Root	Lol excellent
ak harry	I about pissed myself laughing This lady is hilarious
Rodney Price	I agree FUCK Obama And every little thing he touched including Michael Obama
HarmonyTunes	I wa with her all the way up to the abortion bit So tired of bible thumpers hijacking conservatism and patriotism with religious fanaticism They are worse than the liberal socialist scum and far more dangerous There is nothing supernatural in the universe Thomas Jefferson
Mike M	if what wa said in the video wa not so true it would be something to laugh about
TheMikey1865	This is college civics gold
William Dixon	SO TRUE It s Scary
Faux Shizle	HAHA NPC s FTW
ekujj13	So much truth packed into this video
NowA NevA	I bet if a democrat saw this they d think it s a real add ğŸ˜‚
RichardRennes	How wa that sarcasm Was one single thing she said NOT true
DAB42 bridges	The NPCs will absolutely love this
Donald Nace	She is a special kind of stupid
Daniel Vinson	ğŸ˜‚ğŸ˜‚ğŸ˜‚ğŸ˜‚
HOOK & KOOK	Sums it up To me
rocksy112	Omg
CW Roberts Tablet	Ooo savage
Jennifer G	You are an intelligent woman with a great sense of humor As a woman I am so tired of being represented by those feminist
Dirk Steel	I knew this wa bullshit right away a she is absolutely fuckable
Super	This is hilarious it a shame that it true I swear the Democratic party ha all turned into Scientologists
Inked Skin Deep	129 butt hurt democrat do not endorse this video ğŸ˜‚ğŸ˜‚ğŸ˜‚
Big Mac	fanfuckintastic ğŸ˜ğŸ˜ğŸ˜ğŸ˜
Dina N	ğŸ˜‚ğŸ¤£ğŸ˜…great one lmao
mg1022797578	She â€™ s a cutie
Anaris10	Isn t it just so Well done Allie a usual
Bruce Broker	She prof the old saying that blonde are dumb BIG TIME
Molon Labe	Yea sure Democrats are the party of the klan and antifa and illegals
Deep Center Field Press	You forgot Orange Man Bad That wa the cherry on top of the vagina wrapped in femtard speak
Ronald Sliski	Dear Friends r u really buying this bunch of lie n u call yourselves a Christian nation a true born again Christian know no man born of sin is anything but a filthy rag in the eye of the 1 TRUE GOD JESUS CHRIST AND HOLY SPIRIT what this wo an is selling is a illusion of the world demonic influence SPIRITUAL death deception distraction by her father the devil so please get ur eye ear mind cleansed from this whore n trust in Jesus Christ repentance stop sinning FORSAKING all sin not backsliding into sin once u become a born again Christian love God JESUS Christ n Holy Spirit with all heart mind body AND soul 2nd love ur neighbor a yourself n read the bible king James version PREFERABLY daily prayer n communication with Jesus Christ asking Jesus Christ for forgiveness of all ur sin n forgive all evil that u have ENCOUNTERED in ur life this start a24 7 relationship with Jesus Christ n not a religious doctrine man made delusion there of false prophet deception distraction illusion devil control of man in the world be separated from the world of the spiritually dead they really don t care about ur spiritual salvation Jesus Christ Amen
Tim Tyner	120 Democrats thought this wa a real ad and got mad lol
Ian Stradian	That wa awesome Do more Do more Please do more
B Shepard	This ad is awesome because it â€™ s true
slorznovitch	The sad part of this excellent ad is the fact that the mindless lemming on the left actually believe this flotsam
James Higgins	They should act like they preach
MNZGA 57unicorn	She play the snowflake so very well Thankyou for the humour God bless you
Mark JetGator	ğŸ˜² ahhh HAHAHAHA Love it ğŸ˜˜
Robby Manuel	ğŸ˜…ğŸ˜…ğŸ˜…ğŸ˜…ğŸ˜…ğŸ˜‚ğŸ˜‚ğŸ˜‚ğŸ¤£ğŸ¤£ğŸ¤£ ğŸ‡ºğŸ‡¸ğŸ‡ºğŸ‡¸ğŸ‡ºğŸ‡¸ğŸ‡ºğŸ‡¸ğŸ‡ºğŸ‡¸ğŸ‡ºğŸ‡¸ğŸ‡ºğŸ‡¸ğŸ‡ºğŸ‡¸ğŸ‡ºğŸ‡¸ğŸ‡ºğŸ‡¸ğŸ‡ºğŸ‡¸
Blitzie 123	That wa great
Chad Rushing	Republicans have been racist ever since they feed the slave
thealien6900	Brilliant
Erle Harris	Thanks for the truth Allie Stuckey
William Tanck	had to watch it twice I laughed so hard thank s
PaulieP	Spot on
Vicissitube	Brilliant
LVMYKDZ	So far 115 Democrats have viewed this
Eddie Weaver	ğŸ¤£ğŸ¤£ğŸ¤£ğŸ¤£ğŸ¤£ğŸ¤£ğŸ¤£ğŸ¤£
Gsos Seth	Hahaha ğŸ˜‚ this is so true
Gabrielle Budd	I really appreciate you bringing up about the abortion topic Little do people know that these baby that are giving up and killed alive and body part used for scientific research and big money for the corporate big wig who pocket this for politics and big hospital dot dot dot for the sacrifice of a human being under such torture million and million of baby are killed daily under this procedure It ha to stop the Democrats once where a great party Now they have declined into the gutter With their hate and crime and Corruption We need to pray for America so people will see the truth in all of what s coming soon God Bless America we need so much prayer before it s too late
Wolf of Insurance	This is so hilarious and at the same time incredibly true and sad This is definitely going to be taken down by YouTube a it hold to much truth
Jeans Roses	which socialist candidate recently said that woman should not become mother a it betrays feminism I don t remember exactly what she said but it wa bad but I thought wasn t she raised by a mother and along the same line isn t every advocate of abortion on demand already born
Saoirse	That can t be a real DNC add She wa telling the truth They never do that
jmaedl027 jmaedl	Everything She Said Is 1000 True
Lauren 2660	Lol best campaign ad ever spot on need to run this 24 hr til the election lol
James Schrang	AWESOME Should be put on every television station Thank you God bless PRAY VOTE
joespappa	FINALLY an HONEST political add
Duke Wright	Demonkkkrats are the spawn of Satan TRUTH hurt eh blue
W1cked RcL	While I don t agree with a lot of conservative view on religion and I believe abortion is a lot more complicated than just if you re pro choice you want to kill baby I do think they should air this on national television and see who try to refute it
Daly Harnish	Censored oh wait they don t call it that in 3 2 1
Francine L Romesburg	LOVE IT SURE Kyrsten Cinema of Az didn t put this ad out LOL
Matt Cussen	So this is the field where the brainless sheep graze Glad I found it Now I know where to send the wolf
sheriff longmire	Wow love it
Ki777UMiNATii	TRUTH lmao
Myren schwartz	Genius and quite accurate BRAVO
Eric Henry	Bwaaahaaaahaaa Awesome ğŸ‘ğŸ»
Mitchel Putman	Well done young lady Lol
Shit Talking	This is as and just further polarizes side Both side paint a picture of the otherside that s not close to reality It s just a lot of bitching This girl can lick my taint
Mario Piazza`	This is a joke right
Ender	LOL
Jeremy Kay	Funny video Democrats lol
Tricia D.	BRILLIANT ğŸ¤£ğŸ¤£ğŸ¤£ğŸ˜‹
Rocketman	I see 106 Fascist Socialist dimmocrats found this page
Bobby Mccary	Outstanding ad she hit it right on the nail head and hammered it deep
IM DEPLORABLE	It is all true
Beloved	So funny I love your show on CRTV
Handiman Jay	You forgot the disclaimer â€ Brought to you by the people that want you to respect opinion or they â€™ ll beat it on to you â€
Parker Griffin	Subbed
Richard M	The democrat never looked so good
Vasil Svolopoulos	1 30 good lord you are a sexy savage allie
Rowdyinxs	LolğŸ‘
Larry Gunsberg	brilliant SHARE THIS ON FB
Trail Whale	I love it and ur so cute doing it omg ur so funny looking forward to more like this
John Castleberry	Wonderful Love this beautiful honest woman
shank williams jr	â€œ Religious people are idiot â€ should â€™ ve added â€œ except Muslims and Buddhists and Jews when it â€™ s politically useful â€
Fiucik Miselfo	Where had all the Nazis gone Long time passing
Joseph Burton	ğŸ¤“ğŸ–’lmaol
Deplorables United	This is amazing
Child of the Creator God	To bad these people are not Under Oath what a Perjury Case we would have Even so come now Lord Jesus and end Satan and his deception I could not stomach more than 33 second of these lie
Overlord	I knew this wa fake right away because the democrat don t have any beautiful woman
Simon Botte	I m a proud compassionate conservative pro lifer and I love gun weapon of mass destruction I hate refugee and immigrant who are caught in war or drug cartel I hate people who are sick a I hate Obamacare I hate gay and anyone who doesn t agree with me but I m a proud Christian conservative Republican with moral value of love and compassion to everyone just like Jesus Matthew 7 21 â€œ Not everyone who say to me â€˜ Lord Lord â€™ will enter the kingdom of heaven but the one who doe the will of my Father who is in heaven On that day many will say to me â€˜ Lord Lord did we not prophesy in your name and cast out demon in your name and do many mighty work in your name â€™ And then will I declare to them â€˜ I never knew you depart from me you worker of lawlessness â€™
Kevin Rose	Absolutely awesome
someone new	ğŸ¤£ğŸ¤£ğŸ¤£ğŸ¤£ğŸ¤£ğŸ¤£
1motomanic	Had to watch it twice so good
Bob Woodward	Bwahahaha Correct They are the party of racism facism socialism violence riot mob and total intolerance They are the party of nutz and liar and con artist and shear ignorance I wish that they would air this on The main stream medium You nailed it
Johnny Varney	I thought this wa going to be a parody
CryptoTraders	I m an NPC and I approve this message
Marc	Finally an honest campaign ad
MrGenedancingmachine	Enough with these bandwagon bimbo
diecheneydie	Fuck off nitwit
Rick in Texas	Brilliant campaign ad
Dennis Walker	ROTFPMLMFAO Hi Fucking Larious best ad ever for the Democrats
viewoftheaskew	Genius and very well done THANKS
Adrian D	LMAO
Jon Farmer	That is the most honest ad I have ever seen
Dan Smedra	Hit that one out of the park
Glen K	You ROCKED it well done Im so sick of the left
stepnfetchet	Brilliant satire an endangered art form
wamhoffjd	I wonder how long it will be before YouTube remove this video
joemama62	Allie will you marry me
Rabbi Manny Shevitz	This is the most hilarious and creative campaign ad spoof I ve ever seen One of the reason it is so funny is because IT IS TRUE F ck the Democrats They will take the United States down if you allow them to do it
dlsofsetx	Republicans should run this ad every election
Leo Hughes	If a few of your friend and family are murdered by illegal alien well that s a sacrifice we re willing to make
WJack97224	You know the commie socialist Democrats are doing exactly what wa prophesied they are destroying Amerika from within Most Democrats have bought Satan s lie The fact are that commie socialist Democrats have imposed the 10 Planks of the Commie Manifesto check it on the WWW
Dan Deyette	Only thing I like about the lond Dem is the wa her nipple put a crease in her t shirt
Bernard Ryan	Great work
Gordon Van Zandt	True statement This is exactly what DemCommies say and their brain washed mass can t see they are being used
Alison Guerriere	It â€™ s really good except baby aren â€™ t aborted because of forceps Vacuum would be more accurate
Tom Clark	Love the video but make no bone about it the Republican Party is just the dialectic to their scripted idiocracy a the criminal de facto American government continues the policy of the last administration and their global agenda of borderless nation with plan to reduce the world to a feudal Orwellian system of tyranny using commerce and technology and weaponized immigration America a we know is gone JFK wasn t just assassinated the US wa overtaken by a silent coup and we ve been under the control of corporation banker and globalists since bent on removing the only thing that give them a problem people The US gov doesn t fund Planned Parenthood for nothing It s simple learn who owns and control everything I did Learn who control the narrative Turn off the Tell A Vision and get truly informed before they complete the total censorship of the Internet Who Controls America http thezog wordpress com If voting worked they wouldn t use it
robdigioable	LOVE HER â¤â¤â¤â¤â¤â¤â¤â¤â¤â¤
Castle Rock	Greatness
HyperBandit	9000 WOKE
Tom McIntyre	Whats so great about this is the AD is FACTUALLY TRUE and CORRECT
Andrew	Democrats don t hate religion They fervently defend Islam and it Sharia law and will defiantly defend anyone who say anything bad about it
Julie Cowart	OMG hahahahaha I love this it is 100 right on
keats27	I think I m in love
ed rosa	Are you sure this is a parody
Puzzle and Dragons Bro	Sadly this isn t even an exaggeration it s literally their platform
Zane Black	Wow this is TOTALLY FUNNY Lollercoasters
Doctor Jones	Bombs have been sent to Soros Clinton Obama and CNN in the last week Tell me again about the horror of the left ripping your MAGA sign You poor poor people having to be confronted by liberal at your favorite restaurant However will you eat your French Onion soup
SithVoodoo41	Real News
StevenFromTexas	Now this ad is priceless LOL
Rushman236	Brilliant
coachsteved1	Our goal is to make the government work for you so YOU don t have to work at all lol
sm6jesse	Genius
Jonathon Stopper	Absolutely LOVE IT
Rebel with a cause	LOL Tooo Funny Allie If only the Demo Commie Crats could be this honest and funny Their Totalitarian Globalist 1984 agenda would have Castro Stalin Mao Teddy let her drown Kennedy Hanoi Jane and John I wa for the war before I wa against it Kerry doing a happy dance
Jonathan Baird	Love the video but your camera man need to learn how to shoot video There is a too much over exposed highlight
Chris Mayberry	This is amazing
Jane Feeney	Love your sarcasm However half of America don t know the difference and will still vote Democrat
Heisenberg _	Diplo is that you
Christopher  Pack	Soooooo good
Joseph Card	OMG I am going to laugh all day from this one
j p	I will chip in 20 to get this ad aired Many others would a well Get it done
Bryan Ekers	I m somewhat astonished by the blatant lie about Republicans that they respect due process and the Constitution and such Slanderous Republicans deserve an apology young lady and wear a short skirt next time
Martina Vaslovik	I ve never yet seen the Democrat platform so accurately depicted I think this about sum it up
Morpheous58	I see no satire
RAMON MARTINEZ	Brilliant
Pastor Rob Bremer	This will be shared far and wide What a perfect rebuttal of the Dem insanity
Herman	KAAABAM Spot ON Great Job CRTV And looky Only 77 retarded democrat voted this down LOL
Kevin Roe	Democrats Trump want to undermine our Constitutional norm and democratic tradition Also Democrats The Electoral College is Slavery Protect Kids Not Guns
Awad Beatty	Apparently 77ğŸ‘ Leftist nut didn t appreciate her honesty about the Democratic party Hahahaha I love it
Jeff Johnson	How is this not the most viewed thing ever on YouTube
John Callicott	SPOT ON GO RED
Greta Tagliavia	Half of me is laughing out loud at this and the other half is cry at the truth LOL Love this GREAT job ğŸ˜ŠğŸ˜˜â¤ï¸
Cheap Comedy	pretty much sum it up
Steve Holmes	Very well done thank you For putting into word what seems to be so clear about Democrat leadership and their goal
Zee 705	Watched the video immediately subscribed This wa perfect
yellowsnout	Funny because it is true Very funny very true
sapper82	ROFLMAO
Zenkai76	This is the best thing I have ever seen
Tom22	LOVE THIS
m ww	So funny but SO TRUE The Democrats are intellectually and morally BANKRUPT
kallenved	72 democrat seen that Ad xD
Ben Payne	Actually the most truthful political ad I ve seen in year ğŸ¤”
Marina Vakirlis	ğŸ˜ƒğŸ˜„ğŸ˜…ğŸ˜…ğŸ˜…ğŸ‘ğŸ˜‚ğŸ˜‚ğŸ˜‚
Xiagax	NPC 6749898 Thanks you for this message I now know what to believe and how to respond to Republicunts if the belief you told me are challenged
Efrain Adorno	Many time better humor and REALITY than anything SNL ever produced
Error Eliminator	Go to Russia better for you guy
jeff grigg	Fuck you lol the second you said you support peaceğŸ˜‚ go fuck yourself whore
Charlie Wilson	They re going to block you because their base is so gullible they ll believe anything So YT ha to police for them
33TimberWolf	Thank you for making this video It sum up everything that is wrong with the Democrats and why we must have a Red Wave to save our nation
Students for Western Culture	Well done
Mark D. Wood	There the Democrat party is without any euphomisms Golden
Jc Clayton	Great video I wonder how long it will be allowed to stand before youtube say it violates some of their imaginary community value and remove it
Rebekah-Chris S-K	Good stuff ğŸ˜‚
J K	This is just so perfect
Elim Wells	Boy that s a good one good job
Jeetman63	This is sarcasism I thought that the Dumbocrats were just finally telling the truth about their agenda hmmmp
CrassMufumbu	Can t believe the jump in view since this morning
Jeff Kam	Just a stupid puppet
Slayer	Excellent
Azul Beats	Who s here from Ben Shapiro
ayechill bro	you break mgtow spell
Symposium	Oh man a a UK nationalist I must say the satire is excellent lol
Skindoggiedog	Not funny really but very very true
Rogue Ldr1123	I sent this out over and over Hell i even sent it to hildabeast old gmail account
Filip Karwowski	This might a well be their ad Red wave is coming and the dems are gon na get crushed Hard
Darius Ravenknight	I m a believer baby Hold my beer I need to go vote now
Lorri Bethel	I wish I could like this a second time
aaron221969	I loved this So true
E Dean Cozzens	Have you ever considered running for office I d vote for you You are attractive logical and articulate and most of all you have Reagan like humor A real winner Keep learning and preparing
classicalhero7	Nice pantsuit
jusgivmeafknusername	Genius Possibly too subtle and not quite sarcastic enough though Snopes may have to put their best agent on the case
star of hope	Wow Ha ha ha
Scott Dietzel	BEST AD EVER
Kasonas	This is too accurate
CCDevlin	You could have called it an Honest Democrat Infomercial Like the channel Honest Movie Trailer Great concept
Nick Dawson Mr 306	so hilarious but so true
cosMICjester	HILARIOUS spot on
Scott Meckley	Greatest political ad I ve ever seen and I can t stand many of them one more thing I thought about when democrat run your state it s like a bunch of little kid tearing up a house but in this case a city Allie Stuckey rock
Eric the Viking	You ma am have earned yourself a subscriber ğŸ˜‚ğŸ‘
Upper Crust Of A Low Life	I need to make another account just so i can give this two thumb up
Julie Leighton	Well done
Charlie Michelsen	OUTSTANDING
Shannon Choate	Pure gold You knocked this one out of the park Allie
William Bridgeman	Not simply magnificent but true
Ruben T	Way too hot to be a dem
Andy Jayroe	Hey that s my neighborhood
Andrew Chestnut	The right is so fucking bad at satire
Larry LoCastro	Fantastic job Allie
Steve Christiansen	Lol this is the best I love this stuff true satire
randall jeffs	That wa awesome
Bro Sunshine	Good on YOU Allie now let s sit back and wait to see how the socialist left retard respond to your clearly valid point
JohnMacedoJr	Great video unfortunate that whoever filmed it didn t adjust properly or use a polarized filter Otherwise brilliant This wa filmed with a DSLR camera yes
kirkpanzer	Wow Humor I forgot we conservative could still use it You forget that when you see the people that use to be funny are now just bitter hack screaming lie And those that aren t funny having show now that use to have comedian host them Thank you It wa nice to snicker again And I think it wa funny because of the truth in it just like the old day when SNL wa a comedy show
800lbgrila	IF possible on fake MSM network this ad should run every hour 24 7 package deal OMG what if it actually made libtards to face what they really are and walkaway Perfect timing considering normies have a memory like an ant LOLğŸ˜âœ”k
Some dude	BELIEVE WAHMEN
pittchaser	Pure gold
Lori Hale	Brilliant It s everything we want to say but can t because well she said why
Solange Silverman	PERFECT
wendy303173	The best one yet Allie â¤ï¸ I am laughing so hard ğŸ¤£ Thank you
DannyK420711 Kaprelian	Funny the left could do the same video of Trump constantly calling for violence at his rally a well a applauding act of violence the right ha actually murdered people on the left so the video would half to be rated R Right Wingers RED Evil Ignorance
Debbie         Lee Rawls	Liar
T O	I love you Shared this so hard I wish people on my feed weren t so diluted and were capable of self refection god damnit
jbscotchman	LMAO
Bruce Wing	Bravo
phirephate	A ad I wish they d play this during halftime at the next football game
yesorlando05	That wa awesome lol
Akon Fenty	Lmao
Jim Gibbons	Funny because it s TRUE Damn I would be freaking out if you could not see the stupid shit Guess what I have nothing to worry about and that s a good feeling
Tom Griffiths	ğŸ˜‚ğŸ˜‚ğŸ˜‚right
Aaron Cannon	Amazing
Derek B	Genius ğŸ˜‚ğŸ˜‚ğŸ˜‚
Cobra Saboteur	Holy shit this is easily the funniest thing I â€™ ve seen all month Superb
Poisonedblade	And just like that I subscribed
Six Beer Math	So so accurate
Rebekah Green	Hilarious
Jimmers Russell	Democrats are going to have their ass handed to them very shortly Trump win in 2020 get a couple more Supreme Court pick and guess what America get back on track and it will suck as to be a brain dead snowflake But a great time to be a Patriotic Hard Working America and watch a the Great State is Defeated and Crooked Hillary Obama and their gang are indicted and found guilty Traitorous Bastards
SicSemperEvelloMortemTyrannis TyrannyEnder	So fucking real
Len Clements	I would comment a I normally do but after watching this video I m pretty sure the internet s sarcasm limit ha already been exceeded So now when I praise it for it s accuracy and wit I have to be literal That s no fun
Cockney Herbert	Bravo
josephgaviota	Thank you for this advert I ve shared with my friend
Carlos Dyonisio	Nailed it
Benjamin Eby	Awesome Allie
Calilaker CAGLS	DemocğŸ€s so much losing ğŸ˜‚
STYLER	Thumbs up because you re pretty a fuuuuuuck
mtwseneca	HOW did you do this with a straight face You are female Bud Abbott well done
Eric Torres	This is gold Thanks for the laugh ğŸ˜‚
American Patriot	Allie is so sexy even when she dress and act like a libtard feminazi LOL
adam morin	Ty so much
Richard Iwanowski	Allie your DEM ad wa positively brilliant Those view are exactly what the Demos stand for Thank you
Vitali Bahdanovich	Bravissimo
dobbins2550	Is this a spoof or real Hard to tell
Sean JD	Watch this get removed for hate speech Downloading now
Steve Jones	Looks like the censor at YouTube took this down I m not getting it We have a real problem in this country Heading over the BitChute where they still believe in free speech
Greg Nelson	Cute glass Allie
Schaffer	I am an NPC and I am a proud democrat
Comex Joe	Awesome for the first time in history a honest Democrat commercial
Margaret Haynes	Disgusting
aerialcat1	Absolutely brilliant
Mike Genson	I emailed this link to a few libtards I know they started watching because they thought it wa legit and then BOOM
Duke Makedo	Ouch That must sting
Glenn Reschke	Brilliant
Andy	Why is Allie s pronunciation of the word agenda so arousing
Justine she ok Kranz	BAHAHAHAHAHAHA
Marta Caballero	Brilliant ğŸ¤£ğŸ˜‚ğŸ˜†
apache8492	I m sold
Kenny Burchard	Friggin awesome Great work Allie
Woodrow 103	Priceless
Holly Reiter	Love this sarcastic depiction Thanks Gwen
Louie Fillet	Spot on Amazing job a always
David S	hahahaha this is amazing
Kayden3	Youtube need a love button cause I love it when truth speaks to power
Bill	I m IN NOT
fightnuttube	Perfect
kimie Dove	Haha So funny
JustHappy	Youtube need a laugh react
Richard Ensey	I ve just been NPCed to death
Guss Ruffee	The demonrats honestly could run this exact ad and their minion of NPC s would actually go along with it
papi caballo	Walk off Outta the Park Can t give enough Thumbs Up to this L o v e Allie
David Cruz	â€œ Any woman who disagrees with u on this is a self hating stupid bimbo ğŸ˜Š â€ ğŸ˜‚ğŸ˜‚ğŸ¤£ğŸ¤£ you know that wa on repeat 30 time
Canadian Girl	Awesome
Hanne Catton	Brilliant
Seishin Kan	lol I started by down voting until I realized what I wa watching D
Thomas Glynn	Hilarious Love it
Felix Betancourt	you had me at constitution RED TIDE BABY LETS GET IT
Quinton Hudson	Video wa way overexposed That s what I came away with from this video And that democrat are idiot
rustyme1122	Nailed it
Mike Bell	standing ovation clapping best impersonation of that cortez socialist ever
Gonzo 59	Democrats will eat your Babies
James Farmer	Awesome LOL
DmaxHd	The new NPC ad for retarded zombie Orange man bad
rasher bilbo	Color hair or wig you could pull off an Alexandra ocrazio cortex perfectly Do it
Christopher Brooks	noice
Marko Garcia	THANK YOU walkaway
mofomillerman	Because it s funny it s effective Hard to take the left seriously at time I wonder if the left will come out and say gotcha it wa all just a big illogical joke and aplogise for the damage they have done
Kane Mortlock	This
mustang	SO FUNNY
Brackish nz	17 npc s were here
Norman P. Chesterton	Dang I wa about to vote for Trump again but this gave me a completely new perspective
Bored Lawyer	Next she should do a campaign ad for Bob Menendez Senator for NJ Hey he is corrupt and a pedophile But at least he s a Democrat Not like that nasty Republican opponent a successful businessman Now THAT is evil
Christine Williams	omgosh Allie That wa AWESOME And YES I sent it to all my Democratic family member
Kelley M	That wa spot on man spot on
Electric	So when doe the republican campaign ad drop
Mr Spazoid7777	LMAO
John Doe	Savage
steve smith	Omg this is on point
ocsob007	and the hate filled rant of the left will begin in 5 4 3 2 1
justlookaroundpeople	MAGA RedWave
Bladnaster Naster	OMG An honest Democrat Campaign ad You are absolutely awesome Phenomenal job
Solaris Minor	Truer word have never been spoken
kristen21023	Because pregnant pause we re compassionate
djcamp0426	Brilliant Absolutely Brilliant
kevin_marek	LOLOLOLZZZ 0 23 is the stuff of meme godhood
ChurchCountdowns	That s what an honest Democrat Campaign Ad would really be Brilliant
Frank Benlinski	SHARE iMMEDiATELY To YeR Democrap Frenemies iN THEe BubBLe
Calbenmike	Instant sub How have I not heard of her This is brilliant Conservative woman for the win
ThePsychicSasquatch	Savage And true
Benny .Burmeister JÃ¸rgensen	lmao Vote for u we got no platform whatsoever we just want power and btw we truly care about you You nailed it btw
Ivan Herrmann	This is not a Parody Its all truth
michael cassetta	HAHAHAHA GREAT
HMarie Maz	Spot on and HILARIOUS I watched it three time and am sharing with all my conservative minded friend
emdognyc	This is amazing
Shane Royal	Orange man bad
John Waugh	haha
btruman30	Well because feminism ğŸ˜‚ğŸ¤£ğŸ˜‚
skudzer1985	Steven Colbert wish he could perform satire of this quality
Robert Boren	So much truth
Hyelander	In the video description please add local burn care treatment center location
Justin Walsh	Go Fuck Yourself Fascists
Jacob Nelson	The best part of this is not a word of it is a lie
Walter.R	RNC should run this AD everywhere
ChefG Romano	The republican should run this ad
Hoosier Throttle	Excellent
Daniel Morgan	Slow Clap
Garrett Victory	Brutal combo
1218jmm	The GOP should actually adopt this ad Fucking brilliant
Word of Mouth	Got ta love that feel good music
D B	Haha Yes So true
peter mazziotti	Holy shit Amazing
Michael Robeson	Back in the 80 s and early 90 s when it wa still possible to fantasize that the Democrats were a force for the good the best humorist were found among them Republican humorist were boring tone deaf and didactic Not to mention full of anger and self contradiction But halfway through the Obama year it wa the Democrat humorist not to mention most Democrats themselves who d lost their sense of humor and what little sense of irony they d ever had Allie Stuckey is a good example of what pro Democrat humorist used to sound like before their party became even more rabid than their enemy s
JESSEverything	Our meme are so powerful at this point I think we should ease up a bit we shouldn t
Richie Hodge	spot on sickening ain t it
Alberto Langmaid	KAAAABOOOOMMMMM HAHAHAHAHAHAHAHHA PRICELESS
RS2000LT	Best
saygoodbyetoprivacy	REEEE REEEE REEEEE REEEEEEEEEEEEEEEEEEE REEEEEEEEEEEEEEEEEEEEEEEEEEEEEE
Scott Halloween	But but orange man is bad
Bryan Park	Accurate
johnsoncm65	You must have vomited for the rest of the day after making this video Allie But it had to be done
Rocco Borghetti	Allie Stuckey is bae
John Blackwood	Tears in my eye It s so beautiful
GEO ONE	YouTube overlord are going to censor this MAGA
Justme Here	Laughter tear rolling down my cheek
anonimuso	She s right Instead of trying to convince people that their idea are correct liberal always try to intimidate doxx and attack your livelihood to silence you
J. C.	Doesn â€™ t get better than this
TheS killet	Excellent
rex fisher	OUTSTANDING ALLIE
lbsrfr999	Would not be shocked if utube ban this Truth is often offensive
jhl365	This is now officially my 1 favorite thing on the internet Ever
Brandon Blackman	Love it Crushin on you hard
Glenn	PERFECT
Creature	Brilliant
Brian McGrath	Are we sure this is satire This is genius
mchl h	Super awesome
Ben G.	Sadly this isn â€™ t that different than the ACTUAL ad
Dick Cheese McGee	JOBS NOT MOBS
AbecedariusRex	My vote is still with Philip Mimouf Wifarts
Jill B	Saw this on Facebook and about fell over laughing You did it again Allie Lol
Digg .Dangler	Hahaha so True DemocRATs are insane nut job
Jeff Grant	That settle it I m making the switch
S B	Should have done all this walking amongst the homeless At the border In the Projects In line for welfare At a 24 hour Emergency Room At one of their Political Rallies hosted by Maxine Waters
Howard  Grounds	Damn That wa good
hand to hand combat	This need to be seen by everyone that vote
Tuan Nguyen	GO BLUE
Viviana Lara	I m sold
Cetok01	Good one Allie I miss seeing you on The Blaze
Don Webb	DING DING DING We have a winner
Catspeeler	They put this video under a pile of paper I had to search it out I see why though it s ribbed for our pleasure Allie excellent roast I hear baby pacifier stopping to gasp for the scream when they get ahold of this one
Accolade Awarded	UPDATE This is the PERFECT description of the Dumbocrats err uh well I mean Democrats Allie you re one smart cookie
rgbigdog	Got blocked on Facebook for sharing this to the Groups that I have joined in FB time out until Friday 10 05 AM Share this on your FB news feed
Ronald Hatt	WHAT A TOTALLY STUPID BROAD TYPICAL LIBTARD A CLONE OF NASTY PELOSI
Thomas Nigel	ROTFALMAO
gary kelly	HAHAHAHAHAA I LOVE YOU
Wendell	Hey Hey Ho Ho lol
Simon Grey	Aside of whole stick about capitalism v socialism libtards yell capitalism bad socialism great right wing yell opposite both are equally ignorant and amazing video Love those snarky ironic stab that NPCs will never understand
Lee Mac	You ve got my vote
Hugh Mungous	As usual Allie knocked it out of the park
Steve Holt	Im voting Democrat because we need million of Muslim refugee here after all not all of them will blow up a crowded event or drive a truck through a crowded sidewalk just a few will do that Diversity is our strength why dont those evil White people realize this
Emily Rose	hahaha you are just the best
Kyle Turnage	hahahahah THIS IS SO GOOD
Resonator	Truer word have never been spoken
scott.inspirefm gmail	So well done Allie You said it all
Ash Appleby	This made me laugh
Rod Ferraz	This is award winning ad material for sure
You can't See me	Hilarious Allie Great job again
Zoey Graystone	Good stuff
Dustin Culver	So so true And so sad
pra3t0rian	I â€™ m a victim too
N E	Allie this wa great Spot on lol
Avinash Yaduveer	Haaaaha Iam in love with her
Carlin music	Love it Great stuff Allie
kiIl-chan	accurate
Joshie	Where do I sign up
Honey Badger	Be careful Allie The soulless humorless morally bankrupt member of the medium are probably going to call this â€œ fake news â€
Jeff Hoelscher	GREAT job You are hilarious I particularly liked your spoof with Alexandria Ocasio Cortez you were awesome Keep it up
itsnotaboutme	Show this to a Democrat and he might think it s a great ad He ll keep nodding his head in agreement with Allie
Brendan Lepeska	So true
Jason S	keep up the great work Allie
U2Blades	That wa hilarious First Woohoo
Claire O'Sullivan	best political ad ever And it s not satirical a far a I can see They could plaster this on the screen and there would be those that say hand down Ya
ItsAvaRose	amazing
moz	Lol good show ğŸ˜Š
whippimom	ğŸ˜‚
Dan Young	Nice video
Adam Henry	YES ğŸ™
Nathan Mork	I see what you did there and I like it
Jonathan Jameson	God Stuckey is amazing
imkluu	Is there a counter to this a Vote Republican ad which point out the hypocrisy double speak and illogical stance of the Republicans one that like this one actually ring true and isn t filled with outright undemonstrative lie I d like to see it to be fair and balanced if it is possible to make one
BANKO007	This is what would happen if ad told the truth
duolis the brobot	kek
Jack Wolfe	I am in love
I Love Jacques Cousteau	Lmao
McGeneral_Rick_Retard	Lol you re so sarcastically savage Allie xD
Lou D	Lol love it
Rock Barn Records	This is an expert steel man Great stuff
Aaron S	BEST CAMPAIGN AD EVER Hahahahaha
Tyler Roll	f u c k i n g awesome
Emma	This is my new favorite thing
Emily Garren	Allie you â€™ re the best
Extreme Bear	this wa well done awesome guy keep up the good fight lot of love from New Zealand
C C	I â€™ m a confused NPC Is this a real ad
raz	libtard scum
Jane Tatum	Lol This is good
Rachel B	You re awesome Allie Keep it up â¤
For The Love of Enki777	OMG lol this lady is awesome She s totally making fun of them
watcherjohnny	I had a lobotomy and I m a proud Democrat
Jay Turner	Perfect
