miraÃ§ Ã¼nlÃ¼	Kabuuuusss abiii
GÃ¼zel GÃ¼nler	Ä°yi de sorun zaten orada kitap okurken normal bi video izlerken hatta senin videolarÄ±nÄ± izlerken bile bu istek geliyor KaÃ§ kere senin videonu izledikten sonra oraya yÃ¶nlendim Bunu bi eleÅŸtiri olarak alabilirsin
Omer Ceylan	My lady ha been dried
Kaf Kas	bi elmalÄ± biskrem deÄŸil
1-800-000 -LOVE U	educated ear sahibinin sesi deÄŸil aslÄ±nda eÄŸitimli kulak deÄŸil mi
alaimisema	Ã‡ok Ã¶nemli bi konuya parmak basmÄ±ÅŸsÄ±n kardeÅŸim video nun baÅŸÄ±nda tebrikler
mehmet han	harika ya D
scarp trap	En iyi tÃ¼rk youtube kanalÄ±
Rosenberg	2 girl 1 cup mÄ±ydÄ± o Ã–ÄŸÄŸÄŸÄŸ
Fell	yazÄ±k lan
Onat Arslan	0 39 Remixadam Elon Musk
BORA GLRR	Volkan Ã–ge gelsin
Åebnem Ecem KoÃ§ak	Babakok neredesin
Sibirya Kurdu	KIÃ‡INI KALDIR DA VÄ°DEO AT YOREKOK
Lumi	KonuÄŸun mikrofonu neden bu kadar kÃ¶tÃ¼
Litofer	Babakok lÃ¼tfen ÅŸu selÃ§uk hoÅŸ denen andavalla ilgili video Ã§ek
Bukalemur	ne demek tek lavaÅŸ Ã§ift lavaÅŸ
xDxBxPx xDxBxPx	criticism education
SpieDigitalTV	Abi ben de senin gibi videolar Ã§ekiyorum bi bakar mÄ±sÄ±n
Profesyonel BoksÃ¶r	yorekok seni evden cikmayan sivilceli ÅŸiÅŸko asosyal uzun sacli bi pislik saniyodum
cerpment â€¢	Baba kok ÅŸu kanalÄ± eleÅŸtirsene http m youtube com channel UCuMDZEjfFMVqW8bcuqonzSg Bu kanalÄ± izleyenler 9 yaÅŸ altÄ± minecraft baÄŸÄ±mlÄ±sÄ± veletler Ve bu adam trendlerden dÃ¼smÃ¼yor Ve sana sÃ¶ylÃ¼yorum 5 saniye iÃ§inde cringe duygun 78 kat bÃ¼yÃ¼me gÃ¶sterip gÃ¶zÃ¼nden kan yerine kusmuk gelecek Ve konular hep aynÄ± yani deÄŸiÅŸen tek ÅŸey karakterler ve yerler 1 meraba arkadaÅŸlar ben metin tuvaletim geldi tuvalete gidiyom sÄ±cma efekti aa telefonum Ã§alÄ±yo Lan ben niye tuvalete telefonla giriyom neyse alo alo metin ben porno izlerken amuda kalkÄ±p aynÄ± zamanda popeyes tavuklarÄ± yiyebilen granny Sevgilini kaÃ§Ä±rdÄ±m eÄŸer onu almak istiyorsan ebemin oÄŸlunun cenazesinin kaldÄ±rÄ±ldÄ±ÄŸÄ± mezarlÄ±ÄŸa gel seni bekliyirum hihihi lan sevgilim lan orgazm olma sesleri hih hÄ±ÄŸ granny seni varya 2 meraba arkdaÅŸlar ben metin videoyu likelamayÄ± unutmayÄ±n Arabayla gezek biraz aa telefon Ã§alÄ±yo alo alo metin ben 78 derece kafasÄ±nÄ± dÃ¶ndÃ¼rÃ¼rken su iÃ§ebilen baldi OÄŸlunu kaÃ§irdim brazzers ÅŸirket binasÄ±na gel ve oÄŸlunu kurtar lan olm bi granny bi baldi ni salÄ±n la with the flash tv oyunculuÄŸu baldi sen bekle Not bu arkadaÅŸ nefes almadan konuÅŸma yeteneÄŸine sahip Ve eÄŸer videolarÄ±n cringelik puanÄ±nÄ± sÃ¶ylemem gerekirse salih reyiz nah Ã§ekerken ablasÄ±nin onu durdurmak iÃ§in yaptÄ±gÄ± yuz ifadesinden daha cringe 1 leyin gÃ¶rsÃ¼n
Nightmare 16	Iyi oyunu elestir
mhmt tp	yorekok soÄŸuk savaÅŸa katÄ±l
Yusuf Ã‡ay	ArkadaÅŸlar yorekom bir trafuk kazasÄ± sonucu hayatÄ±nÄ± kaybetmiÅŸ sanirim yoksa bizi asla videosuz bÄ±rakmazdÄ± BABAKOK VIDEO AT LAAAAAN
Ã–zcan GÃ¶kmen	youtubesenindir mÃ¶syÃ¶ pikselans
AndaÃ§ Eker	SarhoÅŸ kafayla izledim kafam iki katÄ±na Ã§Ä±ktÄ±
kutay kanat	Hadi koca g tlu bir video at artÄ±k
KapTan K2	http www youtube com watch v 7dqYMrZmdJ4 ÅŸuna bi bak ÅŸiÅŸko ruhlu cenabet herif
YÃ¼ce GÃ¼ngÃ¶ren	Åu erkan tana bir el atÄ±n 1
mustafa aydemir basketbol	BABAKOK mutlu BABAKOK mutluluktan Ã§Ä±ldÄ±racak
ahmet emir	Yorekok abi bu olaya da bakarsan iyi olur http www youtube com watch v 88UJl qu2Fg
Asim Huseyin Yuvak	Abi birsonraki videonda T series ile pewdiepie arasindaki abone yarisinin youtubede surekli farkli kanallarla cikmasini konu alirmisin
oktay dayÄ±	FURKAN TURAN
CÃ¼bbeli PikaÃ§u	VÄ°DEO AT PÄ°Ã‡
Hannibal Lecter	Bizim ablalar da orda bizim ablalar bizim ABLLAAALARRRR Biz daÄŸlarÄ± delerekk ÅŸirine ulaÅŸÄ±yoruz bir ferhadÄ±z biz ferhadÄ±z biz FERHADIZ ÅŸirin de millet Educated ear
Jendeuk Corn	LÃ¼tfen bak lÃ¼tfen diyorum AnlatacaÄŸÄ±m ÅŸu gereksizi bir elden geÃ§ir Gram haz etmediÄŸim o baÅŸlÄ±k ile alakasÄ±z ne varsa toplayan 2 dakikalÄ±k videoyu 10 dakikaya Ã§Ä±karan ve videoyu Ã§ekerken gÃ¶zlerinden dolar iÅŸareti fÄ±rlayan Ben Kpop kanalÄ±yÄ±m diyerek sadece BTS EXO ve Twice videolarÄ± Ã§eken SelÃ§uk HoÅŸ Bence boÅŸ denen gram hoÅŸ olmayan insanÄ± bir gÃ¶r SaygÄ±lar teÅŸekkÃ¼rler
nilhan bacaksÄ±z	nasÄ±l bir kralsÄ±n ya 3
Japon Askeri	2 yÄ±l Ã¶nceki sesin daha iyiydi abi
Forgotten Reaper	Outroo ÅŸarkÄ±sÄ± plz
Harun SEZGÄ°N	MÃ¼thiÅŸ iÃ§erik
Arda Onur Taner	babakokfirarda
kerem korad	LAAAN TWO GIRLS ONE CUP izletiriyo amq bende mÃ¼ziÄŸini ezberlemiÅŸim
HÃ¼seyin AÃ§ar	Kelimeler yetersiz MuhteÅŸem bir mizah anlayÄ±ÅŸÄ±n var Kusursuz denecek kadar
Life Rules	Efso
mÃ¼min coskun	onlar nasÄ±l fontlar ve font renkleridir ya fontlardan dolayÄ± odaklanamadÄ±m size
Berkay Koseoglu	Nargile tayfayÄ± karÅŸÄ±na aldÄ±n
Ramazan yÄ±lmaz	Bu video kesinlikle daha fazla izlenmeliydi
Can Bozok	SABÄ°TLENDÄ°N
RedquireY - Aras	ULAN TÄ°KTOK U ELEÅTÄ°RÄ°YON TÄ°KTOK REKLAMI YAPIYON MORUQ
Arda Atik	Bence porno izlemeyin demek yerine insansÄ± pornolar izleyin ve dozunda 31 Ã§ekin demek daha doÄŸru olur Erika Lust Ä± Ã¶neririm bu konuda Porno yÃ¶netmeni kendisi ve xconfessions adÄ±nda bir serisi var Her bir filmi kÄ±sa porno filmlerden oluÅŸuyor Duvara vurmalÄ± kafasÄ±nÄ± sÃ¼rtmeli pornolar izleyeceÄŸinize seviÅŸme videolarÄ± izleyin sorunsuz bir deneyim olur bence
Murat Er	5 38 ÅŸarkÄ±dan anladÄ±m kÃ¼Ã§Ã¼kken izlediÄŸim lanet iÄŸrenÃ§ bir video
OÄŸuz Can Ã‡elik	vidyoyu 2 dakÄ±kada kapatÄ±p ted konusmasÄ± aÃ§tÄ±m
oyun gemisi	gallesyorekok
Ga Vat	montajÄ± keÅŸke educatedear yapsaydÄ±
Yakup Kuru	Babakok bize BTS tostu yap
BOSS NANO	5 27 link atmayan iyi insan degildir
Tom riddle	daha Ã§ok rteklam ekle tÄ±klÄ±yom hepsine
Last Gaming	Uzun adam deÄŸilmi yaaa
Yok Satan Nihilist Bakkal	bende sabah akÅŸam TED konuÅŸmasÄ± dinliyorum sonrasÄ±nda bana kattÄ±klarÄ±nÄ±n desteÄŸiyle mÃ¼temadiyen 31 Ã§ekiyorum
Tayyar Adaleti	yorekok akbilsesi alÄ±nca mutluluk hahaha hani su korku filminde adamÄ± oldurmeden onceki karekterin gulusu ha ha ha birgÃ¼n videomu gelir babakok yapma her gun video istiyom
alphan kÄ±lÄ±Ã§aslan	8 52 annadÄ±m abi
Adventure Player	31Ã§ekip geldim
geyiks	Ã¼yekok sinirli Ã§ocuk eÄŸliyorsunuz valla
MeriÃ§ DeliktaÅŸ	OÄŸuzhan UÄŸur u gÃ¶rmek isteriz
Kamer Said MOR	Ä°NCÄ°RLÄ° BÄ°SKREM MÄ° VARMIÅ
IÅIKLI TOSUN BABA	KÄ±Ã§Ä±nÄ± kaldÄ±rÄ±p viedo at 6 gÃ¼n oldu mk
Sinan Yuksel	Kim ne derse desin educatedear in Ã¼stÃ¼ne video remix yapabilen adam yoktur Kendisi her ne kadar remix adama karÅŸÄ± mÃ¼tevazÄ± olsa da bu durum deÄŸiÅŸmez KeÅŸke bÄ±rakmayÄ±p devam etseydin be real â¤
Yasin AktaÅŸ	video at artÄ±k sikik
Emre Ã‡etin	My Lady ha been dried
Zilzop	cinselliÄŸin mantÄ±k geriliÄŸi yaptÄ±ÄŸÄ±nÄ± dÃ¼ÅŸÃ¼nÃ¼yorum 31 Ã§ekince duygu seviyem azaldÄ±ÄŸÄ±nÄ± ve mantÄ±k bakÄ±ÅŸ aÃ§Ä±mÄ±n yÃ¼kseldiÄŸi sanmm 31 Ã§ekme sayÄ±mÄ± artÄ±rÄ±yor bir bensel gerÃ§eklik yaratÄ±p ona inaniyorum
Ã‡aÄŸlar Keser	Between two fern imsi bir iÃ§erik olmuÅŸ biraz ama olmamis
Zehra Gencay	Soguk savasa katil
Blizzard	Deep Turkish Web olsun lÃ¼tfenn
Hostile Cucumber	it s the eric andre shooooooooow
Game Power	senin abonen neden artmÄ±yor homofobik
piksel olan	deep turkish web al
nekibu	saÄŸdaki pornocu
_ fiveacii _	knk sen o profil fotonu deÄŸiÅŸtir xd
aegalaxys3	Ulan gerÃ§ekten Ã¶ldÃ¼ mÃ¼ yoksa diye dÃ¼ÅŸÃ¼ndÃ¼m Michael Caine iÃ§in En sevdiÄŸim oyunculardandÄ±r Ã¶dÃ¼mÃ¼ kopardÄ±n boÅŸ yere
Berkan Y.	THE ERIC ANDRE SHOW
Enola Gay	Yorekok cok bozdu
Black Mesa East SÄ±ÄŸÄ±naÄŸÄ±	yorekokun dediÄŸinin aynÄ±sÄ±nÄ± yazdÄ±m Snake are you alright talk to me SNAAAKEEEEE
aladdin altuÄŸ	3 41 neden bu kadar komik lan
Hayvan Herif	Sesinin tonuna hayranim YÃ¶rekÃ¶k Cok derinlerden geliyor
musluk suyu	Lutfen canlÄ± yayÄ±n aÃ§armÄ±sÄ±n gerÃ§ekten Ã§ok keyifli oluyor
Arda ErgÃ¼n	beynimi bÃ¼ken bi program oldu emeÄŸine saÄŸlÄ±k iyi ki varsÄ±n hocam \m
Turab BiÃ§er	aga educadetear Ä± bÄ±rakÄ±p base 42 ye devam ediyon da remixlerini Ã¶zledik real
jo	SÃ¼per video ğŸ‘ğŸ»
Samed Can Palaz	Allah iÃ§in daha fazla video at
Ziya DedebaÅŸ	Acayip kÃ¶tÃ¼ bir Eric Andre parodisisin yorekok
Fatih GÃ¼ndoÄŸdu	Her 10snde bir kahkaha attÄ±m muazzam video olmuÅŸ ya BATESMOTELPRO ve DEEP TURKISH WEB de gelmeli
Sayko 360	doruk abi yorekok abi
Mizah-Ä± Twitch	KardeÅŸim Bu aralar Ã§ok KalemdermeÅŸerepsin
Sevket Ã‡Ä±nar	Eric Andre show lan bu D
Underswap Papyrus	6 06 Johny Johny yes papa yedin mi gÃ¶tÃ¼ne yarraÄŸÄ± yes papa
Oguzhan Alpakut	Eric andre kok
Ercan Duman	Wtcn ferit sirt sirta izle
Hakan K	AdamÄ± diri diri topraÄŸa mÄ± soktun gÃ¶nlÃ¼nde mi Ã¶ldÃ¼ yoksa Long live the Michael Caine
TÃ¼rkler KomÃ¼nisttir K*rtler ise Emperyalist	8 18 amq Ã§inlisi
umur dalyan	2 girl 1 cup kesindir
HÃ¼seyin Tokel	5 10
Atakan Kapar	GÃ¼nde en az 2 posta
Ã–mer Ä°ntepe	Bence oldukÃ§a elit bir sohbet olmuÅŸ
H TÄ±nkÄ±lÄ±Ã§	Hayat yorekok izlerken karÅŸÄ±na tiktok reklamÄ± Ã§Ä±kmasÄ± gibi
Ubaid	Aw hell no
Mehmet GÃ¼labi	TÄ°KTOKU ELESTÄ°RMENE RAGMEN NEDEN KANALÄ°NDA Tiktok reklamlarÄ± var Babakokkkk
Ã‡elik GÃ¶rgÃ¼n	abi yaklaÅŸÄ±k 2 yÄ±ldÄ±r senin kanalÄ±nÄ± biliyorum ama ÅŸu ana kadar sevdiÄŸim tek iÃ§eriÄŸin bu oldu house of babakok devam etsin inÅŸ
Elite Bey	Video at abi
Efe HacÄ±oÄŸlu	aÃ§tÄ±ÄŸÄ±n video umarÄ±m 2 girl one cup deÄŸildir
YiÄŸit Aykurt	Abi fÄ±ndÄ±k ailesinin videosunu yapar mÄ±sÄ±n Ã§ok CRÄ°NGEEE
arda osoydan	Mustafa Kemal AtatÃ¼rk genÃ§lik size emanet AtatÃ¼rk bu sÃ¶zÃ¼ gidip sosyal medyada dans edin diye deÄŸil afrinde vb Ã¼lkeyi koruyun diye demiÅŸtir ALLAH c c zina en bÃ¼yÃ¼k gÃ¼nahtÄ±r der ama heryer zina yapÄ±lÄ±yor yapmayÄ±n umraÄ±m bir kaÃ§ kiÅŸiyi akÄ±llandÄ±rmÄ±ÅŸÄ±m
Utku Erke	MY LADY HAS BEEN DRY
Murat Derse	Tic toc videolarÄ± gÃ¶rmÃ¼yorlar lakin videolarÄ±nÄ± izlerken tic toc reklamlarÄ± Ã§Ä±kÄ±yor ğŸ˜‚ hayat
Ata TanyeloÄŸlu	Biraz eric andre sanki
hiÃ§ kimse	Layq ğŸ‘
UZAKURT	Senin orada ne iÅŸin vaaÄŸr geri dÃ¶n d
Talha Boz	patur putur u da bekleriz
Uvuvwevwevwe Onyetenyevwe Ugwemuhwem Osas	Doruk abi kardeÅŸim izlerken gÃ¶rdÃ¼m youtube tonguÃ§ akademi 8 sÄ±nÄ±f tÃ¼m dersler konu anlatÄ±m canlÄ± yayÄ±nÄ±nda 2005 li Ã§ok cringe bir chat var bir el atsan iyi olur abi
Dulken	KASINTI
exoriente lux	bi video izlemiÅŸtim bu porno baÄŸÄ±mlÄ±lÄ±ÄŸÄ± ile alakalÄ± siz porno izlerken beyin dopamin salgÄ±lÄ±yor ve sizin o videodan zevk almanÄ±z azaldÄ±kÃ§a yeni sekmeler aÃ§arak dopamini arttÄ±rmak istiyorsunuz bu porno izleyerek olur tÃ¼rk dizileri firikikleri izleyerek olur yada sahilde bikinili kÄ±zÄ±lara bakmakla olur aslÄ±nda bunlarÄ±n her biri sizin porno anlayÄ±ÅŸÄ±nÄ±za gÃ¶re ÅŸekilleniyor ÅŸimdi her neyse asÄ±l meseleye geleyim ÅŸu Ã§Ä±plak birÅŸekilde yemek yiyen adamÄ± gÃ¶rÃ¼nce birden aklÄ±mda canlandÄ± aslÄ±nda buda bir Ã§eÅŸit porno ÅŸu adama bir bakÄ±n ya sarÄ±n sarÄ±n baÅŸtan izleyin herif resmen boÅŸalÄ±yor mk yada sosyal medya baÄŸÄ±mlÄ±lÄ±ÄŸÄ± beni herkes gÃ¶rsÃ¼n baÄŸÄ±mlÄ±lÄ±ÄŸÄ± beni herkes merak etsin baÄŸÄ±mlÄ±lÄ±ÄŸÄ± aslÄ±nda bunlar bir Ã§eÅŸit porno hepsi sadece senin beynin yapay yollarla dopamin salgÄ±lasÄ±n diye
MÃ¼cahid Durgut	s baya kÃ¶tÃ¼ abi ona bi bak istersen
pinaxmei G.C.	adama neden o videoyu izlettin ki ya ğŸ’©
Zeynep Sarikaya	Knk bayadir vidio yapmiyodun
Aytug Avci	Neden buradasÄ±n boÄŸaÃ§ Neden educatedear
Mirhan	michael caine i niye Ã¶ldÃ¼rmÃ¼ÅŸ lan bu
Eren Sorucu	uyumadÄ±ÄŸÄ±m bir gÃ¼nÃ¼n sabahÄ±nda denk geldim bu videoya kahkalar attÄ±m ve uykum aÃ§Ä±ldÄ± devamÄ± gelsin yorumlarÄ± okumuyorsun zaten neden yazdÄ±m bilmiyorum
Godric Gryffindor	bobiler Ã¶rg dimi bu
Ahmet Deniz	Eric Andre Show a burdan selamlar
Game'N Bro	yorekok ile konuÅŸmaya gelen insanlar neden hep silah zoru ile getirilmiÅŸ gibiler
Arda BAYYURDOÄLU	Eric andre show geÃ§iÅŸlerinden kurtulmazsan ay adam geÃ§miÅŸten gelip aÄŸzÄ±na 73 derece sÄ±caklÄ±kta extra shot sour cream dirty mocha dÃ¶kecekmiÅŸ Ha bir de bu mesajÄ± 25 kiÅŸiye daha gÃ¶ndermen lazÄ±m artÄ±k
Franklin Clinton	Murder house
Ahmet Sefa Bulut	Bu piano sesini nerde olsam tanÄ±rÄ±m
Recep AYER	Ahh bomba olup patlayasÄ±m geldi
Alp Er	3 49 tam olarak ben
istisnasÄ±z-oyuncu	keÅŸke ÅŸu yorum tutsada
BahadÄ±r DoÄŸan	Yemedik Caine
Salih SÃ¼rÃ¼cÃ¼	Video baÅŸlamadan Ã¶nce tiktok videosu izledim ğŸ˜­
Turker	mÃ¼thiÅŸ konsept hahahahaha helal olsun ya 31 ve albert camus Ã§ok iyiydi
KÄ±zgÄ±n kedi	DUURUT DUURUT BEN SENÄ° Ã‡OK SEVMÄ°ÅTÄ°M YOUTUBE AMA SEN BENÄ° HÄ°Ã‡ SEVMEDÄ°N YOREKOKUN BÄ°LDÄ°RÄ°MLERÄ°NÄ° KAPATMIÅSIN
Adil Burak	Bir daha o geÃ§iÅŸ mÃ¼ziÄŸini duymak istemiyorum yetheeer
Stheno Fors	kalitesiz video olmuÅŸ hiÃ§ ayrÄ±ntÄ±lara dikkat etmemiÅŸsin yakÄ±ÅŸtÄ±ramadÄ±m
Vanilla Ding Dong	Olaaaaaay
sÃ¼vari bey	H A U S E O F B A B A M U K
Ebru KurdaÅŸ	Federal tik tok halkÄ±nÄ±n hayatÄ±mÄ±zda Ã¶nemli bi yeri var onlar hayatlarÄ±na Son vermeden Ã¶nceki son videolarÄ±nÄ± yapÄ±p katliam yaratÄ±yorlar
Ã–zlem k	5 46 bu 2 girl 1 cup mÃ¼ziÄŸi
Abdullah Acar	sondakiparÃ§a edit inini ismini alabilirmiyim
enes yazici	Yengen sulandÄ± kÃ¶z getir sÃ¶ndÃ¼relim serii
JOHN CRISTOPHER FAN	My lady ha been dryed akskkdkfkfksllalalsÃ¶mfkglgkblkblgÃ¶vÃ¶lv
Hitleri seven KomÃ¼nist	Bidahakine Mode Xl gelsin
aLp	Yemegime ara verip yorum yapÄ±yorum Edu ile enfes olmuÅŸ helaaaal
Sedat yilmaz	Michael Caine ne ara Ã¶ldÃ¼ lan kaÃ§Ä±rmÄ±ÅŸÄ±m
Gtown Niggu	DÃ¼nyayÄ± tiktokÃ§u krdÅŸlrm yÃ¶netsin ooo nananaaaaa ooo naanananaaaaa
Mustafa Kemal Can	Ben kalendir meÅŸrebim
oguzhan colak	ending gÃ¼zelmiÅŸ
murat evliya	BoÄŸaÃ§ gibi bu mecrada senelerdir kaliteli icerik ureten birine sorulabilecek en guzel sorulari sordun gercekten Koskoca 10 dakikalik videoda adamin 2 kelime etmesine izin vermeyeceksen ona doÄŸru dÃ¼zgÃ¼n sorular sormayacaksan ve tamamen konuÄŸunu aÅŸaÄŸÄ±layarak komedi kasacaksan bunu boÄŸaÃ§ gibilerine yapma konuÅŸtursan fikirlerini duygularÄ±nÄ± v Ã¶ÄŸrenebileceÄŸimiz bir adamÄ± absÃ¼rt komedi niyetine kelimenin tam anlamÄ±yla harcamÄ±ÅŸsÄ±n
Sercan GÃœNEY	hala alber camus u dÃ¼ÅŸÃ¼nÃ¼yorum otuzbir Ã§ekerken mi
abdullah kocak	Eric Andreye selamlar
T.D. TIRPAN	senin tiktok programÄ±nÄ± izlerken hayatÄ±mda izlemediÄŸim kadar tiktok reklamÄ± izledim Ã¼zgÃ¼nÃ¼m
dukka mendakka	Sodyum gÃ¼nlÃ¼kleri
Ã‡aÄŸrÄ± Tuz	HoÅŸ
Cris Formage	Kanal gÃ¼zel de babakok her ÅŸey bir yerden alÄ±ntÄ± yani KanalÄ±n kendisi iDubbbzTV TVFilthyFrank ve leafyishere karÄ±ÅŸÄ±mÄ± E bu vidyodaki format da Between two fern ve Eric Andre Show karÄ±ÅŸÄ±mÄ± Hani her ÅŸeyin bir baÅŸka yerden kopya edildiÄŸini gÃ¶rÃ¼nce pek de bir komedisi kalmÄ±yor
Ahmet Ã–Z	0536979 07 39
Kedicik	HaÅŸmetli yaÅŸÄ±yoooooo
SadÄ±k OrtaÃ§	Kumbara dolar dolmaz karÄ±ya gidek
Roy Miller	5 11 yÄ±kÄ±ldÄ±ÄŸÄ±m an dostum sen sÃ¼persin
yiÄŸit kÄ±zÄ±lay	neden eric andre show mÃ¼ziÄŸi ve geÃ§iÅŸleri
Enes Demir	tam 31 Ã§ekmiÅŸtim Ã¼zerine bu videoyu aÃ§tÄ±m Ã¼zgÃ¼nÃ¼m
Umut YamaÃ§ Koman	9 36 mesaj geldi sandÄ±m la
Orkan Ã‡il	UmarÄ±m BoÄŸaÃ§ konuÅŸurkenki uÄŸultu bilinclidir
Haliye Ã–zgÃ¼rkuÅŸ	Nargilenin duzeneginde su var yenge icemeyince kuruyor
Kudret YÄ±ldÄ±rÄ±m	Zach galifiniakis between two fence Iceriginin turu ordan calinma yorekok
h1pers	konu tiktok kanserine gelince tiktok reklamÄ± Ã§Ä±kmasÄ± da ne biliyim yani biraz sanki bÃ¶yle derler ya hani
One Love	That s the way aha aha i like it
TheIbrahim1907	House of pain
Sarp E	abi neden kulaÄŸÄ±nÄ± karÄ±ÅŸtÄ±rÄ±yorsun
YarÄ±m gorani oynayan kuÅŸ	SadÄ±k TopragÄ± getir
kagan tan	daha fazla house of babakok gelsin
fat black man	v i c t o r y r o y a l e ÅŸ a p k a s Ä±
Ã‡iÄŸdem Nur KulaksÄ±z	YHOFC
BEONHAS VÄ°DEO	Deep wep turkish i getir ancak sen getirirsin
Ege AnlÄ±	BugÃ¼nkÃ¼ konumuz 31 ve pornonun dÃ¼nyaya etkileri
okuyom ben yaaah	Vikipedia yasaklanio ama tiktok reklamda youtube over
Mustafa Talha Ã‡INAR	TEOMAN dinleyin
Thraldes *	Le Case De Kok
PonÃ§ik OJJ	31 Ã§ekesim geldi
Osman Bey	2 bob 1 kok
yunusemreUfuk	Her ÅŸey boktan bir eleÅŸtiri ile baÅŸladÄ±
MÄ°XED	Are You Ready
Karambit TV	yttyyt
BuÅuO planetvrvrvrÄ±	Neler dedi ve adam niye terk etti
Ã¶ykÃ¼ - G	Bu videoyla bir aydinlanma hissettim
Yusuf BahadÄ±r Olgun	Ã‡ok iyi olmuÅŸ
Greexez 8899	Videoyu izlerken tik tok reklamÄ± gelmesi
Equinox	8 18 de ki gÃ¼lÃ¼ÅŸ ne Ã¶yle D
Baki GÃ¼neÅŸ	MUAZZAM
Furkan kÃ¶roÄŸlu	GÃ¼zel olmuÅŸ bu arada ucuz kurgu diye bir ÅŸey vardÄ± onu da hatÄ±rlamanÄ±zÄ± rica ederim Doruk bey
GRKN- rezi	hugola
Sas Sad	Eric Andre Show
BuÄŸra KaÄŸan AltÄ±kat	Annemle izliyordum abi Allah belanÄ± versin
EREN DUMAN	birdahaki konu Ã¶lmek olosun
sad af	EcÃ¼keytiyÄ±r
meraba televole	wtf yarÄ±da tiktok reklamÄ±
Tuna Ã‡akmak	HOY
RoCoKo	outrodaki ÅŸarkÄ±yÄ± shazam da soundhoud da bulamÄ±yor bulan birisi varsa yazabilirmi
InkSwapSans TR	AMAN AMAN NERELERE GELDÃœM
gorsel Guneysoy	gÃ¼zel devam
Mehmet Alper Korkmaz	kokain masasÄ±na hapÅŸurmak gibi
Erdem Budak	your aunt is blented my brother
Asaf YÄ±lmaz	Devam
ertuÄŸrul emre bendekalsÄ±n	Bildirimler gelmiyor sikicem
ozan arend	Eric andre izledigini tahmin etmistim
Ä°brahim Atalar	YENGEN HARMAN OLDU LWLDLDDLLDLSÅSEÅFÅGLLEKW
Clash Gamer	sonuna kadar izleyen bordo berelidir
ahmet bilgin	YKS ALES TUS KPSS ve devamÄ± olan bir insan Ne 31 i Gezecek zaman bulamÄ±yor sonra beyin mavi ekran ğŸ˜€
crylord37	5 46 nerde duysam tanÄ±rÄ±m videonun adÄ± 1 cup 2 girl 1 BoÄŸaÃ§
Captain Game	Abbas yanbasani cagir ve aNa sKm konusunu isle
Ossibabak_YT ,	Yorekok Baba belgoturk Yeni Video atti maskeli adamin gereckt yuzu Yinee MOMO var
Furkan Karahan	aghhh my boner
manyak oyuncu	Oh ye babakoks house
Gazapizm'in MuÃ¢llÃ¢sÄ±	Abi sÃ¼per amÄ±nakoyim ya
StrabenflÄ±ttecem Weiterfahren	15 yaÅŸÄ±ndayÄ±m 31 cekiyorum sigara iciyorum qwqwqwqwqw
Pewchu	tÃ¼rkiyenin en iyi edit kanalÄ± olabilir D
sinamatik Evren	HOUSE OF BABAKOK YOREKOK STAR BEBEÄÄ°M
Duck Guy	The Eric AndrÃ© Show Kok edition ÅŸimdi hizmetinizde
Arena Team	BEÄENÄ°N GÃ–RSÃœN KONUKLARIN ELLERÄ°NE ABSÃœRT BÄ°R NESNE VER ONLA DEVAM ETSÄ°NLER KONUÅMAYA D
The ÅAPLAK is coming	Victory Royale ÅŸapkan legendary BABAKOK
Lyd	7 24 Yorekok oha mq
Burak Kodaz	6 40 Cod 4 Ã§Ä±ktÄ± zaten
Beyzanur DoÄŸan	ne izledim ben biraz Ã¶nce
Mertcan YÄ±ldÄ±z	Bunun nasÄ±l yapÄ±lÄ±caÄŸÄ±nÄ± gÃ¶stermiÅŸsin babakokkk
Mehmet Ã§etin	Dostum bu iÅŸi yapÄ±yorsun
YiÄŸit Efe GÃœLLÃœ	HayatÄ±mda gÃ¶rdÃ¼ÄŸÃ¼m en faydalÄ± video
Mahir Karasoy	Ä°lk defa boÄŸaÃ§Ä±n olduÄŸu bir videoda eÄŸlenmedim
Selenay Kurtkan	K A L E N D E R S O H B E T L E N D Ä° N Ä° Z
TuÄŸba Ã‡	Nerdesin be platoniÄŸim gel de birlikte izleyelim Babakoku
Aå„ªç´ ç¦	BugÃ¼n komik manyak intro yokmu
Eren SoytÃ¼rk	Renk ver la sohuh
miro tankian	CAN SUNGUR GELSÄ°N
Hulk Ekmek	TutmaZ
Onurlay BelasÄ±nÄ± ArÄ±yor	Tiktok videolarÄ± izlerken 31 Ã§ekiyorum
Furkan Kaya	Enes baturu getir
Fuckosentez	Kendisi Educate ear
Lasivece	Seni izlediÄŸim iÃ§in teÅŸekkÃ¼rler
TAHA ZEYD NAYÄ°R	Oynayan video kÃ¼rdan videosu
Åafak Toker	Ä°kiniz porno izlediÄŸinizde ordakileri gerÃ§ek mi sanÄ±yodunuz yani gerÃ§ek hayattaki gibi EÄŸer bÃ¶yle sanÄ±yosanÄ±z zekamÄ±z aynÄ± deÄŸil KÃ¼Ã§Ã¼k Ã§ocuÄŸa bÄ±Ã§aÄŸÄ±n zararlÄ± olabilceÄŸini sÃ¶ylersin ama bÄ±Ã§aÄŸÄ± yasaklamayÄ±z demi Ã§Ã¼nkÃ¼ gerekli Bu da Ã¶yle
Rozenans	biri 4 51 de baÅŸlayan tiktok yorumunu kesebilir mi
Davut Karaman	DiÄŸer bÃ¶lÃ¼me PorÃ§ayÄ± Ã§aÄŸÄ±r efsane olur
onatov onatoviÃ§	ERIC ANDRE MÄ° OLDUN ÅÄ°MDÄ°
Yasin ATEÅ	Yengen harman oldu kardeÅŸim seri serii
ADOLF KADÄ°R	164873035
mail sarac	omg wtf
Adana Ball	9 22 ÅŸarkÄ± Ã§ok gÃ¼zel d
EmirAhmet Arda	arkada ne var kerimcan onedio professional educattedear
LORD VANDHAR	2 35 Ayberk neyi dÃ¼ÅŸÃ¼nÃ¼yor bir tÃ¼rlÃ¼ anlayamadÄ±m
Janberk Ãœnal	anladÄ±m aÄŸbi
Alperen Eker	Enes patirputur v amca evden kovma serisi acil
Moto garaJ	kalender abi kendÄ±ne Ä±yÄ± bakkk senÄ± sevmeyene guaj boyalÄ± mercÄ±mek corbasÄ± Ä±smarlÄ±ycam instagram BAYPÄ°S10 beni bul acil D kanalÄ±ma abone olmadÄ±n lan 2 senedÄ±r lider takÄ±pcÄ±n benÄ±m D
Carnage	hÃ¶hrÃ¶Ã¶hÃ¶ educatedear qalp yorekok eheoÃ§hÃ¶hÃ¶hÃ¶
James Clerk	Micheal Caine gerÃ§ekten Ã¶ldÃ¼ sandÄ±m senin yÃ¼zÃ¼nden
Irfan Coskun	Sesini deÄŸiÅŸtirebilmek iÃ§in Ã¼st Ã¼ste s bindirmemeye Ã§alÄ±ÅŸÄ±yorsun O nedenle birlikte program yaptÄ±ÄŸÄ±n insanlar sen konuÅŸurken konuÅŸmamak iÃ§in kendini kasÄ±yor Ama bu durum gÃ¼zel bir sonuÃ§ doÄŸurmuyor Educatedear gibi samimi ve neÅŸeli bir adam bile ka katÄ± oturuyor Genel olarak doÄŸal bir diyalog gibi durmuyor Takibi keyifsiz bir sÃ¼reÃ§ Bu sesinle ilgili olay yÃ¼zÃ¼nden samimi ve eÄŸlenceli bir sohbet programÄ± yapman bence olanaksÄ±z GerÃ§ek sesini kullanmamanÄ± anlÄ±yorum Bu konuda haklÄ± olabilirsin Ama o halde daha eÄŸlenceli bir sohbet programÄ± formatÄ± bulmalÄ±sÄ±n bence Mesela konuklarÄ±nla yan yana oturup konuÅŸmak yerine Messenger ile yazÄ±ÅŸabilirsiniz Hem ironik olur hem de ilginÃ§ bir gÃ¶rÃ¼ntÃ¼ ortaya Ã§Ä±kar MSN zamanlarÄ±mÄ±za gÃ¶tÃ¼rÃ¼rsÃ¼nÃ¼z bizi Not Burada yazÄ±ÅŸtÄ±ÄŸÄ±n sohbet programÄ± iÃ§in bir sponsorluk baÄŸlantÄ±sÄ± bile kurabilirsin
Miray Algan	Daha uzun olsa su lanet videolar nolurdu sanki
fataltragedy	harika olmuÅŸ asfsdssffdsgh
Burak Ã–zdemir	Ä°zlediÄŸi video 2 girl 1 cup deÄŸil mi
sanal hunkar35	bu videoyu izleyipte ÅŸu ÅŸiÅŸkotayÄ± rÃ¼yasÄ±nda gÃ¶ren ey bizansÄ±n genÃ§ yÃ¼zÃ¼ like at yoksa gÄ±rtlaÄŸÄ±nÄ± alÄ±rÄ±m
Yusuf Ã‡elik	Babakok Ã§ok gÃ¼zeldi verdim bi dislike
DaddyBassBelly	erik andre
Deniz Bey	Niyesiyahbeyazyabiyon
Behram Ä°stanbullu	Ä°NCÄ°RLÄ° BÄ°SKREM MÄ° HayatÄ±mda yediÄŸim en b ktan ÅŸeylerden biri affedersin kusmaya gidiyorum
veni vici fÄ±tÄ±fÄ±tÄ±	EDUCATEDEAR O Brother Where Art Thou
Herbolog XX	8 13 fetiÅŸimi harekete geÃ§irdin Ye beni babalock
Berfu Ã–ztÃ¼rk	Eric Andre gibi olmuÅŸ Ã§ok ta gÃ¼zel olmuÅŸ
Metehan Arabaci	Devami gelsin diyenler
Dante Alighieri	olum Ã§ok iyi lan D
Mobil oyuncu Tunahan	Ã–zcan showu eleÅŸtirsene
Mta Serkan	Sondaki mÃ¼ziÄŸin adÄ± nedir
GÃ¶kalp DurmuÅŸ	KuÅŸum AydÄ±n deÄŸil mi o ya videodaki
ras sc	Ã‡ok iyi lan
Eda Elkoca	ğŸ˜„ğŸ˜„ğŸ˜„
MG-ONUR KILIÃ‡KAYA	2 gril 1 cup
Melik Sah Tokur	Seri kapanÄ±ÅŸ mÃ¼ziÄŸinin linkini getir
UMUT Ã–Ã‡GÃœDER	Ã§akma geekyapar
Berk Ã‡apar	eric andre bunu beÄŸendi
Cahit Meray	2girl1cup mÄ±
Cafer Balta	Aaaaaand it s the eric andre shoooow
Sinan Polat	michael caine Ã¶lmedi
EXORCISTT	devamÄ± gelmeli kok izlemesi keyifli
hakan uzungÃ¶l	bu format gÃ¼zel devam et
Adolf Soner	Outro
Smile Entertainment	Michael myers ğŸ˜˜
Onur Aydemir	BaÅŸlÄ±ÄŸÄ± gÃ¶rÃ¼nce istemsizce aklima House of Nature ve Elif Aybuke KoÃ§ak geldi 20 defa daha izledim tÅŸk babakok 3
Miray Kuru	SansÃ¼rlenmiÅŸ video hangisi
Salim baÄŸÄ±ÅŸ	Batesmotelpro nun diÄŸer Ã¼yeleri ile tekrardan bir projede yer almanÄ± epey istiyorum Neden onlarla deÄŸilsin artÄ±k seni onlarla gÃ¶remiyoruz sebebini tahmin edebilsem de tam olarak o kadarÄ±nÄ± bilmiyorum Birlikte bu iÅŸi yapmanÄ±zÄ± isterdim En azÄ±ndan volkanÄ± bu bÃ¶lÃ¼me Ã§aÄŸÄ±rabilirsin Belki onlara da faydasÄ± olur ğŸ˜”
Kayra5138	Le harmaned yenge face
ege Ã§akÄ±r	ene baturu davet eder misin
citizen alpi	Naysli dan
Sadiye	Two girl one cup bu mÃ¼ziÄŸi nerede olsa tanÄ±rÄ±m
taner no.	Ä°zledikten sonra 31 Ã§ektim
Ahmetcan Ã–zkul	L E F A C E T H Ä° N K E N A B O U T K Ã– R Ä° N S T A F F L A N D I N
Troll Face	Babakok BuluÅŸmasÄ± yapalÄ±m
Rahadke Kolpa	Neyse videoyu kapatÄ±yÄ±mda 31 cekeyim
Jujul Jaja	Jahreinin gelme ihtimali kaÃ§ kokbaba ğŸ˜Š
Berkay KaraÃ§ay	Åimdiye kadarki en iyi video olabilir muazzam bir ikili
Yasin Egemen	House of eduyore olsun hep boÄŸaÃ§ olsun
Murathan Dil	Dinleyelim bakalÄ±m Teoman
Mustafa Ä°BAÃ‡Ä°FLÄ°KCÄ°	Yorekok kamera karÅŸÄ±sÄ±na geÃ§me cesaretinde bulundun ne zaman gerÃ§ek sesinle video Ã§ekeceksin
Ahmet Cengiz	AÅŸÄ±rÄ± iyi video
Enver AYDIN	videonun sonunda Ã§alan ÅŸarkÄ± nedir acaba
fÄ±stÄ±kezmesi	deep turkÄ±shweb gelecek ben soylÄ±m buraya da yazÄ±m bi cok kÄ±sÄ± merak edÄ±yo bence
jesus christ	Ya amÄ±nakodum yÄ±llardÄ±r aklÄ±ma gelmiyodu mÃ¼ziÄŸi duyunca yine dehÅŸete dÃ¼ÅŸtÃ¼m amÄ±nakoyim
Ebral Gomez	En sevdiÄŸim 2 ÅŸahÄ±sğŸ’™ Educatedear Ã¶nceki videolarÄ±na bayÄ±lÄ±yorumğŸ’™
Meyra	8 29 daki mÃ¼ziÄŸin ismini bilen var mÄ±
Ä°smail Ã‡etinkaya	Boktan bir gÃ¼n geÃ§irdikten sonra ÅŸu iÃ§erikle karÅŸÄ±laÅŸtÄ±m TeÅŸekkÃ¼rler Babakok Ä°yi ki varsÄ±n
Bekir Karakulak	michael caine Ã¶llmedi lan
Muhammet Duman	Edu yu aÄŸzÄ±nda acÄ±sÄ±z kanatla hayal ediyorum
Nuh Ã¶zdemir	EdcukeytÄ±diyÄ±r ÅŸeklinde okunur adam diye yaz tamam tamam yapmayacaÄŸÄ±m
Esen MansuroÄŸlu	aralÄ±ksÄ±z 98 dakika boyu gÃ¼lebilirim
tuncelcel	2 bÃ¶lÃ¼m aleyna tilkiyle olmalÄ±
Ã§akma Dytto	gene muhteÅŸem videoydu âœŒardÄ± gelsinğŸŒ™
Zeynep KÄ±sa	MastÃ¼rbasyon baÄŸÄ±mlÄ±sÄ± olan bir bey vardi okuduÄŸum kitapta Ne zaman aklÄ±na mastÃ¼rbasyon yapmak gelse evine koca koca taÅŸlar gÃ¶tÃ¼rÃ¼yordu Terapi iÃ§in Siz de oyleyseniz evinizi taÅŸla donatabilirsiniz Ã–ylesine bir Ã¶neri jfjfjd
Murat Can Akdeniz	sansÃ¼rlÃ¼ video 2 girl 1 cup
Ziya DoÄŸramacÄ±	Bunu izledikten sonra 31 Ã§ektim
Adele Basar	her 31 dediÄŸinde azdÄ±m
halil haya	yorekok bÄ±rak tÃ¼rkÃ§emiyi katletmeyi
Nordalion	Eric Andre show of YouTube Turkey
Can Bulut Altin	boÄŸaÃ§Ä±n eski videosu two girl one cup
TG Eyup Kerem	Sen ne diyon nerde ay yanlÄ±ÅŸ yermis
Yaren Deniz Ã–zÅŸahin	Sen nasÄ±l bir kalitesin yaaaa
A.K.A Manyak ÅiÅŸko	Bir sÃ¼re gÃ¶tÃ¼rÃ¼r bu seri
Yusuf Bozkaya	5 40 ta 2girls1cup aÃ§Ä±yor sanÄ±rÄ±m D
Hain Costak	MÃ¼kemmel
sisifos 2	Merhaba arkadaÅŸlar ben yorekok
Enes Hesperos	Ä°nÅŸ devamÄ± gelmez hadi bakalÄ±m
Hugh Lauire	SansÃ¼rlenen video 2 gÄ±rla 1 cupmiydi 16 yaÅŸÄ±mdayken izlemistim muzik tonundan anladÄ±m
YaÅŸar Altun	Can sungur
MambaRebellion	5 10 dk daha uzun olabilir
Enes YeÅŸilkaya	between two fern Ã¼ Ã¶zlemiÅŸtik bu iyi oldu d
Aykut YÃ¼cesoy	Bu vesile ile umarim yorekoku post42 ekibi ile soguk savasta gÃ¶rme sansimiz olur
Hami ORAK	BoÄŸaÃ§Ä±n ciddiyetsizliÄŸi ve babakok tarafÄ±ndan youtubeun derinlikleriyle tanÄ±ÅŸtÄ±rÄ±lmasÄ± MÃ¼kemmel bir bÃ¶lÃ¼m
Efe ÃœngÃ¶rdÃ¼	Yorekok bozdu abi yeeeaaa Diyenler gelmeden
Ã–mer Tekin	SÄ±Ã§arken olaylarÄ± daha derin dÃ¼ÅŸÃ¼nebilmek
Panchostra	Eric Andre Show
Ali Eyup	Ä°yi araklamÄ±ÅŸsÄ±n eric andre showdan
kubrickscalling	Babakok sonda Ã§alan ÅŸarkÄ± nedir Yengen kurudu yeminlem
Talha TuÄŸla	TÃ¼m kanser konularÄ± toplayÄ±p iyi bir konuÅŸma olmuÅŸ
Mert Toprak	Yorekok SoÄŸuk savaÅŸa diyenler ğŸ‘ğŸ¼
Ğœ.Ğœ KARAKAYA	Outro ÅŸarkÄ±sÄ±nÄ± bilen var mÄ±
Ahmet Selim Ozturk	nice eric andre kardes
Emre Ozgen	David linch seni Ã§ok etkilemiÅŸ baba
bu kim lan	Bu koka naptÄ±nÄ±z lan AdamÄ± hiÃ§ iÃ§ten gÃ¼lerken gÃ¶rmedim
ZÃ¼mrÃ¼t Orhan	Abi harika video olmuÅŸ eline saÄŸlÄ±k YouTube denen ne Ã¼dÃ¼ÄŸÃ¼ belirsiz bu karadelikten bizi Ã§Ä±karÄ±p halen anlamlÄ± esprilere gÃ¼lebilen genÃ§ler yetiÅŸtirdiÄŸin iÃ§in Ã§ok teÅŸekkÃ¼rler babakok Serinin devamÄ±nÄ± bekliyoruz
Copycat	Bu videodan sonra ruh saÄŸlÄ±ÄŸÄ± hastanelerinin gelirleri arttÄ±
Ferhat Aslan	Babakok Ã§ok sinirlendi ve sakinleÅŸmek iÃ§in aÃ§ karnÄ±na iki gÃ¼n Tik Kok videosu Ã§ekmeye karar verdi
Hah Hahha	Ä°lk defa yorekokun bir videosu boyunca gÃ¼lÃ¼msemedim bile ğŸ‘ŒğŸ¿ğŸ–•ğŸ¿âœ¨
Mehmet FÃ¼rkan Ã–ztÃ¼rk	Niye BoÄŸaÃ§ a 1C2G izlettin ki sen ÅŸimdi s s
Efe Seymen	We will be right back
YaÄŸÄ±z Hasan KÃœTÃœÃ‡OÄLU	Sonda Ã§alan ÅŸarkÄ±nÄ±n ismi nedir
Emre AktÃ¼rk	Bir daha ki konuk batesmotelpro yakÄ±ÅŸÄ±r
inside dead	Cok iyi olmusâ¤
bÃ¼lent Ã¶ztÃ¼rk	Koklar buluÅŸuyor
OÄŸulcan Åahin	babakokun trollÃ¼nÃ¼ anlayÄ±p sÃ¼rdÃ¼rebilecek nadir adamlardan biri educatedear ilk bÃ¶lÃ¼mÃ¼n onunla olmasÄ± iyi olmuÅŸ
Tunahan Onaran	1 07 yakalandÄ±m sandÄ±m
Chln Sl	2 kÄ±zlar ve 1 kap
Yakup DoÄŸan	reyiz deepturkishweb ekibini Ã§aÄŸÄ±r
Koalstoff	HazÄ±r konuk almÄ±ÅŸken 15 20 dk tut da keyfimiz yarÄ±da kalmasÄ±n Kuruyoruz sonra
Ozan Erte	Hiiiiii ğŸ˜±ğŸ˜±
Hayri Parker	Ä°kinci konuk fero olsun
HaydarT.	Abi Ã§ok cringe yaa
Efe Umut GÃ¼ldal	micheal caine Ã¶lmediki ya hain yorekok
Shamkal OÄŸuz	SoÄŸuk SavaÅŸ Yorekok
Ruslan Jafarli	Ã‡ektiyin videoyu sikeyim
Mehmet KÃ¶seler	duman duruken teoman mÄ± dinliyim bi daha dÃ¼ÅŸÃ¼n D
burak elÃ§i	MuhteÅŸem
Oleg	Educatedear x yorekok fanart yaoisi istiyorum
Ahmet YÃ¼rÃ¼k	kusacam
Serhat TÃœLEK	Ä°ncirli biskrem harman oldu
HÄ±gh Tower	Of the rising sun
Random Things Around	Oooaaa bak bu Ã§ok iyi olmuÅŸ
One Above All	AÅŸÄ±rÄ± we ll be right back mÃ¼ziÄŸi var Overdose olmamak sÃ¶z konusu deÄŸil
Bismarck	2 girl 1 cup wtf
Kadir Alkan	A k a lÃ¼fer
Mert K	michael caine batman basliyor kara sovalye ve yukseliyor filmindeki alfred rollerini oynamasiyla ve bu filmde yapmis olduÄŸu seviyeli ve cok komik mizahlarla kalbimde yer etmis birisiydi Allah rahmet eylesin mekani cennet olsun DIPNOT Christian bale kadar rolune en iyi uyan bir batmana bu kadar uyumlu bir yardimci gerekirdi zaten Soylemeden edemedim
GÃ¶ktuÄŸ  KÃ¶ksal	uzun zaman sonra gÃ¼ldÃ¼rdÃ¼
mehmet yurttaÅŸ	Her 31 de para atsam sanÄ±rÄ±m ekonomimize katkÄ± saÄŸlayabilirm
Ahmet Turgutov	SardÄ± SarÄ±yo
Yigit Ã–z	ilk bÃ¶lÃ¼mden harika konuk hharika konular sÃ¼persiniz
Emre GÃ¼len	Aradaki geÃ§iÅŸ mÃ¼ziklerinde Eric Andre Show un mÃ¼ziklerini bilerek mi seÃ§tiniz sayÄ±n Yorekok AdamsÄ±nÄ±z
Ahmet KÃ¼rÅŸat	Ulan gereksiz sansÃ¼rle tanÄ±dÄ±m seni vay be yÄ±llar
tarÄ±k topÃ§uoÄŸullarÄ±	Daha Ã§ok video at gÃ¶tÃ¼nÄŸskrm
Enes Malik Arslan	DÃ¼nyayÄ± yorekok yÃ¶netsin
Ã¶zgÃ¼r duru	YouTube yi kurtaracak seÃ§ilmiÅŸ kiÅŸi yorekok
Berke	Moa ladey ha bane dwraid MOAYT
Burak Ã–zcan	half life intro yorekok outro
Fraserr HD	Abi bildirimler gelmiyor
Fatih DoÄŸan	Between Two Ferns ve The Eric Andre Show karÄ±ÅŸÄ±mÄ± bir ÅŸey olmuÅŸ Ã‡ok da gÃ¼zel olmuÅŸ Sizleri tebrik ediyor ve baÅŸarÄ±larÄ±nÄ±zÄ±n devamÄ±nÄ± diliyorum Yorekok Bey
fatih alperen	hepsi iyi hoÅŸ da Michael Caine i niye Ã¶ldÃ¼rdÃ¼n onu Ã§Ã¶zemedim
PATATES ARASI KUMPÄ°R	Hugolayla da yap bence
ismini vermek istemeyen mahmut	31 Ã§ekmek istiyorsanÄ±z kumbaranÄ±za para atÄ±n diyonda para olsa atacaz
96eyagli	gÃ¼zel sohbetti real soÄŸuk savaÅŸa da bi uÄŸra
Nuriya KurdaÅŸ	Job of the harman
TEK TAK TÄ°K	http youtu be b4vQDQa1Zoc
RedSall	LORD OF BABAKOK BÄ°TCHES
yiÄŸido 0001	Biri eric andre izlemiÅŸ babaaa
Ferhat Yildirim	Enis KirazoÄŸlunu da Ã§aÄŸÄ±rabilir misin
Pluton Baykuslari	O melodi hala kafamda Ã§alÄ±yo
mikasa ackerman	Hshshhshs sonuna kadar izledim yaa Ã§ok gÃ¼ldÃ¼m sjsjsjsjsjjs
Serhat Elcin	Ah riley reid elsa jean
Can Erkin	your local eric andre
Cihat Demirel	MÃœKEMMEL
Skailbour	send bob and vagana
Jon Osterman	Bitirim Ä°kili
BÃ¼ÅŸra Maya	2 Sevdigim youtuber yan yana
volkan salman	Seni izlerken Marvel alemindeki mavi kree Ler gibi oluyor ten rengim yada otobÃ¼ste gaz Ã§Ä±kartan yaÅŸlÄ± teyzenin yanÄ±nda oturuyor gibi gÃ¶rÃ¼ÅŸmek Ã¼zere
è¡™ áƒªÔ¾Õˆà¥®uÄ· æµ³Ğ¼Ñƒ	BaslÄ± Kok â¤ï¸ educatedear
Beyza Nur	Hmm tuz
omer yildirim	real kesinlikle devam etmelisin izlerken gÃ¼lmedigim saniye yok
OG Loc	5 38 two girl one boÄŸaÃ§
Ali Ã–nal	sondaki ÅŸarkÄ± beni etkiledi
Ali	rahatsÄ±z edici bir edit beÄŸendim ğŸ‘
NameliNime	3 28 2 tane yaÅŸlÄ± KADIN var amca seninki takma mÄ±
Muhammet Ä°smet Kazak	Ä°ÅŸte ÅŸimdi kendime geldim
Seaque	Porno izliyorum PornolarÄ±n gerÃ§ek olmadÄ±ÄŸÄ±nÄ± da biliyorum film gibi izliyorum onlarÄ± 1 yÄ±ldan uzun zamandÄ±r tabiri caizse 31 Ã§ekmiyorum ama izlememek en iyisi tabi
Egemen Boz	Michael Caine Harman Oldu KÃ¶z Getir HADÄ° TÄ°KTOK Ä°NDÄ°RELÄ°M
servet Ã¶zmen	YorekokğŸ˜
Albus Percival Wulfric Brian Dumbledore	5 40 2 girl 1 cup
KreatÄ±F FikreT	BoÅŸ yapma moruq ya sen kimsin nallahÄ±m
NoThÄ°nG lOsE	yorekokun dediÄŸi Ã§oÄŸu ÅŸeyi anlamÄ±yorum sanÄ±rÄ±m cahil bir orosbu evladÄ±yÄ±m
iron man	5 40 taki video two girl one cup
mehmet play	2 girl 1 cup
uweknow da wae shje	Bu videodan sonra ciddi ciddi 31 Ã§ekmek istiyorum
okan yÄ±lmaz	EÄŸvle eÄŸvle para atmaktan kumbara patladÄ± okumadÄ±ÄŸÄ±m kitap kalmadÄ± dinlemediÄŸim teoman mÃ¼ziÄŸi kalmadÄ±
RomalÄ± Abi	Micheal Cane Ã–ldÃ¼ AAAAA AÄZIMA SIÃ‡IN AAAAAAHHHHHH
Abdulkadir Ã–zgencÄ±gor	Eric andre show Yorekok version Masa kÄ±rmak lazÄ±m olmaz Ã¶yle iÅŸin rajonu bu
Ay Adam	Beni hatÄ±rladÄ±n mÄ± lan ÅŸiÅŸko
Fatih Aytar	Schengen HarmanoÄŸlu
Emre Ã‡.	Siyah beyaz olmasÄ±na ayar oldum
Sabri Tugay ÃœstÃ¼nay	5 50 2 girl one cup Eric Andre de yapmÄ±ÅŸtÄ± Orjinal ol biraz taklitÃ§i olma d Åaka ÅŸaka seviyoruz seni babakok
Batuhan Kirli	Bu seri devam etmezse buraya kusarÄ±m
ahmet said	Ä°ncirli biskrem yok ama bim deki incirli kurabiye var olmazmÄ±
SkullKid	one man one girl two girl one cup
canerdhdj tc	O T U Z B Ä° R L E N D Ä° N
Soner Sedefoglu	The eric andre show tadÄ±nda olmuÅŸ ğŸ˜
ÅŸaka zam	Seri gelsin
Pez Elma	Michael Caine Ã¶lmedi ki neden 1933 2016 yazÄ±yor
Oyun Konsolu	O video 2 girl 1 cup muydu LÃ¼tfen o olmadÄ±ÄŸÄ±nÄ± sÃ¶yle
MarserJared	Eric Andre
ErtuÄŸrul Kalyon	Son bÃ¶lÃ¼m de garanti ebes batÄ±r gelecek
kuÅŸ tÃ¼yÃ¼	Neden bildirim gelmedi kiğŸ˜‘
Enes Kaleli	cowboy bebop geÃ§iÅŸleri beni tatmin etti sadece geÃ§iÅŸleri izledim siz de Ã§ok geÃ§iÅŸliydiniz tebrikler
arda_SG	ne izledim ben
lolGaming HD	Lan YOREKOK AMCA
Tina Dungze	seems like eric andre but not it is more like caner omur show
whitewriter	Yiyosa ingilizce kÃ¼ltÃ¼r demeye Ã§alÄ±ÅŸÄ±n ne kadar zor biliyo musunuz
GereksizPerma35 Bilal	Ä°ncirli biskerm yiyenlere kalp yazdÄ±m sandÄ±nÄ±z demi biz kalpci tayfa deÄŸiliz
Mert Sari	00 18 Subliminali de yediÄŸime gÃ¶re artÄ±k videoya geÃ§ebilirim beyin ayarlarÄ± yapÄ±landÄ±rÄ±lÄ±yor 1 0101010101010101010101010101010101010101010101010101010101010101010101010101010101010101 0101010101010101010101010101010101010101010101010101010101010101010101010101010101010101 0101010101010101010101010101010101010101010101010101010101010101010101010101010101010101 0101010101010101010101010101010101010101010101010101010101010101010101010101010101010101 0101010101010101010101010101010101010101010101010101010101010101010101010101010101010101 0101010101010101010101010101010101010101010101010101010101010101010101010101010101010101 0101010101010101010101010101010101010101010101010101010101010101010101010101010101010101 0101010101010101010101010101010101010101010101010101010101010101010101010101010101010101 0101010101010101010101010101010101010101010101010101010101010101010101010101010101010101 0101010101010101010101010101010101010101010101010101010101010101010101010101010101010101 0101010101010101010101010101010101010101010101010101010101010101010101010101010101010101 0101010101010101010101010101010101010101010101010101010101010101010101010101010101010101 0101010101010101010101010101010101010101010101010101010101010101010101010101010101010101 1000 Beyin ayarlarÄ± yapÄ±landÄ±rÄ±ldÄ± beyin koklar ile uyum saÄŸlamasÄ±na geÃ§ildi videoya geÃ§iÅŸ tamamlandÄ±
Emirhan YÃ¼cel	michael caine Ã¶ldÃ¼ sandÄ±m abv you recock
Bera Furkan	Ä°ncirli biskrem
Berke Solmaz	eric andre show a benzemis baya begendim
Napolyon Kiraz Kompleksi	E R I C A N D R E S H O W L A N D I N
Emir YÃ¼mnÃ¼	abi neden ya
murteza gÃ¼ler	Ã‡ok iyi olmuÅŸ Keyifle izledim
Sefa Adar	E K E Y ne demek E k e yAnkara gÃ¼cÃ¼ D
Fatih DÃ¼z	Eric Andre ye benzettim Yorekok tanÄ±r mÄ± bilmiyorum ama
Tuncay West	2 girl 1 cup
estonya	peki sonraki videonda kimi seÃ§iceksin
Canberk	EÄŸer bu serinini devamÄ± seri bir biÃ§imde gelmezse Babakok Server larÄ±na saldÄ±rÄ± dÃ¼zenleyeceÄŸim
Ä°nsan GT	BoÄŸaÃ§landÄ±n
MÃ¼him DeÄŸil	GÃ¼zel video olmuÅŸ izlettiriyor Daha iyi iÃ§erikler bekliyoruz
Metehan Tekayak	ĞdamsÄ±n babakok
Kaori Kanzaki	Best unexpected collaboration ever
gezegendegezen	4 33 kesinlikle gonzales hamster a benziyor
x x	Piano tile
Hasanali Ayhan	ABÄ° YORUMUMU BEGENÄ°RMÄ°SÄ°N GERÃ‡EK MÄ°SÄ°N DÄ°YE MERAK EDÄ°YORUM KRALSÄ°IN
Kerem Demirel	Edu kat eder yore koklar
Serhat ÅanoÄŸlu	2 34 ğŸ˜‚
Yusuf AltunbaÅŸ	Ted konuÅŸmasÄ± moruk ya kÃ¼ltÃ¼rlÃ¼yÃ¼m
majesty John	Video gelir bir ara deÄŸil o video her zaman gelmeli ara verme
International Tv	abi ekranÄ± siyah beyaz yapma normal yap bidahakine
Maryam Torabi	Bu seri efsane olacak
Ahmet Yusuf	Babakok yavaÅŸ yaÅŸ kÄ±sÄ±tlamsÄ± alcaksÄ±n
ArdÄ±l KÃ¼lekci	arkadaki ÅŸarkÄ±larÄ± yazabilecek olan var mÄ±
Ä°smail HakkÄ± UÄUZ	5 46 iki kÄ±z bir kupa 0 bok vallahi yok
Burak Srbs	YouTube seni bile deÄŸiÅŸtirdi be bilader eski tadÄ± tuzu hiÃ§ vermiyorsun elveda babakok
Turgut Buhurcu	Very cringe geciriyom
selman baÄŸrÄ±yanÄ±k	Ä°zledikleri videoyu merak eden bi ben miyim
karolin	yes papa
Mustafa OÄŸuzhan Ã–ZTÃœRK	Neden Ä°ncirli biskrem
Dame Junge	3 44 ğŸ˜‚
Batuhan BakÄ±roÄŸlu	Ä°lk kez bir videonu sonuna kadar izledim ondada teÅŸekkÃ¼r aldÄ±m Nerelere gitsem kimleri siksem bilemedim ÅŸuan
Kenan Oral	Neden
Ä°smigen Cotazalek	geliÅŸir bu arada bu kanal
A random girl on the internet	gerÃ§ekten kulaklÄ±k takmak gerekiyomuÅŸ sofranÄ±n ortasÄ±nda baÅŸlattÄ±m
JES! TERN	Olm fortnite Ã§ektim sandÄ±m fortnitenin ÅŸapkasÄ±nÄ± gitmiÅŸsin
*Forever Blink!*	YouTube seri zil bildirimi getir karÅŸiim
Teoman Adacan	Seni SoÄŸuk SavaÅŸ ta gÃ¶rmek dileÄŸiyle babakok
Abush Shebo	harika content
Cause of my euphoria	8 19 cuteâ™¡
Ã–mer Faruk Aksoylar	serin format
halil ibrahim koÃ§ak	morakok mabim 3
Turner Meme	Mukbang yanlÄ±ÅŸ okudun eheheheh
holycanzcrumb	0 50 ye kadar eric andre esintisi vardÄ± mÃ¼zik gelince tam anladÄ±m
JollyJoker	Oi Mait
Ä°bRaHiM ÅaHiN	Aaa boÄŸaÃ§ abi
Siverekli	Albert Camus adamdÄ±r
Demir UÄŸurlu	Mukbang video better than yorekok video
Ñusted à¸£trafer	your lady ha been dried
Goktug Bora Soylamis	Ã‡ok fazla Eric Andre Show u anÄ±msattÄ±
Mehmet Can Kara	Abi ben otuz bir Ã§ekmek istediÄŸimde otuz bir Ã§ekiyorum ama porno izlemiyorum ve bu benim gerÃ§eklik algÄ±mÄ± etkilemiyor
Emre Akbulut	Ne izledim ben
BabamÄ±n Silahlari	M Ã¼ k e m m e l olmuÅŸ
Dj Yenici	son 100 yÄ±ldÄ±r kumbarama para atÄ±yorum
ehveniÅŸer hÃ¼dayinabit	arkayada mile devi koymuÅŸ kral
YUSUF	kokshow
Anime & Game	N Ä± c e V Ä± d e o panpa
Mertcan ellialtÄ± 05081972	sizbizimÃ§ekoslavakyalaÅŸtÄ±radÄ±kÅŸarÄ±mdansÄ±nyorekok
Le Vitaminsiz	Kokx talk by Educatedear from Salih â€™ s brain
Beyzanur Demir	Offf mÃ¼kemmel yorekok love yuuuu
Batuhan Karakaya	hayata bakÄ±ÅŸ aÃ§Ä±m deÄŸiÅŸti teÅŸekkÃ¼rler Y O R E K O K
Erkam Sagdic	565 yorum galp at
FARADAY	Abi biraz Ã§alÄ±ÅŸÄ±lmamÄ±ÅŸ veya zorlama olmuÅŸ gibi bence aohbet daha samimi olsa Ã§ok gÃ¼zel olurdu ama biz senin dk da bir suratÄ±nÄ± izledik
yusuf_ sekerci	haftaya Frida Kahlo gelebilirmi babakokcuÄŸum
Mithat cem KÃ¶ktÃ¼rk	Ã§ok erotik bir video acilen kaldÄ±rÄ±lmasÄ± gerek
Tobey Maguire	MÃ¼kemmel lan
Erhancan YiÄŸitbaÅŸÄ±	SÃ¼per seri ene baturu konuk al d
DOLAR dÃ¼ÅŸÃ¼rÃ¼cÃ¼ faÅŸo	BU BOKU BEÄENÄ°N ğŸ’© Ã‡ÃœNKÃœ O BÄ°R BOK
Emre AytaÃ§	Ä°lk yengen harman oldulandÄ±nÄ±z
Zehranaz YÄ±lmaz	Steve job a sevgiler ğŸ˜ğŸŒ»
Orkun Bey	5 37 den itibaren oynayan videoyu direkt ÅŸarkÄ±yÄ± duyunca anladÄ±ÄŸÄ±m iÃ§in kendimi kÃ¶tÃ¼ hissediyorum
Haydar Abuzitin	Yorekok real efsaneydi seni izlerken ilk Ã¶nce hayatÄ±m sorgulayÄ±p gÃ¶zÃ¼mÃ¼n Ã¶nÃ¼nden geÃ§irdim ve geÃ§irirken ÅŸunu fark ettim ben otobÃ¼se binip yer bulamayan yaÅŸlÄ± teyzeler gibi hissettim ve azgÄ±n amcalarÄ±n altÄ±na girmeyi bekledim
Murat Demir	Yoreklendiniz
Mustafa KaragÃ¶l	GÃ¼zel olmuÅŸ aynen devam karÅŸim
Samet TaÅŸhan	Riley reid â¤
ahmet kerem yÄ±lmaz	Abi kumbarama para attÄ±m sonra albert camus kitabÄ± okudum saÄŸol ama isteÄŸim hiÃ§ azalmadÄ±
Yunus Emiroglu	Oooo babak naber yaa
Selam Aleykum	Igrencsiniz
Laithah	gÃ¼lerken house of babakoku gÃ¶rÃ¼p bi dÃ¼ÅŸÃ¼nÃ¼yorum
Onurr Sanver	Neyse gidip 31 Ã§ekeyim
Argus'un KrallÄ±ÄŸÄ±	Nedenini bilmiyorum ama bu videoyu aÃ§arken gÃ¼lÃ¼msedim
Ahmet Ã•mer Ã•ndiraz	The Eric Andre Show gibi olmuÅŸ iyi iÅŸ
Nesrin ErdoÄŸan	My lady ha been dried ğŸ’¦ ksdÅŸdkÅŸss
crab man	8 24 teki Ã§Ã¶zÃ¼mlemelerin cidden doÄŸru kelimesi kelimesine artÄ±k kok burcuyum 3
pesimist oyuncu	Yada 31 Ã§ekebiliriz
TuÄŸrul Tuncel	OlmuÅŸ
Neval KUTLU	Houseofbabakok
cg	Allah seni alsÄ±n yov ne kadar komiksin
Meryem Eray	Herkes gÃ¼zel yaratÄ±cÄ± yorumlar yazÄ±yor Ben ise hayalet izleyici olmak ve seri beÄŸeni atÄ±p Ã§ekmekten baÅŸka bir ÅŸey yapmÄ±yorum Affet Babakok
sCATman	Priceless
MUTLU Ã‡ALKAYA	Ä°iiiii di babakokkkk
DeyiÅŸuk Jr	Ã–zledik seni reyiz
MÃ¼cahit Kaya	BaÅŸarÄ±lÄ±
Nihat Imrak	abi 4 menÃ¼ nedir ya SAKAT BIRAKIR
Jordi El Nino Polla	Ben ne izliyorum amÄ±nankoyim
Ä°brahim PalaÅŸoÄŸlu	Ayakta duran Hannibal eksik
feyza vaveylai	10 09 bakÄ±s Ä±dkdkd
GÃ¶kay KurtoÄŸlu	ben ne izledim diyorum ÅŸuan en azÄ±ndan iki eski analog mizahÅŸÃ¶rleri izlemek iyi ki varsÄ±nÄ±z
DarkEar	babamÄ±n maaÅŸÄ±nÄ± elime geÃ§irdiÄŸim an kumbaraya attÄ±m saol babakok
Aliihsan HaÅŸhaÅŸ	Big bang teori ÅŸarkÄ±sÄ± duyunca duygulanan
ByPersians	Sen ulke icin cok yaratlisin o yuzden Saka lan saka videolrun mikemmel cringden arinmisssin ama seni cogaltmamiz lazim
Mr. Cringe	Post sosisvesalam
Ahmet Kemal YILMAZ	Ne idÃ¼ÄŸÃ¼ belirsizler
Yusuf Kucuk	Efsane olmuÅŸ bÃ¶yle devam et
H B	04 28 neye benziyor sence Ã¼zÃ¼cÃ¼ bir hayata ÅDNFÅWÄFÃ–EÄCMGÃ‡NÄDMFKDNFÃ‡Ã–VÃ‡D
OLD MAN WOLWERINE	M Ãœ P T E Z E L L E N D I N
Pussy Slayer	Eric Andre show havasi olmus BEGENILDI
Hello Negibor	4 05 yemek yiyordum lan yemek
Itachi	holy shit caine
AyÅŸegÃ¼l Åafak	5 50 2 girl 1 cup
S.Bahadir Turker	Abi neden reklamlarÄ±nda aleyna tilki var
When Music Talks...	MY LAYDY HAS BEEN DRIED BRING SOME EMBAH PLEAS
buse aydÄ±n	my ladie ha been dried asdfg
Mustafa KarpÄ±nar	Hahafhhj
Muhammed AKAN	4 51 o kadar iyi aÃ§Ä±klamÄ±ÅŸki iÃ§im rahatladÄ±
MThan	Daha az kanser koy
chin chin	Eric Andre den content Ã§almak iyiymiÅŸ kokcum
Furkan M.B	Yine aydÄ±nlattÄ±n bizi babakok sokuÅŸturamadÄ±klarÄ±mÄ±zdanmÄ±sÄ±nÄ±z
Strawberry Field Guard	2 KOK 1 CUP
NEQOLAÄ°SER	sanki bu videodan Ã¶nce bi video daha vardÄ± biÅŸeler mi oldu izleyemedim bea I
Arda Albayrak	Olm tipin Ã§ok tatlÄ± la
DoÄŸukan subaÅŸÄ±	Emma watson 3
sekseverler derneÄŸi	Remix adam senin tÄ±rnaÄŸÄ±n olamaz abim Sen komikli remixlerle youtube tÃ¼rkiyeyi ele geÃ§irmiÅŸken remix adam pipisiyle oynuyordu
Empire Of Game	Tiktok dÃ¼nyada gÃ¶rdÃ¼ÄŸÃ¼m en en en en en en en en en en en en en en en en en en en en en en en en en en en en en en en en en en en en en en en en en en en en en en en en en en en en en en en en en en en en en en en en en en en en en en en en en en en en en en en en en en en en en en en en en en en en en en en en en en en en en en en en en en en en en en en en en en en en en en en en en en en en en en en en en en en en en en en en en en en en en en en en en en en en en en en en en en en en en en en en en en en en en en en en en en en en en en en en en en en en en en en en en en en en en en en en en en en en en en en en en en en en en en en en en en en en en en en en en en en en en en en en en en en en en en en en en en en en en en en en en en en en en en en en en en en en en en en en en en en en en en en en en en en en en en en en en en en en en en en en en en en en en en en en en en en en en en en en en en en en en en en en en en en en en en en en en en en en en en en en en en en en en en en en en en en en en en en en en en en en en en en en en en en en en en en en en en en en en en en en en en en en en en en en en en en en en en en en en en en en en en en en en en en en en en en en en en en en en en en en en en en en en en en en en en en en en en en en en en en en en en en en en en en en en en en en en en en en en en en en en en en en en en en en en en en en en en en en en en en en en en en en en en en en en en en en en en en en en en en en en en en en en en en en en en en en en en en en en en en en en en en en en en en en en en en en en en en en en en en en en en en en en en en en en en en en en en en en en en en en en en en en en en en en en en en en en en en en en en en en en en en en en en en en en en en en en en en en en en en en en en en en en en en en en en en en en en en en en en en en en en en en en en en en en en en en en en en en en en en en en en en en en en en en en en en en en en en en en en en en en en en en en en en en en en en en en en en en en en en en en en en en en en en en en en en en en en en en en en en en en en en en en en en en en en en en en en en en en en en en en en en en en en en en en en en en en en en en en en en en en en en en en en en en en en en en en en en en en en en en en en en en en en en en en en en en en en en en en en en en en en en en en en en en en en en en en en en en en en en en en en en en en en en en en en en en en en en en en en en en en en en en en en en en en en en en en en en en en en en en en en en en en en en en en en en en en en en en en en en en en en en en en en en en en en en en en en en en en en en en en en en en en en en en en en en en en en en en en en en en en en en en en en en en en en en en en en en en en en en en en en en en en en en en en en en en en en en en en en en en en en en en en en en en en en en en en en en en en en en en en en en en en en en en en en en en en en en en en en en en en en en en en en en en en en en en en en en en en en en en en en en en en en en en en en en en en en en en en en en en en en en en en en en en en en en en en en en en en en en en en en en en en en en en en en en en en en en en en en en en en en en en en en en en en en en en en en en en en en en en en en en en en en en en en en en en en en en en en en en en en en en en en en en en en en en en en en en en en en en en en en en en en en en en en en en en en en en en en en en en en en en en en en en en en en en en en en en en en en en en en en en en en en en en en en en en en en en en en en en en en en en en en en en en en en en en en en en en en en en en en en en en en en en en en en en en en en en en en en en en en en en en en en en en en en en en en en en en en en en en en en en en en en en en en en en en en en en en en en en en en en en en en en en en en en en en en en en en en en en en en en en en en en en en en en en en en en en en en en en en en en en en en en en en en en en en en en en en en en en en en en en en en en en en en en en en en en en en en en en en en en en en en en en en en en en en en en en en en en en en en en en en en en en en en en en en en en en en en en en en en en en en en en en en en en en en en en en en en en en en en en en en en en en en en en en en en en en en en en en en en en en en en en en en en en en en en en en en en en en en en en en en en en en en en en en en en en en en en en en en en en en en en en en en en en en en en en en en en en en en en en en en en en en en en en en en en en en en en en en en en en en en en en en en en en en en en en en en en en en en en en en en en en en en en en en en en en en en en en en en en en en en en en en en en en en en en en en en en en en en en en en en en en en en en en en en en en en en en en en en en en en en en en en en en en en en en en en en en en en en en en en en en en en en en en en en en en en en en en en en en en en en en en en en en en en en en en en en en en en en en en en en en en en en en en en en en en en en en en en en en en en en en en en en en en en en en en en en en en en en en en en en en en en en en en en en en en en en en en en en en en en en en en en en en en en en en en en en en en en en en en en en en en en en en en en en en en en en en en en en en en en en en en en en en en en en en en en en en en en en en en en en en en en en en en en en en en en en en en en en en en en en en en en en en en en en en en en en en en en en en en en en en en en en en en en en en en en en en en en en en en en en en en en en en en en en en en en en en en en en en en en en en en en en en en en en en en en en en en en en en en en en en en en en en en en en en en en en en en en en en en en en en en en en en en en en en en en en en en en en en en en en en en en en en en en en en en en en en en en en en en en en en en en en en en en en en en en en en en en en en en en en en en en en en en en en en en en en en en en en en en en en en en en en en en en en en en en en en en en en en en en en en en en en en en en en en en en en en en en en en en en en en en en en en en en en en en en en en en en en en en en en en en en en en en en en en en en en en en en en en en en en en en en en en en en en en en en en en en en en en en en en en en en en en en en en en en en en en en en en en en en en en en en en en en en en en en en en en en en en en en en en en en en en en en en en en en en en en en en en en en en en en en en en en en en en en en en en en en en en en en en en en en en en en en en en en en en en en en en en en en en en en en en en en en en en en en en en en en en en en en en en en en en en en en en en en en en en en en en en en en en en en en en en en en en en en en en en en en en en en en en en en en en en en en en en en en en en en en en en en en en en en en en en en en en en en en en en en en en en en en en en en en en en en en en en en en en en en en en en en en en en en en en en en en en en en en en en en en en en en en en en en en en en en en en en en en en en en en en en en en en en en en en en en en en en en en en en en en en en en en en en en en en en en en en en en en en en en en en en en en en en en en en en en en en en en en en en en en en en en en en en en en en en en en en en en en en en en en en en en en en en en en en en en en en en en en en en en en en en en en en en en en en en en en en en en en en en en en en en en en en en en en en en en en en en en en en en en en en en en en en en en en en en en en en en en en en en en en en en en en en en en en en en en en en en en en en en en en en en en en en en en en en en en en en en en en en en en en en en en en en en en en en en en en en en en en en en en en en en en en en en en en en en en en en en en en en en en en en en en en en en en en en en en en en en en en en en en en en en en en en en en en en en en en en en en en en en en en en en en en en en en en en en en en en en en en en en en en en en en en en en en en en en en en en en en en en en en en en en en en en en en en en en en en en en en en en en en en en en en en en en en en en en en en en en en en en en en en en en en en en en en en en en en en en en en en en en en en en en en en en en en en en en en en en en en en en en en en en en en en en en en en en en en en en en en en en en en en en en en en en en en en en en en en en en en en en en en en en en en en en en en en en en en en en en en en en en en en en en en en en en en en en en en en en en en en en en en en en en en en en en en en en en en en en en en en en en en en en en en en en en en en en en en en en en en en en en en en en en en en en en en en en en en en en en en en en en en en en en en en en en en en en en en en en en en en en en en en en en en en en en en en en en en en en en en en en en en en en en en en en en en en en en en en en en en en en en en en en en en en en en en en en en en en en en en en en en en en en en en en en en en en en en en en en en en en en en en en en en en en en en en en en en en en en en en en en en en en en en en en en en en en en en en en en en en en en en en en en en en en en en en en en en en en en en en en en en en en en en en en en en en en en en en en en en en en en en en en en en en en en en en en en en en en en en en en en en en en en en en en en en en en en en en en en en en en en en en en en en en en en en en en en en en en en en en en en en en en en en en en en en en en en en en en en en en en en en en en en en en en en en en en en en en en en en en en en en en en en en en en en en en en en en en en en en en en en en en en en en en en en en en en en en en en en en en en en en en en en en en en en en en en en en en en en en en en en en en en en en en en en en en en en en en en en en en en en en en en en en en en en en en en en en en en en en en en en en en en en en en en en en en en en en en en en en en en en en en en en en en en en en en en en en en en en en en en en en en en en en en en en en en en en en en en en en en en en en en en en en en en en en en en en en en en en en en en en en boÅŸ ÅŸeydir
Murat Ãœzel	Videodan sonra gelen anlamsÄ±z incirli bi biskrem yeme isteÄŸi
martin Schreibenwerologtransilowski	muvaffakiyetsizleÅŸtiricileÅŸtiriveremeyebileceklerimizdenmiÅŸsinizcesine
Elif	Babakok Andre Show
qlows kkk	Video gÃ¼zelde inÅŸallah renk kÃ¶rÃ¼ deÄŸilimdir
Stop it Get some help	Ã‡ok iyi olmuÅŸ kskdbskdjajskjflskd
Yunus Ã‡iftci	two girl one cup videosu o D
Tarla Faresi	ulan herif yaÅŸÄ±yo neden Ã¶ldÃ¼rdÃ¼n bi de 2016 da
Salih Demirel	yorekok seni neslimizin boktanlÄ±ÄŸÄ±ndan bizi kurtaracak siber bi ÅŸÃ¶valye olarak gÃ¶rÃ¼yorum
Samet Basaran	Daha fazla bekliyoruz video BABAKOK
Ferhat Kuru	Sesin Montaj mÄ±
Deadpool Game boy	Yorekok ve Educatedear mÄ± Mom Get the camera
Fatih oyunda XXx	bende gitmedi youtube
oÄŸuzhan Ã§alÄ±ÅŸkan	eric andre nin daha sakin olanÄ±
Deniz GenÃ§tÃ¼rk	Bence izleyin ve Ã§ekin
Alper ÅimÅŸek	Bu sefer de eric andre teliflicek
SASÄ° FANBOY	Yorekol
Wantonsergea	Abi lÃ¼tfen bts elestir bikrtim su bts den
Hasan mert ÅŸimÅŸek	Babakok why so Eric Andre
Habbo Really	GÃ¼lÃ¼yodur heralde ğŸ˜…ğŸ˜…ğŸ¤£
Enes Okyanus	Ses kalitesi gittikÃ§e kÃ¶tÃ¼leÅŸiyor AynÄ± hayatÄ±m gibi Bu videoyu neden izledim ben ya
YutubÃ§u	el kokado sohbet zamanÄ± kalÄ±p atarmÄ±sn adamÄ±m
FÄ±rat YÄ±lmaz	Harika konulara parrrrmak bastÄ±n
Just Play Games	3 47 Yorekok but with mental breakdown
Nlh Krky	Dekor fena qardeshimm
Ahmet Ã‡ankaya	yorekok kendi batman filmini Ã§ekmelisin
Furkan TÃ¼rkcan	Neyse gideyimde bi 31 Ã§ekeyim
Huseyn Memmedov	Tolga cevik gelsin next bolumde
yavuz selim ALTUN	Ne izledim ben
The Royal Whistle	mÃ¼thiÅŸ bir iÃ§erik olmuÅŸ umarÄ±m 1000 bÃ¶lÃ¼m gider
Betmen Motovlog	ruh hastasi D
MiraÃ§ AdaÅŸ	iÅŸde bu
Paradoxy 2023	A K A Sahibinin sesi
Parkour secption	O video neydi acaba merak geldi
SwctPass	Birdahakine beni alarmÄ±sÄ±n
Ã–mer Kahraman	Bu videoyu heycanla aÃ§tÄ±ÄŸÄ±m iÃ§in kendimden utanÄ±yorum
Burak Samed DoÄŸu	abi adam Ã¶lmemiÅŸ ki niye Ã¶ldÃ¼ dediniz ayÄ±p deÄŸilmi yav D
san paste	France pig
Mustafa Niyazi	ilk baÅŸta subliminal mi koydun abi D senden beklemezdim yaw
Deniz Antigone	meme review 8 56
WONG	video yu izlerken 31 Ã§ekmek CSDEAFDRVGTHBGERTHGWERTHG
Kaya Alp TÃ¼tÃ¼ncÃ¼	AmatÃ¶r izliyordur
Alex Ruthbone	Epilepsi uyarÄ±sÄ± niye yapmÄ±yorsunuz GÃ¶zlerin birbirini sikti
Slade Wilson	2 koks 1 wow
Ece Aksoy	BomboÅŸ bir videoydu MuhteÅŸem
VictorySniper	yorekok deep turkÄ±sh web le viddeo Ã§ek bence sikiÅŸ amcÄ±klÄ± olsun
YaÄŸmur	BoÄŸaÃ§ abim be
Ã–mer KÄ±zÄ±lkaya	GÃ¼zel olmuÅŸ artÄ±k her 31 Ã§ekmek isteÄŸimde bu videoyu aÃ§Ä±cam
Sami E.	Abim Ã§ok gÃ¼zel olmuÅŸ ama Pewdiepie ya saldÄ±rma olayÄ± internet ÅŸakasÄ± Hintli olan T series kanalÄ± onu geÃ§mek Ã¼zere diye platforma olan gelen bi saldÄ±rÄ±
MFG Master	Efsane
EtsizÃ‡iÄŸKÃ¶fteOlmaz	bu ikisini bir odaya kapatÄ±p sabaha kadar konuÅŸturmak lazÄ±m
Yusuf Kaan ErdoÄŸan	Mouse of babakok so Soryyy
Ã¶zcan arslan	onur nerden vuracaÄŸÄ±nÄ± iyi biliyorsun he
BulaÅŸÄ±kSÃ¼ngeriSÃ¼ngerBob	Le bababok
Bulut KoÃ§	K A R D E Å Ä° M Y E N G E N K U R U D U S E R Ä° K Ã– Z G E T Ä° R
Children waiting for the day they feel good	outro
Lucifer	Sonraki bÃ¶lÃ¼me Jahrein i Ã§aÄŸÄ±rÄ±r mÄ±sÄ±n
DJ EsqaliÅ¾e	8 29 mÃ¼zik ismi lÃ¼tfen
Rage 2	HoB
haci baba	bi soÄŸuk savaÅŸ patlar hee
kangal	tiktok izledikÃ§e 31 cekÄ±om 31 cektikce ted konumasÄ± dinlÄ±om
Seri KÃ¶z Getir KardeÅŸim	BABACOCK
Herhangi Biri	bir sonraki house of babakok bÃ¶lÃ¼mÃ¼ne seri getirilmeyen kÃ¶zÃ¼ konuk al
Kill Zone	31Ã§ekmeisteÄŸiduyuyorum
Mirzan	Lan yorekok Ã¶yle olduÄŸunu sanÄ±yorsun ama hiÃ§ eÄŸlenceli bir eleÅŸtiri kanalÄ± deÄŸilsin ama biliyorum bu durum zerre kadar sikinde deÄŸil aynÄ± ÅŸey benim iÃ§in de geÃ§erli
UÄURCAN GÃœRPINAR	O deÄŸil de Editleri en kaliteli olan tek youtube kanalÄ±
jont	Bu video benden daha aÅŸaÄŸÄ±lÄ±k â˜ ï¸
ERTUÄRUL Ã‡ILDIR	YA ÅU BAHO ÅEYSÄ°NÄ° YAPMAYIN Ã‡OK SEVÄ°YE DÃœÅÃœYO SONRA JAHREÄ°NE FALAN SARMIÅLARDI Ã‡OK REZÄ°L OLMUÅLARDI
Diagonal BrambLe	damn son where d you find this
Polizei	yengen K U R U D U kardeÅŸim seri K Ã– Z
Ahmet Aksu	Abi bugunden itibaren o 31 cekmeyip para atma isini yapacak ve gelismeleri buraya yazacagim
Furkan Åenel	KARDEÅÄ°M SERÄ° VÄ°DEO GETÄ°R Ä°ZLEYÄ°CÄ°LER KURUDU
Ali Balta	Baba supersin
Mehmet Yavuz	Outro da Ã§alan ÅŸarkÄ± nedir bilen var mÄ±
zEEp	EÄŸitimli kulak
Prometheus	Can sungur gelsin Efsane olur
Gayem Malta	Ã–zlÃ¼yoruz â£
Sarper DÃ¶nmez	Bkz Yengen harman oldu
Keyfimin KahyasÄ±	Video Ã§ekimini yaparken kestiÄŸiniz yerleri de video sonuna ekleseniz daha iyi olur aslÄ±nda
TeflonTepsi	tu gÃ¶rl van kap
s1	2 kral 1 video
ADOLF HITLER	Kendi yorumumu arÄ±yorum moruq
Rexla	ilk defa az renkli video sonunda gÃ¶zÃ¼m aÃ§Ä±k izliyeceÄŸim epilepsi hastasÄ±yÄ±m aynÄ± anda 1 den Ã§ok renge bakÄ±nca epilepsim tetikliyor maÄŸlum yorekokun videolarÄ± pavyon gibi Ä±ÅŸÄ±klÄ± mÄ±ÅŸÄ±klÄ± gÃ¶zÃ¼m kapalÄ± izliyorum hep sadece s
Yunus Emre	Efsanemk
Tesla Bey	2 Sap 1 kok
Fikir. Kaya	Baba dogru yolda ooh yeahh p
OÄŸuz Kaan CÃ¼ni	YORERIC ANDRE VE KONUÄU
Burcu	Cok eÄŸleniyorum seni izlerken babakok gÃ¶zÃ¼mÃ¼z yollarda kalmÄ±ÅŸtÄ±
Mehmet Cengiz	Beynimi yaktÄ±gÄ±n iÃ§in tÅŸkler kalp at C
gren gren	Mesela doruk yavuz ted konuÅŸmasÄ± findux 31 kumbara diferansiyel denklemler
Bruce Wayne	babakok eric andre seviyor sanÄ±rsam
Oyuncu avÄ±	abi efso olmuÅŸ hayattan ve nuggettan mahvolmus ruhum Ã§ok bÃ¼yÃ¼k bir acÄ±yla izledi
tayyip oksuz	Kalitesiz talk show lara Ã¶rnek olmasÄ± umuduyla
Berat BAKI	PRÄ°M DEVRÄ°YESÄ° GELMELÄ° BENCE 1
Utku Aslan	Ted konuÅŸmasÄ±nÄ± Ted kolejliler mi izliyor
Soldier Elite	Daha bi saat olmuÅŸ 400 yorumu da ben atÄ±yÄ±m dÃ¼z saÃ½Ä± olsun
Devilevils	tam 31 Ã§ekecektim bu video bana hayatÄ± sorgulattÄ± teÅŸekkÃ¼rler yorekok ve educatcatcacasdad
Fatih Kaplan	Sonunda be babakok â™¡
Sinan CoÅŸkun	Educattedear Y O R E K O K L A N D I N
Nuri KÃ¼lahcÄ±	10 dakikanÄ±n Ã¼stÃ¼nde yengen harman oldu lÃ¼tfen seri devam etsin yoksa seni macbang yanlÄ±ÅŸ yazmÄ±ÅŸ olabilirim videosunda ki kÄ±llarÄ±n arasÄ±na sokarim
Recep Emre Ada	Tek dikkatimi Ã§eken yorekok un sÃ¼rekli Ã§arptÄ±ÄŸÄ± Ã§iÃ§ek ve mum
Erdem Teker	o muhabbetin orijinali kardeÅŸim seri limonlu soda getir yengenin boÄŸazÄ± kurudu boÄŸaÃ§Ä±n dediÄŸi gibi kÃ¶zle Ä±slanmanÄ±n yada kuruluk gidermenin alakasÄ± yok kurumasÄ±nÄ±n sebebi de fazla nargile iÃ§mesi
Ã–mer Benian	1 cup 2 girl SansÃ¼rlenen video
Mobil Oyuncu	Micheal caine Ã¶lmedi
A-Social Man	EducateEar
Mustafa KÄ±lÄ±Ã§	35 dakika
Ã–mer Yurdunol	yengenkurudukÃ¶zgetir
Emre Ã–ksÃ¼z	Abi yemin ederim ÅŸuana kadar en Ã§ok gÃ¼ldÃ¼ÄŸÃ¼m kabus oldu D D
Engin GÃ¶ksuakar	ğ„ğƒğ”ğ‚ğ€ğ“ğ„ğƒğŠğğŠ
Enes Kaya	ADAMKOK
Hetaro	H O B
TastyGamersTv	Yorum
Pipildek	09 05 meme review
Comolokko Man	Hosbulduk
Nakro Nakroth	Desperado da calan music esnasinda yorekok adeta Quentin TarantinolandÄ±ÄŸÄ±nÄ± hissettim LÄ°KE A BOSS
BÄ°ZÄ°M FAKÄ°RHANE	gzl olmÅŸ krdÅŸm bÄ±ravo
Turk Astronout	ok
Faruk AydÄ±n	Tedx izledikten sonra patlattÄ±m bi tane xD
crowding out	Yorekok hocam montunla bir dean winchester olmuÅŸsun sormasÄ± ayÄ±p nereden aldÄ±n yakÄ±ÅŸmÄ±ÅŸ yani paylaÅŸ bizimle saygÄ±lar
Ã–mer Faruk GÃ¶ktepe	Abiiii
Åehirdeki Ä°nsan	aldÄ±ÄŸÄ± konuktan Ã§ok kendini Ã¶n plana Ã§Ä±karan tek program tebrikler
ÃœLKÃœCÃœ BOZKÃœRT	yorekok un gerÃ§ek adÄ±nÄ± biliyorum
Ã¶mer balkÄ±ÅŸ	Senin sayende zengin oldum
ãƒ„taylan winner	HENTAIIIIIIIIIII WEWWEQWQEWQ
Kaan Ergin	Videodan hemen porno aÃ§tÄ±m ve aÄŸlayarak 31 Ã§ektim
Batuhan yÄ±ldÄ±z	2 Cocks 1 Ear
Godly Or Godlee	gÃ¼zel video he bu arada eric andre devam ediyormu bilen varmÄ± nerden izleyebilirim o 2 girl 1 cup yerine 2 kid 1 sandbox felan gÃ¶sterebilirdin tam Ã§almÄ±ÅŸsÄ±n be abey
BarÄ±ÅŸ GÃ¼ler	Michael Caine Ã¶lmedi Ki sen bunu zaten biliyordun
DeaD inside	Ne boktan manasÄ±z ve gerksiz bi videoydu
EFSANE SARAN	turkish eric andre show
Sorry For My Bad England	Asya ÅŸarkÄ±larÄ±nÄ±n kliplerini inceler misin
sÄ±la	KeÅŸke 3 saat falan olsaydÄ± Ã§ok kÄ±sa oldu bu babakok ğŸ’œ
Usame Ã‡aÄŸtay	Sende mi Yorekok
limonun sikilmiÅŸ diÄŸer yarÄ±sÄ±	Her 31 Ã§ekmek istediÄŸimde kumbaraya para arsaydÄ±m ÅŸu an tramp ayak parmaklarÄ±mÄ±n arasÄ±ndaki siyah kiri emcikliyo olurdu
EREN POLAT	Ä°YÄ° TAÅAK GEÃ‡Ä°YORSUN TANIMADIÄIM HALDE NEFRET ETTÄ°ÄÄ°M KÄ°ÅÄ°LERDEN YOUTUBER
alpgiray nyan	Bu victory royale ÅŸapkasÄ±nÄ± belediye mi daÄŸÄ±tÄ±yor boiii
KlÃ¸us	Tiktok Ã¶lÃ¼m asla denemeyiniz
ibrahim kaynak	Mulholland Drive Ä±n iÃ§ine Krimcan Ä± koyman psikolojik yoÄŸunluÄŸunu betimledi kardeÅŸim ğŸ’†
Kerel	BoÄŸaÃ§ Ä±n Ã¶mrÃ¼nden Ã¶mÃ¼r gitti kardeÅŸim nasÄ±l format bu
Garip voltadÄ±r	ArtÄ±k 31 cekmicem teÅŸekkÃ¼rler babakok
Nao Lithic	Nibbas tartÄ±ÅŸÄ±yor
Halit CerrahpaÅŸalÄ±	RICA ETSEM SALÄ°H REÄ°S GAMZE VE BABASINI KONUK ALABÄ°LÄ°R MÄ°SÄ°N BEN DE Ã–YLE TAHMÄ°N ETMÄ°ÅTÄ°M TEÅEKKÃœRLER
Hezyan	Michael Caine Ã¶ldÃ¼ mÃ¼ ya
Hasan Demirlek	Youtube geri dÃ¶nÃ¼yor
Kutay Madenci	ben ted yerine geekyapar izliyorum ama
Bilgin Durmusali	sondaki mÃ¼zik ismi lÃ¼tfen Ã§abuk teÅŸekkÃ¼rler
Kubilay Erkan	Between two koks
Ã‡ukulata %	Enfes
GodoÅŸ Matriks	Ä°yide Ã§ok iyi ya
Serkan Turan	Between two fern
gamer bro	8 22 valla mÄ± la
Glass Man	beyin hÃ¼cremi 20 e indirdin yorekok
Onur Ugur	BurasÄ±nÄ±n cringe olmamasÄ± gerekiyordu sadece ted konuÅŸmasÄ± ufkumuzu aÃ§ar sÃ¶zleri Ã§ok fazla cringe deÄŸil miydi
KÄ±raÃ§ Aslan	kardeÅŸim yengen kurudu seri video at
Beyza x	0 46 youtube tr nin gidiÅŸatÄ±nÄ± dÃ¼ÅŸÃ¼nÃ¼rken tam olarak bÃ¶yle oluyorum YanlÄ±z duygularÄ±ma deÄŸil mimiklerime de tercÃ¼man olduÄŸun iÃ§in teÅŸekkÃ¼rler BabakokğŸ’›
ayranÄ±m dÃ¶kÃ¼lmesin gÃ¶tÃ¼m sikilmesin	Cock penis deÄŸil mi Ã§ok ayÄ±p
mustafa boran	beyler iyi izleyin diÄŸer video 10 yÄ±l sonra gelicek ehuehu
yigi	yengen kurudu gel vajinasini yala
Kemal Arda Ayar	meh
Deniz Ä°ster	Abi gay sikis porno yapsaniza
i love natsuki	1 cup 2 girl
Baranalp Aksal	B Hala Albert Camus â€™ u dÃ¼ÅŸÃ¼nÃ¼yorum Y Osbir Ã§eherken mi
Stuka Blyat	Yok Ã¶yle soÄŸuk savaÅŸlar Ğ”Ñ€ÑƒĞ³
Yasin Kaygusuz	Niye Elsa jean
Steam Steam	Yorekok sayfanin bildirimlerini aÃ§tÄ±m ama bana video attiÄŸÄ±na dair bildirim gelmiyor neden
esrachunli	Doruk boÄŸazÄ±nda ne var kanka kablomsu bir ÅŸey gibi
adasgamer67 gf	mukbanq videosu bekliyoz moruq
Can KantarcÄ±	Sen varken remixadam kim reyiz
Ahmet SAYGILI	Babakok soÄŸuk savaÅŸa katÄ±l reyiz
DoÄŸukan Canbulut	le educcate ear face
Emre Ãœmit Er	Beyin yalpalamasÄ± geÃ§irten bir video olmuÅŸ nÃ¶ronlarÄ±nÄ±za saÄŸlÄ±k 3
Minnak Tilki	Yorekok soÄŸuk savaÅŸa gelsin
Aykut Ã‡am	BoÄŸaÃ§ â€™ Ä± Yorekok â€™ tan kÄ±skanan bi ben miyim
Osman ErdoÄŸan	Yorekok bu mecralarÄ±n en iyisi deÄŸil mi lan
sin miedo	ğŸ‘2 GIRL 1 CUP ğŸ‘
TarÄ±k Åamil ÅAHÄ°N	SansÃ¼rlÃ¼ video 2 girl 1 cup videosuydu da ben niye bunu biliyorum ya
PsyNova	efsane ikili bi arada
Mister Pandastic	Depresyonum 3 kat daha gÃ¼Ã§lendi
Caner taÅŸkÃ¶y	31 sonrasÄ± izleme keyfi
tyretear	2 36 HDSIRPFHWAEIORHEWNIQRFHYERTEHSITJ
Sakura Hagiwara	Yorekok â¤
Piano Hands	Ahahaha bu konsepti sevdim
Serhat GenÃ§	BABAKOK
Eren Bozkurt	Can sunguru cagÄ±r
Maxipyke	ÅŸu an ÅŸu daÄŸlarÄ±n arkasÄ±nda aaaaa diye baÄŸÄ±ran dayÄ± var ya onun gibi baÄŸÄ±rÄ±p yÃ¼zlerinize bakarak 31 Ã§ekmek istiyorum o yÃ¼zden kumbarama para atÄ±p albert camus okurken teomanla cinsel iliÅŸki yaÅŸayacaÄŸÄ±m ÅŸey pardon teoman dinleyeceÄŸim
Haje	Eric Andre Show esintileri gÃ¼zel
Numb	ï¼«ï½ï½Œï½‰ï½”ï½…
FNC Faker	Her 31 Ã§ekmek istedinizde yorekok aÃ§Ä±n
Deniz Duru	2 Girls 1 cup 5 37
Berk	HacÄ± biraz reklamÄ±na video dÃ¼ÅŸmÃ¼ÅŸ
Nescient H	SoÄŸuk savaÅŸta seni gÃ¶rmek isteriz
mert aydogan	bekleyelim video gelir bir ara
Yusuf YILDIRIM	ne her 31 Ã§ekmek istediÄŸimde kumbarama para mÄ± atiyim zenginim dostum
Buse Ozturk	3 50 kulaklÄ±kla dinleyenlere 5 saniyelik saygÄ± duruÅŸu
frkn krks	tam kuruyoduk geldin
Yunus Ã‡oban	Efsanesinizzzz
Deniz Aksakal	Eric Andre show
Teolia	Abi gerÃ§ekten efsane devamÄ± gelsin ya en kaliteli iÃ§erik manyaksÄ±n sen D
SivilceSurat	ÅŸey deÄŸil mi ya bu napiyoruzbizki
Berke Ãœnal	BilinÃ§li bir ÅŸekilde ve standartlarÄ± belirlenerek Ã§ekilmiÅŸ rezil bir video Ä°zlediÄŸim en kÃ¶tÃ¼ 10 video arasÄ±na girebilir Ã§ok baÅŸarÄ±lÄ±
Dragonborn _5445	Birdahakine berk gelsin
Emirhan Altun	3 28 iÃ§eride 2 tane yaÅŸlÄ± kadÄ±n var D
gÃ¶rkem gÃ¼ler	2 bÃ¶lÃ¼m deep turkish web ile olsun
HanSulh	TED konuÅŸmalarÄ± izleyecek genÃ§lere uyarÄ± Eski TED videolarÄ±nÄ± izleyin bi 2016 Ã¶ncesi fln yenileri Ã§ok bozdu Eskiden veri ve objektif gerÃ§ekler yada farklÄ± felsefik bakÄ±ÅŸ aÃ§Ä±larÄ± Ã¼zerine enteresan eÄŸitici ve bilgilendirici konuÅŸmalar oluyordu Åimdi ise daha Ã§ok kiÅŸisel doÄŸrular hisler ve sÃ¶zdebilim metafizik saÃ§malÄ±klar Ã¼zerine konuÅŸanlar Ã§Ä±kÄ±yor hep TED konuÅŸmalarÄ±na bilmiyorum TED bilerek mi yapÄ±yor yoksa Ã§Ä±kÄ±p konuÅŸacak akÄ±llÄ± adam mÄ± kalmadÄ± Tabi yeni konuÅŸmalardan da gÃ¼zel olanlar var ama geneli bahsettiÄŸim gibi
Osman BEYAZAY	AklÄ±mda porno izlemek yoktu aklÄ±ma soktunuz
DoÄŸukan Keskin	sizi shipliyorum
BuÄŸra Ã§alÄ±ÅŸkan	Kumbaraya attÄ±ÄŸÄ±m paralarla zengin oldum Ã§ok teÅŸekkÃ¼rler yorekok
soomeoone oordinary	En son Ã§alan mÃ¼ziÄŸin adÄ± nedir
egolu kiÅŸi	Åu arkadaki jazz mÃ¼ziÄŸini bilen varmÄ±
Smiley	Yeni HOB h o
LaToupe Extreme	Senin yÃ¼zÃ¼nden tekrar porno izledÃ¼ym
Serhat GÃ¼zel	200 IQ SUN
Buse Kahraman	Son kÄ±sÄ±mlarda Ã§ok tatlÄ±ydÄ±n be Babakok
Muhammet IÅŸÄ±k	Oha en sevdiÄŸim remixÃ§i ve yutubÄ±r yan yana ğŸ’™
HiroÅŸ hima	HayatÄ±mÄ±n deÄŸiÅŸtiÄŸini hissedebiliyorum D
alperen ipek	BABACOCK IN FIRE
Mehmet Ã‡oksever	educate ear kim
Ahmet Veli Dirican	Yorekok artÄ±k bimden alÄ±nmÄ±ÅŸ bozuk sÃ¼t gibisin
Furkan PoÃ§an	Oyyyyy ne video beeeeeeeeee
Tayfun Ä°Ã§pÄ±nar	Bu adam boktan espriler yapÄ±p zorla gÃ¼lme videolarÄ± Ã§eken arkadaÅŸ deÄŸil mi
MEHMET KORHAN	Bu iÅŸi biliyosun
serdar al	DÃ¼nya Ã¼zerindeki en boÅŸ video filan ama yine de izledim ve sorgulamÄ±yorum Ã§Ã¼nkÃ¼ boÅŸ ÅŸeyler zevklidir babakok candÄ±r
Ahmet Nadir KeÃ§eci	BoÄŸaÃ§ Ã§Ä±plak adamÄ±n videosunu izlerken yemeÄŸe kitlendi hissettim aÃ§ mÄ± yayÄ±na Ã§Ä±kardÄ±nÄ±z lan adamÄ±
Furkan Åen	Tuvalette eskiden p rno izliyordum bu videodan sonra babakok izliyorum
RED Risus	bu molotofÃ§u niye burda binalarÄ± ateÅŸe vermekten fideleri yerinden sÃ¶kmekten mi sÄ±kÄ±ldÄ±
Bora TÄ°LEYÄ°	Lan
OÄŸuz	Michael Caine i de Ã¶ldÃ¼rdÃ¼n ya helal
Enes YÃ¼ngÃ¼l	between two fern deÄŸil mi bu ya
Dalyar AkoÄŸlu	onedio videosu gelsin
gurur ateÅŸ	Saglam is ğŸ˜„
Ajan Profesyonel	31
Tcma Sync	30 yaÅŸÄ±nda ÅŸiÅŸman bir insanÄ±n Efendim
seth rollins	adam incici beyelr dagÄ±lÄ±n asd ASf a DFS F
Ezio Auditore Da Firenze	nerede A K A MANYAK ÅÄ°ÅKO
ismail sevgili	Defalarca gÃ¼ldÃ¼ÄŸÃ¼m videodan bir tanesi daha
Hasan YÄ±ldÄ±z	Ä°ÅTE BÃ–YLE VÄ°DEOLARA TREND DÄ°YORUZ
Pulart	KANKA PSÄ°KOLOJÄ°MÄ° BOZDUN VE ZATEN BAYA BOZUKTU
Aureliano Buendia	5 30 2 youtuber 1 kok
Max	Babakok yakÄ±nda SoÄŸuk SavaÅŸa katÄ±lÄ±r rez alÄ±n
Valar Dohearis	4 04 hayattan soÄŸudum
omer	BU ERÄ°C ANDRE KAFASINI SEVDÄ°M AMA Ã‡OK EDÄ°T YAPMIÅSIN KARDEÅÄ°M BÄ°RAZ AZALT MUHABBETÄ° DE DÄ°NLEYEBÄ°LELÄ°M
Samet Arik	aaaa remix adam deÄŸil mi ya o
TarÄ±k Ekici	5 40 2 dirhem 1 Ã§ekirdek
oguzhan ergin	BOYNUMA DOLAKOK
Samet DeÄŸirmenci	5 39 2 girl 1 cup sanÄ±rÄ±m sesden anladÄ±m xd
Linatr Lina	YOREKOK BÄ°RAZ CÄ°DDÄ°YE ALSA SAÄLAM PARA GÃ–TÃœRECEÄÄ°NÄ° DÃœÅÃœNÃœYORUM AMA ADAM TARZINDAN Ã–DÃœN VERMÄ°YOR
Ã–mer Faruk	Your lady ha been dried
ÃœNÄ°VERSÄ°TELÄ° KAFASI	3dk gibi geldi 10 dklÄ±k video
Mert Sezer	Bana Yorekok gibi acÄ± soslu nargile aromalÄ± 4 ekonomik daba daba burger bulun Avrupa yÄ± feth ediyim Fatih Sultan MEHMET
Ã‡are Sauron	Babakok bu nedir FelÃ§ oldum D
Alptekin Ustun	bir an micheal caine gerÃ§ekten Ã¶ldÃ¼ sandÄ±m korktum
Enes	B A B A K O K L A N D I N
Zedra	Yorekok Kimdir Yorekok gelecekten gelen bir cyborg ayÄ±sÄ± Ne Ä°ÅŸe yarÄ±yor DÃ¼nyanÄ±n ne kadar boktan ve manasÄ±z olduÄŸunu anlatÄ±yor Peki hayat boktan ve manasÄ±z ise neden uyarma gereksinimi duyuyor Ã‡Ã¼nkÃ¼ bizleri seviyor
The Reptilian	CANIM KÃ–RÄ° LÄ° TAVUK KIZARTMASI Ã‡EKTÄ°
Mia X	Le bÃ¼yÃ¼k kÃ¶z harmanda face
Burak Åahin	Bu videodan sonra 31 Ã§ektim TeÅŸekkÃ¼rler yorekok
Semih Ã–zler	Heath Ledger en iyi Joker
JAGUAR GAMING [TR]	V I C T O R Y R O Y A L E
Doktor SaÄŸbÄ±rakmayan	Resmen cringelendim bu nasÄ±l iÃ§erik arkadaÅŸ
KurÅŸun Edits	Sex
Ensar Togru	Yengen HARMAN karÅŸimm
Ahmet Åergi	Abi onlar da seni bi ara post42 de aÄŸÄ±rlasÄ±nlar bence
Just in	Konsept gÃ¼zelmiÅŸ
Egekaan Genan	Bu kadar ilgi orospusu dolu olan Ã¼lkemizde tiktok videolarÄ± az bile
Rotinda Varol	Yorekok burnun Ã§ok gÃ¼zel
Argonot Ahtapotu	Yorekok batesmotelpro educatedear kamusal mizah bi tarafa olsun geri kalan bi taraf olsun
coni sins	SoÄŸuk koknation
lil xian	ilk deÄŸil
Ebubekir Boz	Bu adamlarin kafalarini yakalamanin verdigi mutlulukla hayata tutunuyorum
Efe Ulukir	meme ler cok komedy ya
Emre Zengin	harika inÅŸ devam eder
Yakup KulakoÄŸlu	AdamÄ±n yÃ¼zÃ¼ Wade Willson un mutant yÃ¼zÃ¼ne benziyor bence Ã§ok cool
BÃ¼ÅŸra Nur	Bildirim gelir gelmez videoyu izlemek ğŸ˜‚ğŸ™Œ
DarkRider 95	2009
Ã‡aÄŸdaÅŸ A	post 42ye konuk olarak gelicek rez alÄ±n
Furkan SAÄLAMKAYA	3 57 SDVCJCÄ°JCÄ°JCMCKFKDD
Gellert Grindelwald	Bir dahakine eski aburcuburlardan bahsedelim
Erdem Colak	YENGEN HARMAN OLDU KOZ GETIR
SolTÄ±k Oyun	Ulan canÄ±m popayes Ã§ekti
demo121 bomb109	ÅŸu anki tÃ¼rkiyedeki ben Lets talk about political stuff
Rhemp	5 37 MÃ¼zik sesinden ne olduÄŸunu anladÄ±m xd
Gray-Wolf	AynÄ± uygulamayÄ± kullanmamÄ±za raÄŸmen millet bu kadar sikik iÃ§erikleri nasÄ±l buluyor anlamÄ±yorum Yani ne kadar aptal iÃ§erik varsa bu tÃ¼r eleÅŸtiri kanallarÄ±ndan vaar olduklarÄ±nÄ± Ã¶ÄŸreniyorum Biri gider Ã§okomelin iÃ§ine yatar diÄŸeri Ã¶tekine boks maÃ§Ä±nda meydan okur bir baÅŸkasÄ± cinsel iÃ§erikli video baÅŸlÄ±ÄŸÄ± atar Sonra arkadaÅŸlar arasÄ±nda HacÄ± senin instagram facebook twitter var mÄ± ben de yok kullanmÄ±yorum deyince ArkadaÅŸlarÄ±m bana sigaraya hiÃ§ baÅŸlamamÄ±ÅŸ bir adama sÃ¶ylenen ÅŸu klasik sÃ¶zÃ¼ sÃ¶ylerler Ä°yi iyi hiÃ§ baÅŸlama zaten Bi sikime yaradÄ±ÄŸÄ± yok
Crowley	Eric Andre
idunelmasi 1	Ovv Between 2 Ferns havasÄ± var ama aÄŸÄ±r deÄŸil sÄ±rÄ±tmÄ±yor Ä°yiymiÅŸ nomoreyoutuber
A E G	Ã‡ok iyiydi teÅŸekkÃ¼rler
MrRobot temsili hesabÄ±	ÄardeÅŸim Yengen kurudu yengen harman oldu qARDEÅÄ°MM sERÄ° qÃ–Z Qetir hemen
Serkan	BoÄŸaÃ§Ä±n sesi Ã§ok kÃ¶tÃ¼ geliyor
emin kÃ¶pekleri	my lady ha been dried
Alfredo KalÄ±nski	5 37 2 girl 1 cup
Moth	5 39 mÃ¼ziÄŸi nerde duysam tanÄ±rÄ±m anasÄ±nÄ± siktimin 2 girl 1 cup Ä±
Teoman Toplu	Two girl one cup a dis
SÉ™mÉ™ndÉ™r SÉ™fÉ™rli	AÄŸzÄ±mla iÅŸitdiÄŸim iÃ§in hayatÄ±m eskisi gibi
ekrem badem	vay kankam kÃ¶zlÃ¼yosun gene milleti 3
Can Akusta	educatedear â™¥ï¸ yorekok
Hoshi's Bajinia	Babakok yine Ã§Ä±lgÄ±n iÃ§eriklerle geliyor Ã‡OK SEVÄ°YORUM ÅU ADAMI DJLDMFÅRÅSALÄDD
BarÄ±ÅŸ BakoÄŸlu	ne izlediÄŸim hakkÄ±nda hiÃ§bir fikrim yok ama garip ÅŸekilde hoÅŸuma gitti
Arkabi 08	Zaman ne hÄ±zlÄ± geÃ§iyor Oysaki lisedeyken educatedear in remixleri ile sÄ±nÄ±fta birimizin doÄŸum gÃ¼nÃ¼nÃ¼ kutlarken Ã§Ä±lgÄ±nca dans edip zÄ±plÄ±yorduk
R1NT	noluyo lan
Thatweirdgirlnamed 'Cerensu'	5 47 two girl one cup
TarÄ±k Yetgin	1 video 2 ÅŸiÅŸko
Gokdeniz Gl	E D U C E Y T U R
Yavuz Selim Ã‡aÄŸan	This must continue
kathy catty	Tiktoklandin
Damla AltunbaÅŸ	cidden ilerletmeden izlediÄŸim tek youtube tÃ¼rkiye kanalÄ±Ä±sÄ±n
Bayram SevinÃ§	BABAKOK
KazÄ±m Ã–mer GeleÅŸ	CanlÄ±mÄ±ydÄ± yaa
Atahan AkyÄ±ldÄ±z	Victory Royale ÅŸapkan gÃ¼zelmiÅŸ kanka nerden aldÄ±nğŸ˜‚
efe bal	yav ders Ã§alÄ±ÅŸÄ±yidim yayÄ±nÄ± kaÃ§Ä±rmÄ±ÅŸam yuv djsagnjÄ±kagj D
pcislocked	kumbara patladÄ± ananÄ± sikiyim
Raving Raven	Ä±m fabalous hello tiger chicky face
B E R K L E N D Ä° N	YOREKOK eric andre
Ğ¢Ğ°Ğ»Ñ…Ğ° Ğ¯Ğ²ÑƒĞ·	L E Ä° L K G Ã– S T E R Ä° M F A C E
lexus TÃ¼rkiye BayiliÄŸi	Yorekok CumhurbaÅŸkanÄ± olsanaaaa olsannaaaa olsanaaa
cool man	The one stop This email ha to do so by turning up It ha an amazing day and the Three main thing I want you are a bit It ha been a long term and a bit of a problem I think the best I think the best of all the time two week go for it to the Crown of a new job and a few minute The list it is not a member fellow or a person who is not a member fellow This is a bit of fun I think it is a great deal ÅŸaka la ÅŸaka tÃ¼rkÃ¼m ben
DAÄLAR AÃ‡IK	sa
tugrul	YENGE
Sabri Varal	ooo eric andre show esinlenmeleri hoÅŸ
Galerici AydÄ±n	ÅiÅŸman adam baturaya benziyor
Mustafa DurmuÅŸ	renk kÃ¶rÃ¼ oldum galiba lanet olsun
â€” Êá´œá´ŠÉªÉ´.	when gÃ¶rmek nargile ben triggered
Dogukan Ozlu	KFC den dÃ¶rt menÃ¼ sÃ¶yledim MUKBANG educatedmouth
Metehan	Ortak arkadaÅŸÄ±mÄ±z olan garip biri ile masada baÅŸ baÅŸa kalÄ±nca ben de educatedear gibi oluyorum
HÃ¼seyin BÃ¼lbÃ¼l	3
Bir Ä°nsan	SansÃ¼rlenen video hangi video
Didem YazÄ±	Selam ece seni seviyorumbdjjd â™¡
Bedirhan YaÄŸmur	Between Two Ferns with Zach Galifianakis TÃ¼rkiye ÅŸubesi
Naz.X	NapÄ±yonuz mk
Mavi Kedi	Heichdeck SOKUÅTURAMADIKLARIMIZDANMISINIZ
Enes KarakuÅŸ	Muck
Grand Crew	Kok OLD
krak trak	H A R M A N L A N D I N
GUNpo364	52 yorum
Yusuf Berke	YENGEN KURUDU KÃ–Z GETÄ°R
DermooN	Ä°lber OrtaylÄ± ve Celal ÅengÃ¶r gibisiniz Xd
Lyla Rio	GÃ¼ldÃ¼m
enes tahtallÄ±	Sa
Åamil DuymaÃ§	K F C L E N D Ä° N
cumhuriyet kÄ±zÄ±	Babakok nerdesin yaw gÃ¶zÃ¼mÃ¼z yollarda kaldÄ±
t MAC	Le menÃ§istÄ±r aksanÄ±yla konuÅŸan boÄŸaÃ§ beyin cringe faysi
Wejaduke	between to fern esintileriÄŸ
Mamishere	Xdd
Muhammed Ä°kra AydoÄŸan	YENGEN KURUDU KARDEÅÄ°M KÃ–Z GETÄ°RRRRRRRRRRRRRRRRRRRRRRRRRR
TheChoosenOne FURKAN DURAN	Sa
Lost Frequencies	CanlÄ± chatten sa
Efe Uyma	KOLA CÄ°PS ALIP GELCEM BABA
Taragay	KALKTI
Teymur Mammadov	Babakok gÃ¼m gÃ¼m
RÄ±dvan Ä°skender	Bu ne olumm
Ã‡aÄŸan Taha GÃ¼ltekin	Chatten yazmayin artik
Sea Nabiyon	Tam da 31 Ã§ekip gelmistim tesadÃ¼fe bak
Gamer	thinken about kÃ¶ri n stuff
Emre _3775	en sevdiÄŸim adamlar be artÄ±k rahat Ã¶lebilirim
GÃ¼lay Terlemez	Babakok sinirli
Mustafa PerinÃ§ek	SokuÅŸturamadÄ±klarÄ±mÄ±zdanmÄ±sÄ±nÄ±z
Ä°simsiz Ã‡ekirge	Sa
waffentrager	karÅŸÄ±m da iki kelime edebilecekmisin yorekÃ¶kkkkkkkkk
hamdi avni	Aman tanrÄ±m dedim GÃ¼neÅŸ dÃ¼nya ve ayÄ±n aynÄ± hizaya gelmesi gibi bir ÅŸey
Mutant Patates	Hocam Bir Yerimizi AlalÄ±m
Yusuf Demir	Rez alalÄ±m deÄŸerlencek buralar
Task Force GH0ST	Sa
Palzivan	Babakok sinirlendi babakok kÄ±zdÄ± ve ÅŸuan iÃ§imizden geÃ§meyi planlÄ±yor
Ahmet Taha	The Babakok
Edwards JR	Hele ÅŸÃ¼kÃ¼r bee
yarrak the Ã§omar bÃ¼kÃ¼cÃ¼	Babakok sÃ¼tÃ¼n Ã§ok acÄ±
Enver Ã–ztel	LA 2 SEVDÄ°ÄÄ°M ADAM YAN YANA TEZ ZAMAN Ã–PÃœÅÃœRLER UMARIM yazarken aklÄ±ma bÃ¶yle bir gÃ¶rÃ¼ntÃ¼ geldi ve kusmaya gidiyorum
Zeynep Nur Ã‡ELTÄ°KÃ‡Ä°	Bekliyorum yorekok u
atmaca a	NOLUYOR BABALARA GELDÄ°K BABABABABABABABA
Hasan Emir Erdem	SoÄŸuKOK savaÅŸ
Furky	Bu ne babakok
KEVÄ°N DURANT	Bekleyenler ÅŸimdi gidin Saat 5 de gelirsiniz ğŸ˜
YENÄ° OYUN! !!!	31 kisi bekliyor
Ã–mer ErÅŸuva Saeyaro Lasctar	Wow yayÄ±n demek
MevlÃ¼t Yakar	HESABIN ÅÄ°FRESÄ°NÄ° UNUTAN AMDÄ°N ONLAYN
Etorameth	SA MORUQQQ
