Lee Oskar	meu pc trava ta todo fudido ma eu compro fifa point kkkkkkkkkkkkkkkkkkkkkk
Henrique Dal Alba	Aldolfz joga no Xbox ou PC
FÃ©lix Oliveira	MÃºsica do minuto 10 33
Eduardo Nunes	CampeÃ£o Brasileiro 2018 Vamo coloradooooooo
Douglas Fabian	AÃ­ Adolfo tirei o Maradona e o SÃ©rgio Ramos no mesmo pack com 14 vitÃ³rias na wql kkkkkk
janderkson mamedio	Kkkkkkkkkk
Dame Lillard	â€œ Seria o inÃ­cio de uma nova histÃ³ria â€ KKKKKK pirdi
Soccer Skills And Goals	Adolclipes
Linha 11 Football	Esse Adolfo Ã© sensacional vocÃª Ã© top cara
Davi Nunes	13 24 eis que adolfo gosta de negÃµes
Stealth Gamer	4 15 auauauuaauauuahaushauahs
Insane Design	me nerfa EA
Jorge Nascimento	O melhor YouTube namoral cara Adolfo vc e mito
IrmÃ£os Nescau	PAU NO CU DO CHRIS WOW
Maycon Silva 19	Qual o nome da mÃºsica 8 18
Mano Fransu Oficial	0000000 Kkkkkk ğŸ˜‚ğŸ˜‚ğŸ‘ŠğŸ»ğŸ‘ŠğŸ»
Lucas Garcia	Qual Ã© a mÃºsica de 04 15 rola sempre no pack eu sempre pergunto ma nunca me respondem
Ruan Kilmister	000000000000001
Caio Thug	monstro gigante maravilhoso Sei nÃ£o Hen
Humberto Oliveira	Adolfera tu caiu em todos o bait possÃ­veis tava dando pena mano kkkkkkkkkkka
MÃ¡rio Scarpari	Po cara tu Ã© foda hahaha muito engraÃ§ado Fiquei ouro 3 na squad sem tempo pra jogar Tirei Navas 87 e Vela 84 IF pela segunda vez kkk aÃ­ fiz un dme de paÃ­ses e ligas hÃ­bridos ganhei isco 89 tÃ´ feliz demais cara abraÃ§o
Thales Rufino	Kkkk Adolfo qual Ã© a probabilidade de tirar um De Gea e um Mahrez no pack de 12 500 Fiquei prata 3 no squad pq estava sem tempo de jogar abri a recompensas pelo telefone e tirei o de Gea e o Mahrez kkkkk
Canal Sem Nome	Mano cadÃª o RTD1
Jalmir Marques Morais Morais	TÃ¡ igualzin a eu tÃ¡ sÃ³ tirando carniÃ§a ğŸ˜‚ ğŸ˜‚ ğŸ˜‚ SÃªÃ©loko cachoeira ğŸ˜‚ ğŸ˜‚
JoHn Tv	DescriÃ§Ãµes da cabeÃ§a de baixo 13 18
Mauro Cesar	zaro
Emanoel Brasil	0 47 quando meu professor comeÃ§a a falar minhas notas
Davies Videos Sound clips comedy	Esse Pack deu fome lasagna kkk
_ Jhonatan	VAMO VELHO
Jonnathan O.F.	Adolfera quando vamos no ver no gigante do Beira Rio pae AbraÃ§o cuzao
Williamm Fernandess	Quem viu a live de ontem com a Amanda dÃ¡ like
JoÃ£o Gelado	Zero zero zero zero zero zero
Gustavo Souza	Santi Carzola vem em toda
Spike Gaming	Vai rolar RTD1 nesse fifa19
Valter Oliveira	SÃ³ sou teu inscrito pq tua mina Ã© gata
Mateus Henrique	AdolfÃ£o volta a jogar Rocket league desde que vocÃª jogou mudou muito se quiser jogar comigo bora n sou muito bom sou Melo manos melhor do que vc era KKKKKKKKKKK meu perfil na steam Ã© M4T3U5 ou pesquisa mateuselo meu Nick da conta
Arthur Fonseca Prado	Quando sai o vÃ­deo que a Amanda tira o SÃ©rgio Ramos
pedro br gamer	Adolfo acho que amanhÃ£ o Santos ganha
Davi Vidal	Prefiro a amanda tirou o sergio ramos 91 kkkkkk
Matheus Dos Santos	ADOLFEEEFA Ã‰ O NOME DEEELE
Hugo Moura	01 27 tomei um susto da porra com o tele transporte do Goku kskskssk
Samuel gameplays	Boa adolfera
ALBERTO GAMES	SÃ³ faltou o Xandeus nesse Pack Opening
Dudu ChorÃ£o	so mais um
Leonardo Silva	b aaaah
Toque de  Letra	melhor pack opening rindo pra kct kkkkkkk
Natanael Maciel	Pack Ã© roubo na cara dura sÃ³ vem merda
GabrielMaq10â„¢	0000000000000000000 1
L'Jota	Faz un 2 ano q n vejo o adolfao e mano PQPPPPPP O Adolfao parece o Kiko viado
TheKing _24	Adolf pq vc b grava a sÃ©rie do Alex Hunter
Luiz Gamer 1234	13 10 De nada
InvalidGamer	Que sequencia foda Adolfera continuum assim broo
Harrison Borges	monta um time da serie A ta cheio de carta foda de la
Vieira	13 46 MAMO KOULIBALY
coringa thuglife	4 pack seguidos d 7 500 todos deliciosos Fera Adolfo
cÃ³e rapreize	VIDEO COM A AMANDAAAAA
Zoones	Deveria ter encoxado o colchÃ£o enquanto toca winx
Helter MÃ¼ller	Vim do futuro pra dizer que o adolfera nÃ£o caiu no Bait do SÃ©rgio Ramos
Matheus Bertuso Pela	Cabei de tirar o isco 89 no pack do drafy
kalel	ImpressÃ£o minha ou este vÃ­deo jÃ¡ foi postado ante
Leandro Rondelo	Mano falei vou abrir esse merda pacote vei veio o Suarez 91
Rafael	Ronaldo estÃ¡ proximo
Vitor	Quer bait maior do q aparecer Espanhol Zagueiro Real Madrid e vir o FILHO DA PUTA DO NACHO FERNANDEZ kkkkkkkk cai 2 vezes seguida nesssa porra
The Sr.PreguiÃ§oso	esse cara Ã© mt engraÃ§ado qpqpa skdkadkakdakdkapsd
Lusca	vai ter rumo a primeira
Pedro Henrique	ğŸ’ªğŸ’ª
Eduardo d	Adolfo sei gostoso me da um coraÃ§Ã£o pfv
Cristiano Pallaoro	Hauahuahau melhor vÃ­deo pqp
luis fernando	Adolfera vai ter live hoje
AD0LFzZ	Salve lindos Live do DomingÃ£o do AdolfÃ£o vai ser foda hj fiquem ligados q no mÃ¡ximo a 20 00 de BrasÃ­lia estaremos ao vivo
victor hugo carlos moreira	Q horas costuma ter life
Seu Madruga	MITOLFO
Vitor Dalprat Silva	isso faz tempo nÃ©
Mr. Gordo Plays	Eita
A praga Pione Sisto	Quem viu ao vivo o pack JÃ¡ faz tempo pra krl
joice dornelles	Eu nao consegui ver ah live ontem ğŸ˜­
Lucca GrenÃ¡	Tira essa barba adolfera que vc vai tirar o ronaldinho
Dener Bremm	Kkkkkkk o duke ta se superando na ediÃ§Ã£o ta mto top
Renan Santana	99 de piroca
douglas costa	Cara teus vÃ­deos sÃ£o sensacionais
Nial Horan	adolfz para de postar video velho quem apoia deixa o like
Neutr0	Que horas sÃ£o a life adolfz
Leonardo De Carvalho	manda salveeee
Pedro Neves	Kkkkkkkkkkk pack meditaÃ§Ã£o
DiegociÄ‡ Costa	Adolgrosso
Gean Lima	Vamo velho ğŸ¤™ğŸ»ğŸ˜¤ğŸ¤™ğŸ»
Quando vc estiver lendo comentÃ¡rios eu vou estar lÃ¡	A EA acabou com a venda de coin
Viinny Fressati	Um do primeiros amo es vÃ­deo Tmj
vicente santos	Quem esta vendo domingo da like
Eduardo Mendes	vai ter live hj
Ruan Muck	Adolfera nÃ£o consigo assistir a life pela mixer Pq nÃ£o coloca a life aqui no youtube tbm Ficaria melhor pra muita gente
Nealz xd	Passando pra avisar que o Palmeiras nÃ£o tem mundial
Filiphy Biladeiro	ABRI PACKS SEM CAMISA QUE VEM SÃ“ 86
SD Monteiro Araujo	Packzinhos da oja
KÃ†FFI	ADOLFERAAAAA
MrGui	Salve
Quando O Ziggs Ulta Seu FPS Cai?	Kidelicia de vÃ­deo
Leoni Tanatos	43 visualizaÃ§Ãµes e 75 like YouBug e seus extensos problemas
Kill Hero	Likolfooo
Renan Bergmann	Qm viu o 90 na live de ontem da like
Paulo Ricardo	Manda salve
Diego Orcesi Da Costa	AdolfÃ£o tu Ã© foda continuum assim por favor nÃ£o diminui o ritmo de vÃ­deos Te amo â¤ï¸
Washington Paulo	Vi terminar a WL Tenta abrir a Live mais cedo se possÃ­vel ğŸ˜™
Japali pali	Eu acabei de terminar de ver o especial de 400 k do adolfz e bem quanto termina aparece notificado do Adolfao kkk
Eduardo Magno Da Costa	Mitoooo
Pablo Souza	Adolfera Ã© o nome dele
Gamer Sincero	Mito MELHOR CANAL DE FIFA BR ğŸ‡§ğŸ‡· â¤ï¸
diogo ulisses barboza de oliveira	salve
HUNTER	FIRST
Pedro Pancotte	Iae
Mateus s rego	Primeiro
NOVA ERA GAMES	frist
Gustavo Almeida	First
GRstrik3	first
