Angelo Alexandre	I see a lot of the comment never seen a Vlad interview or Kno who Vlad is lol ğŸ˜‚ğŸ˜‚ğŸ˜‚ I m dying at these comment
Neeka Taki	Akdjkddnd the amount of shade being thrown at the reporter lowkey make me feel sorry for him but then I remember what he said in the interview and join in throwing shade
salma nazwa	THIS INTERVIEW IS SUCKS
SELO oo	6 10
Nabina Gurung	Awkward interview like seriously ğŸ˜‘ what kinda question is that ğŸ˜¤ğŸ˜’
Wynn J	unfortunately this wa 1 disrespectful 2 did you even do any proper background research
donnydanko	this is so awkward yikes
Elise Ting	geez i dont know if id wan na give this video a thumb up to show love for kris or a thumb down for the interviewer
Jackson Brown	I love Chinese movie Names a Hong Kong movie Honest mistake I guess
H	Stfu cunt insensitive prick Just cause you get to interview a celeb doesn â€™ t mean you juice the fuck out of it
Fannie Wu	damn i hate u ğŸ’©ğŸ’©ğŸ’©
Doyoung/cute Bunny	Kris went from â€œ Chicken is not my style â€ to this SO PROUD OF HIM ğŸ’—ğŸ’—ğŸ’—
Angel Angel	This wa so uncomfortable to watch like why is he emphasizing so much on his dad
Lina El Biar	Wow Just wow I m feeling so embarrassed for this interview It wa so tact le and unprofessional My baby Kris ğŸ˜­ğŸ˜­ğŸ˜­ğŸ˜­ğŸ˜­ğŸ˜­ğŸ˜­ğŸ˜­ğŸ˜­â¤ï¸â¤ï¸â¤ï¸â¤ï¸â¤ï¸â¤ï¸â¤ï¸â¤ï¸â¤ï¸
é•¿é•¿åŸ	Fuck you china china people disgustingğŸ˜›
ann	what kind of an interview is this who asks about the other parent if they arent mentioned this is so rude
fernweh0wanderlust	Na just too busy lmaaaoooo
German Army	Y all be mad about the interviewer but did anyone actually think about that he maybe didn t write the question Like he is probably just doing his job Â¿ But i agree that he could be like more Kind or le disrespectful lol
Jasmin B	Can â€™ t he see that Kris is uncomfortable about his father being the topic Like seriously Is he insensitive or what ğŸ™„
Bianca Nava	One thing that I really loved in this interview is that kris corrected the interviewer saying that there wa 12 member in EXO ğŸ˜­â¤ï¸
æ–‡æºªæºª	å¿ƒç–¼å‡¡å‡¡ ç¬‘ç€å›ç­”ä¸»æŒäººä»–æœ€ä¸æ„¿æåŠçš„äº‹
midgetBBY	Ok people These are question that alot of crazy fan wanted to know so he asked them because if kris doe not be up front with these question some crazy as fan is going to find out like how they stalked him and found his momma his friend and ect
jjsunqs	the interviewer wa so fucked up like i get asking him about his parent but don â€™ t fucking push the topic when he â€™ s clearly uncomfortable
3C10  LIM MING HOI æ—æ˜æ„·	kris wu is so handsome
Mary Pie	kris wu looked so awks and uncomfortable those are personal question you shouldn t ask this wa so dumb poor boy
Carina Luvz	It â€™ s such a personal question prop to kris I wouldn â€™ t be able to answer It since I my dad wasn â€™ t around either I find it so disrespectful that he wa asking so many question that were personal But that â€™ s just me ğŸ¤·ğŸ»â€â™€ï¸
Lulu Yan	these question are so wired
Harlow	SUPPORT TALENT SUPPORT KRIS STREAM ANTARES
Jongin's Black Hair	I m so mad the interviewer keep asking him about his dad again and again He already say that they never meet What kind of stupid question He keep asking about Kris s dad Can t you see Kris s face Can t you see his eye although he wa wearing shade Omg he looked so sad I feel I want to cry but at same time I wa so mad at the interviewer
kumaminyoongi //	LeAvE bAbY KriS aLoNe ALSO BITCH NOT ALL OF US ASIANS ARE SHORT
Hannah Lee	this interviewer is so insensitive wtf i ve never felt so uncomfortable watching an interview before he sound more like a therapist than an interviewer asjdksf did he really feel the need to ask sm personal question he ha no respect or common sense
Evelyn Santos	okay
Jannat Day	These are horrible and inconsiderate question how disappointing no one should have to go through such a terrible interview
Amanda J	This whole interview is so ridiculous Kris look so freaking uncomfortable The pushing with question about his dad is so unprofessional learn some boundary And then he make that stereotypical comment about his height being â€œ tall for an Asian kid â€ Come on dude show some respect
mrspoynter2005	this interviewer though shouldn t this interview be about him a an artist these question sound like he is on Dr Phil or something
Brinnie	He feel uncomfortable when the interview asked him about his dad I feel bad for Kris
ichliebeBill4leben94	lol yo wtf question ğŸ˜‚ what you tryna get a success story our of him Asian kid with dad make it big lol come on dude anyway kris we need a new hair stylist
anone anon	I m normally quite forgiving but dayummmm this interviewer is asking some dumbass question he could ve researched first beforehand
valeria yvonne	this is such a horrible interview im so sorry for kris he deserves better
fangirl is life	THE INTERVIEWER IS FUCKING DISRESPECTFUL ğŸ—¿ğŸ—¿ğŸ—¿ğŸ—¿ğŸ—¿ğŸ—¿
Ba dum Tiss	This Interviewer Is A Cunt Bruh
Erika	Why the fuck this interview wa 40 abt his dad kshdjshdks that s not very comfy to talk about srlsy
Princess	African parent too Doctor lawyer engineer nurse Yeah typical
Kw 720	Every Asian parent be a doctor or a lawyer
sunaìˆ˜ë‚˜	fuck that interviewer man
T Jasmin	Kris ha a big heart He handled the question professionally and that alone say a lot â™¡
RERE MEZZ	Wtf stupid question here duh
Mark Tuan	This whole interview is a mess this interview is fukcing rude kris is trying to cut the answer short why the fuck you pushing bro
emina twopm	brb lem me go slap the interviewer
Ivy Lo	Wtf is wrong with this interviewer
jun	holy fuck dude stop asking about his dad
Jennifer Choi	what the fuck is with your dad question
Maya Muringani	Dang u really asking about his dad like that
Desiree Nieves-Pi	Love you kris wu ğŸ’˜
Purple Galaxy 0613	Why doe this interviewer want to know so much abt his dad Kris handled the situation so well I kept cringing
Exoseveteen Bangtan	Damn his dad is gon na be hella regretful once he find out who his child is today
Shichhya Jugjali	The interviewer is unbelievably disrespectful The shitty question about his dad you could see how uncomfortable he wa
shineeshawol1998	This is the shittiest interviewer in the world This asshole ha no respect for kris feeling Just want the juicy info What a douche
BtsVbae Exo.D.Ooppa	Cringe
JYUNA 's	why the hell you want to make someone so uncomfortable by asking him a question like that
Alexandra Chavarin	Almost 3 minute regarding somebody doe t deserve the time or energy from Kris anyways I believe Dj Vlad could ask more about something else or show more interest in something else anyways Congrats Kris keep doing what your doing
EXO- L	Why is he asking a question about EXO Cause Kris is not in EXO anymore Kris and SM had very bad feeling each other so he went back to China
Sofi sofiyyah	What an incredibly unprofessional interview To continue asking him question about his father when he â€™ s expressed his discomfort physically and egging him on for a reaction is SO messed up Have you thought about your audience Do you seriously think new fan or existing fan of Kris would want to see him unearthing trauma brought on by your highly unprofessional invasive poorly written and poorly researched question Congratulations on making the WORST out of an opportunity to interview such an important figure of the Chinese music community Instead of focusing on milestone like Kris â€™ album his bridging of the East and West through music and even his acting career you chose to focus on the uncomfortable question that clearly have no connection to his artistry An awful travesty Congratulations on exploiting the kindness and respectfulness of Kris while exhibiting absolutely no tact Kris may not have said anything to your face but I assure you your unprofessionalism will warrant future celebs not being a kind to you Your lack of self awareness and emotional intelligence is pitiful
Athow besuto	6 22 at that time EXO still so big all over the world
Cartoon Character	Kris you took this interview well Fuck the dad question You dealt like a bos SWAG
Aqsa Akbar	God that smile Kris
chanyeol wife t	i understand his life cuz i leav it right now and it s painful ğŸ˜©
á„‹á„Œá„‹call me baby girl	You can see how uncomfortable fanfan is
Thanima Rajan	this is so awkward I hate such interviewer
peach	thats pretty tall for an asian kid wait what I ve met so many Asians who are tall it s mostly the girl who are shorter but the boy touch the roof with their head o Asian boy are so tall most of them it s the girl who are short lol
LETICIALIXO OMG	KING OF CHINA OMG BEAUTIFUL PERCET VOICE PERFECT EVERYTHING LOVE U AAAAAAAAAAA
I Do MinKyoongi	Kris sweetie I m sO soRry I m so sorry tHaT a uglY as bitch lIkE this wOulD even SaY that oH MY GAwD
KayLyda	SOOOO many question about his dad I thought Kris seemed excited at the start then when those dad question kept rolling his mood wa like meh And I just wished he could move past those question Very awkward
Htut Soul	Fack you Not only Asian go through divorce The European kid go through this too What is so hard about this There is clearly a question you shouldn t be digging around with Facker ğŸ–•
21Blackjack	Poor kris I wan na hug him for being strong enough to cope with such a dick of an interviewer I know what it â€™ s like to grow up without a dad so I understand how difficult it is to talk about that kinda thing
Van Ok	STUPID interviewer
mochi milk	This interviewer is so fucking disrespectful
DIVANI SHAFA	You are the worst dude it s his own privacy i mean like you don t have to ask some question like that
Qiuxian Lin	I like kris wu he is so cuteğŸ˜˜
blossom m	I hate you interviewer you re so stupid how did you even get this job
siti faizal	what the f ck What question do you ask kris man Please have some respect of him It wa too many personal question Wu Yi Fan Kris still relax and keep smile But I m almost cry here in the same time I m very angry with the man Btw fighting with your career kris Exo L always support and miss you ğŸ˜˜ğŸ˜˜ğŸ˜˜
Gabriel Asaf	What stupid and invasive kind of question are these What the hell
Only Love	Since lay debuted in ny will they run to each other often or rarely ğŸ˜¨
CHO BY SUNSHINE	Seriously Talking about his dad you are so RUDE I don â€™ t care that can keep everyone watch this clip but this is his private story You should respect to him and his family
y not	ugh im genuinely happy that kris is happy but damn i miss ot12 not to mention krisho
Jamaica Plaza	I LOVE YOU KRISEEEUUUUUUUUUUU
sna z	What s wrong with the interviewer Keep asking about his dad
Kobe Savage85	Should â€™ ve just found his dad and interviewed him
winter cat	This is one of the worst interview I ve ever seen So glad Kris wa a professional through out the whole interview
Xiao Aeri	Man I can relate with kris haha if it me I would react like how kris did but deep down it hurtsğŸ˜… and btw his laugh at 6 03 I could repeat that all day longğŸ˜
Eat Shiit	He look amazing
Aryana Wright	Damn so much question about his dad why he so nosy for
Polly Molly	This interview wa awkward and uncomfortable So much hate for this insensitive interviewer uggh ğŸ™„
mm æ	He is greatï¼
flowerzxo	wth is this ohmygod my baby ğŸ˜­ğŸ˜­ğŸ˜­ğŸ˜­
NQ Zulaikha	I love you bruh but i hate that hairstyle
Dope Lee	never imaged Kris Wu could be interviewed since this channel is all about Hip Hop you see wut I mean
sweet x lush	clearly it â€™ s not just me who think this but the interviewer seems very disrespectful maybe kris agreed to talk about these topic but it seems by the expression on his face that he wa getting really uncomfortable
yang hang	This is just deadass not a very good interviewer
Angela Geeba	Mad respect for you Kris â¤ï¸
Ya Yeet	Why is the interviewer so rude he wa asking personal deep question
BtsOnCrack	why tf is the disrespectful interviewer asking my baby such horrible question about his father
fantaestic taenologist .	Too many dad question
Pewdiepie's Hot Dog Boss	The interviewer is particularly interested in Kris s dad
Sario Galupo	Yeah yeah yeah yeah yeah
African ARMY	As an interviewer you re supposed to make the guest comfortable enough to want to open up to you You re supposed to listen to the guest You set the mood and make sure the whole conversation flow This interview is not it It s really awkward he keep pushing certain question that he clearly didn t want to answer or had already answered in a way Just ugh But Kris did really well and he wa open with his answer You go boy
A 88	It would â€™ ve been nice for the interviewer to actually do research on Kpop if he â€™ s going to ask question about it â€œ so you make it into this group but you â€™ re not Korean â€ nooo way really He â€™ s not Korean â€œ You learned how to speak Korean â€ no shit nah he spoke Chinese and English in a country that speaks Korean in a group that performs and speaks purely in Korean â€œ In the boy group were you singing â€ ğŸ¤¦ğŸ½â€â™€ï¸ğŸ¤¦ğŸ½â€â™€ï¸ Also the interviewer just sound plain patronising He could be a great guy for all I know but 1 He â€™ s not even in the shot which just make him seem more condescending 2 He talk about himself way too much and stuff like how he just interviewed Jay Park and they â€™ re so â€œ similar â€ 3 He asks way too much about his dad like why would we need to know so much detail this isn â€™ t a therapy session 4 Instead of just asking question he pose them a â€œ so when you were you did â€ like he â€™ s some job interviewer reading a resume 5 It felt like he kept waiting for Kris to say stuff rather than him leading the conversation so Kris is just left there smiling awkwardly I don â€™ t know Kris Wu well but I can â€™ t believe he just sat there and continued the interview Must be a pretty chilled guy to deal with that
Hopetobe Angel	Love him so much For the interviewer don t ask like that just respect him
Giuls CG	STOP WITH THE DAD QUESTIONS MAN HE DIDNT SEEM COMFORTABLE AT ALL ARE YOU DUMB YOU SOUNDED LIKE YOU DIDNT CARE THE WHOLE INTERVIEW YOU WERE LIKE â€œ OKAY NEXT QUESTION â€ WHAT THE HECK MAN STOP
Doremia	literally the weirdest and unprofessional interview please the slight racism and sterotypes being thrown and the false oh hey we re both immigrant so we must relate spiel
naya papaya	what the fuck why doe the interviewer keep pushing these personal question about his dad
sigh ferreira	no offense but this interviewer wa terrible suuuuper awkward boring pushy and it felt like he didn â€™ t do any research on kris at all yikes
OSH Exo	I hate this interview
jimin excuse me	I honestly don â€™ t like this interview because the interviewer keep on asking very personal question about his life especially in the beginning
Lupe Hernanadez	TERRIBLE INTERVIEWER he kept pushing Kris to answer personal question like boi
criesyoongii	I â€™ m pretty pissed off about how freely the interviewer threw out the fact that his dad wasn â€™ t in his life and wa pushing Yifan to talk about it What â€™ s with the stereotype about Asian height too though I â€™ m gon na punch this guy in the face
æ—å˜‰æ–‡	è¶…çº§å¸…
Jb Dontpanic	the interviewer sorry you had to deal with this kris
Karina Valverde	take a shot every time he say yeah
mikeyjaynes92	This wa wayyy too short and I agree he shoukd have taken the hint to kove off from the dad question I ve seen his video and interview before but never ha he gone on like this to someone he is not close with at all
Hope McGregor	agh I feel like the interviewer wa too pushey NO ONE ever asked me THAT many question about my family and personal life
glazec4	Kris wa a good sport but y all got ta get a new interviewer he didn t do good at all
Shafikah Irwan	There wa a sad face on the happy face
Soft ChimChim	He is so uncomfortable ğŸ˜£ Kris you didn â€™ t have to force yourself to answer them ğŸ™
PROPERTY OF RAPMONSTER RAPMONSTER	The interviewer is awful
wu bucky	stupid interviewer for sho
Elyse G.ì—˜ë¦¬ìŠ¤ ì§€	wtfff this interviewer is wack so disrespectful give kris a break jesus
krisssssten	This interviewer did the same thing to Jay Park on the topic of 2pm like okay ask the first few question but after that you can already get the vibe a an interviewer that they dont want to talk about it and are uncomfortable ğŸ¤¦ğŸ»â€â™‚ï¸
Exo My Aesthetic	I m watching this for Kris but this channel seems pretty disrespectful and pushy like other commentors have mentioned They shouldn t have made him talk about his father and ask all those stupid question
Paul Chan	What TF question What s wrong with u people SXXX show
GoodLuckNabs	Please take a look at my reaction to Kris November Rain 3 http www youtube com watch v wMSx6pvkuo4 feature youtu be
MaloneBeauty	What the actual fuck is wrong with this interviewer Ask him about his accomplishment and his music and what he like and he want to do good thing the interviewer is hiding his face
_ mixhuu _	WTF IS WRONG WITH THE DUDE IN THE BACK ASKING THESE DISRESPECTFUL ASS QUESTIONS
maemae bahad	I don t like this interview It wa too personal Kri s kept smilling but damnnn this interview is awful
í—¤ë‚˜	There is part 2 I hope u had better question to ask
Curry Zhong	0 55 Is he saying yes in chinese in the interview lmaooo
Kerry Castaneda	I think it wa really personal when he asked if he would try to contact his dad Not everyone is interested especially if his mom divorced him then that must â€™ ve been a reason
HaloRainne	Its an INTERVIEW not a THERAPY SESSION Pressing him about such issue is so disrespectful and invasive And then when you mentioned Jay you could have asked Kris if maybe he liked or know Jay If they might want to collaborate or something But instead you compared their career pattern wtf Don t get me wrong yall I love Jay Park but like why Jay Park and Kris Wu are not the same omg this whole interview is a cringe fest I feel bad for Kris you could feel the discomfort and awkwardness through the monitor
vaishnavi barthwal	This interviewed did my Kris dirty ğŸ˜‘ but Kris being the humble one that he is answered him calmly but I could see the hesitation in this eye
Amalia Hernandez	Kris wu being interviewed by the dumbest man alive
Tuna PCY	Okay This is not a freaking interrogation
sokerisade	Everyone in the comment selection is complaining about the interview because â€ the interviewer made him uncomfortable by pushing him to talk about his father â€ Look this come from someone who grew up without a father too someone who ha only once met him and wa too young to remember it someone who only know the name and hometown of their father simply talking about his father doesn â€™ t make Kris uncomfortable it â€™ s that he really doesn â€™ t have an answer He want to give the interviewer a proper answer that answer to the question who where when and why But he doesn â€™ t know all the answer Why Because he doesn â€™ t know his father Talking about him doesn â€™ t make Kris sad or angry It doesn â€™ t cause any emotion And the interviewer only asking so many question because the topic is interesting due the fact that in most case even if someone â€™ s parent break up they still keep seeing both of them for example at holiday or being a week with one parent and another week with another parent And don â€™ t lie and say that you haven â€™ t ever been even the tiniest bit interested into Kris â€™ family dynamic
moon gloss	Somebody please fire this interviewer
Tenzin Jurmey Dasel	I don t like how Kris is Smiling it off Its so intrusive and I feel so uncomfortable that Kris is comfortable
mi chiamo thiago	I subed to this channel cause I like hip hop but this interviewer is worse than garbage I may unsub
Sawyer Averys	he ha a bit of a mixed English accent it s like a mixure of an Aussie accent with a hint of a Chinese accent but for the most part sound American
thaBAMs fix	As a woman of color I never ever would have thought Kris wa into HIPHOP and basket ball Like if I saw him in high school I would just thought he would never like me because he probably think i m to ghetto because i m black BUT BOY IF I HAD KNOWN HE WAS bout it bout it I would have been like heeeeeeyyy mr wu
BTS owns my heart	1 00 min this Moment broke my heart
Alison Lim	Worst interview ever
snoopiboi	i liked how he kept cheesin when the interviewer keept asking about his dad bro if the interviewer did that to me i would have thrown the chair at him
BTS & EXO are both kings	Kris is so chill HOW I would â€™ ve flipped that interviewer is terrible
fangurl asdfghjkl	GALAXY HYUUUUUNG
pitutupi	This interviewer wa so insensitive about kris dad I also never met my dad and i got these question so often in my life It â€˜ s like people don â€˜ t get that it â€˜ s a sensitive topic and that growing up without a dad can cause you to go through so much shit in your life and they just keep asking personal question in a very insensitive way like whyyyy
Gabriela Macedo	Wtf is wrong with this interviewer Kris wa so uncomfortable this is not the kind of question you keep insisting on ugh
cher G	1 41 yEa
shane	Why doe it make me actually angry they keep trying to pry into his life about his dad He said he had no contact leave it at that The dude kept asking the same shit
HarperPolo	I m more interested in his time with Exo and his career afterwards then about his damn father ğŸ™„
Naa Zuhry	WTH interviewer kept asking about his dad when his clearly said HE DONT KNOW WHAT HAPPEN TO HIS DAD
aza s	Some russian guy make kris uncomfortable for 9 50 minute straight
ChanYoda.	khe
lesia	VLAD TV are garbage people
Jackie	the interviewer is such an asshole kris looked like he didn â€™ t want to talk about his dad but the guy kept pushing him to talk about it for 3 minute
Pink Bubble tea	I really hated this interview kris look so uncomfortable the entire time
winwin's lines	tbh interviewer wa rly pushy kris seemed uncomfortable and he wa v awkward the interviewer wa asking WAY too many personal question
Elena Song	I am amazed at how easy going Kris is He s so big in China and very popular in North America a well He handled the interviewer s disrespectful question and comment while smiling I wouldn t be able to do that honestly
CHANNEL ViE å…ˆé”‹æ—¶å°š	Guys you heard clearly this interviewer is Rrrrussian No wonder I pay my respect to Kris at this point
Savannah's STARS	the questiond weren t that disrespectful Y all are overreating and pretending to be woke
Morayo Adedapo	so you can tell he doesnt really wan na talk about his exo experience i know the chinese member don t have good memory with SM but i still hope the memory they shared with the member are keeping them friend
golden closet	Aww he â€™ s so awkward
Karina Sturm	For their â€ boy band â€œ
Bunny Friends	This is very awkward interview in the beginning asking about his dad
lau kwokchun	This interviewer suck at interviewing What the fuck is he doing
hafsa tahir	Lol kris dissing exo that it wa big that time ğŸ˜‚ğŸ˜‚ğŸ˜‚ğŸ˜‚ğŸ˜‚
Brooklyn	doe the interviewer think all asian are small and short stereotypical smh
krystalx	wts why are they asking such sensitive question about his dad this is not a counselling session lol but Kris handled the question very professionally proud of u galaxy
Miss Capricorn	Kris DOESN T want to talk about his dad then why da fuq are you asking Are you THAT dumb to figure out that he s uncomfortable ğŸ˜‘ You should burn In hell for forcing someone to talk about that they don t actually want to ğŸ™‚
Violette Picker	ok the interview wa shit bUT KRIS â€™ S ENGLISH THO WOWWWW
Tahsin Mahmud Adib	I think he asked sensitive question and he s talking like every u kid is 6ft tall ğŸ¸ğŸ¸
Tiffany Keepers	Kris handled the EXO question so well But he is so much better solo because he stand out a an individual I love EXO but I wish I could see more solo from EXO
Alejandro Gonzalez	You went back to China because SM can t touch there Fucking traitor
yes help	wtf this is so disrespectful i cant feel kris feeling uncomfortable
anto kumai	He is amazing
Noel Kim Tráº§n	love KRIS WU
liana lee	Professionally unprofessional interviewer
Tejuoso Ayomide	this guy s know for his stupid as question gosh i hate this interviewer
T F	ohhh this is the really shitty interviewer who gave that shitty and insulting interview for jay park also damn sorry kris wu had to go through this also
pentagon hui's wifeu	The interviewer should feel honour to get to interview kris wu and not someone else But he wa acting really rude like wtf Not gon na mention about what he said but y all know it Luckily kris is very kind Ugh
u aa	His voice shivered a bit shocked meğŸ˜“
;:	well we all know that asian ppl r soooo sensitive when it come to family topic and like
spectacular borla	12 member ghaddâ¤
kzire	this interviewer sucked as holy shit
Siti Hajar	Dude have u done this before That wa soooo awkward Kris wa struggling to answer those question
mochihyunilee serious	ok kris wa so uncomfortable with those question like dude LEAVE HIM ALONE he obviously expects people to question about HIS music and stuff SO STICK TO HIM ONLY PLEASE
blub	wow i felt so uncomfy listening to his question
M R S. J E O N	WE MISS YOU YIFAAAAN EXO NEEDS YOU THEY DONT UNDERSTAND ENGLISH HAHAHAHAHA KIDDING
H e w w o	Besides the whole thing about privacy how about actually doing some proper research a well Is it that hard to get 12 member down
Ridashisha Kharsati	This interview is kinda akward but kris did a good job ğŸ¤—ğŸ¤—
Nicole Delight	To the interviewer You know our galaxy kris wu is you know he is not you know comfortable and you know he doesnt want your question and you know cant you feel it uhm uhm you know we love him you know pls be good to him you know I fuckin loath you you know
Naila Imran	The anchor should not ask such personal question
Black Pheonix	UGHHH THE RUDE IRRITATING UNRESPECTFUL STUPID INTERVIEWER LIKE WHAT JUST WHAT
Cheryl Ho	shit interviewer
Navera Arif	dumb bitch really think all asian kid are short lmao
Echo Koo	I have observed Kris love to say yeahğŸ˜‚
Putri Wulandari	People may thumb down this video not because they hate kris but they hate THIS INTERVIEW it s so offensive to talk about a father who left a family and don t give a fuck about that family I think it bitter for kris to talk about him but you ask too many question about it not good
Nemo 2003	Thank you Kris because you don t forget exo and u I m really go on cry I can t stop I know that exo missed you so much you and luhan and Tao we really love all of you and we really wished for exo return having a twelve wolf again and the last thing I will always support you
HÄ±ll _	I thought the Jay park interview wa bad ğŸ˜« this wa garbage
MarkJin ParkTuan	I miss him my galaxy fanfan so muuuch ğŸ˜­ but the interviewer is kinda disrespectful
nurul zahidah	this is so uncomfortable to watch it feel like i m invading a too personal part of kris kudos for kris for being calm â¤
Diane Marchadesch	Whut the heck I thought Kris wa Mino winner on the thumbnail ğŸ˜‚
Well we know bts, exo and twice are legends Zainy	Did that interviewer really need to ask almost all question about his dad I mean if he is really interested in his dad then he should interview of his dad not him ğŸ˜‘ He should be thankful that Kris didn t freak out on his any lame question ğŸ˜³
btsfanarmy	Okey i wan na kill that person in the background what kind question is that bro
chococatchristi	I â€™ m so proud but I â€™ m still cry OT12 is still in my heart no matter I â€™ m proud of all the member both current and past My chogiwa king ğŸ‘‘â¤ï¸ğŸ‘‘â¤ï¸ğŸ‘‘â¤ï¸ğŸ‘‘â¤ï¸
Rafa Jingona	Kris just don t want to meet his dad or talk about it stop asking ğŸ˜‘
Poop cheese	Im sad that Kris wu not being there EXO back nothing group otherğŸ˜¢
ElleTee	Don t like the interviewer but kris handled it very well
Vicky Lieu	I believe the question about his father is too personal How rude to ask those question I would have left but he is so kind to do so This interview I hate it he stereotype him just because he is tall and Asian Just because you are an immigrant yourself doe not give you a right to stereotype others Do not stereotype others because you would not want someone stereotype you
galaxyyaoyao ff	I love you
kpop l.o.v.e	This interview could ve been much better ya know
Yukiko93_YP	THIS INTERVIEW WAS UNCOMFORTABLE BC THAT MAN ONLY ASKED HIM ABOUT HIS PERSONAL LIFE INSTEAD OF HIS CARRER AND MUSIC LIKE WTF
æ±¡å©†å©†	Is he doing a black accent
Ann Moe	y asking abt his dad bro
Yemile Ramos	Wtf with the question about his father As the daughter of a mom who got divorced when I wa little and after that my family completely separated from my dad this made me really mad He doesn t have a relationship with his Dad after they got divorced end of the topic don t go ask more question Sometimes I even don t remember that I had a Dad and it isn t even sad you get used to it just don t bring the Dad topic to u
YourKpop FanGirl	I m counting yeah who s with me
Anonymous Girl	Honestly the guy asking question wa really rude and insincere
Trash Kpop Fan	He look fucking uncomfortable when that guy asks question about his dad
jake lee	First of all he is not Chinese at all He is Canadian Secondly he is a Faker rapper in China His freestlye is like shit and finally many ignorant girl pursue him Reasonable Chinese people hate him He is too fond of talking big I am a pure Chinese I just want to talk about my true opinion
aesthetae	he s so fucking HANDSOME dude
An Shieh	Wtf this made me so uncomfortable This wa tactless a hell
kiana m	the interview is a whole scum for keep continuously asking about his father like leave his as alone but kris not trying to whoop his as either
Sylvie Rouhier	Honestly the only reason I watched your video wa because Kris Wu and Jay Park your interview style of invading people personly business and past is too much It s hard to watch I d love to dislike this video but I love Kris Wu too much â—£ â—¢ You need to learn to respect people before you can properly interview them
Souji Her	Kris is 6 â€™ 2
TaEhYuNg SnAtChEd My WiG	god christ he seems so uncomfortable my poor child
J A N I N E T E U T L E	The interviewer is so disrespectful wtf
K E	This interviewer is kinda rude Kris made it pretty clear the dad thing wa not an issue he cared about or wanted to talk about But Kris is super classy so it worked out I guess ğŸ’
eyena	Kris ma boi excited af Edit stop making him speak about his father jump this shit
Oumnia Reghai	I couldn t finish the interview I legit stopped in 1 50 because of the amount of disrespect Like bro move on he answered abt his dad what do u want more For him to cry Stay strong galaxy wu yi fan ğŸ˜»â¤
bailey bea	bruh this is meant to be an interview not a therapy session omg
kookie C	Is Vlad really that shocked He s an as
I adopted two kittens named Suga & Jennie	One of the most cringe and awkward interview I ve ever watch
Gashlycrumb Tiny	lmao what is this interview asking about his dad like 20 fucking time take a hint vlad the fuck
Seni Josh	Kris is so cute Uwu I liked this interview it made me understand better why he left exo I just didn t like the guy asking him all those question about his father like wtf He just kept asking and asking and when kris thought that it wa over the guy asked again about his father jesus christ some thing are just personal please respect that Kris baby I love u and support u no matter whatğŸ’—ğŸ’—ğŸ’—ğŸ’ğŸ’•
like dream	I hope you will stop talking about his father in the future
jikook letter	I don t understand why you are asking about his dad for 3 minute like I just don t get I think that is so personal and hard for him But he s keep smiling and that is so sweet Well done Kris
i english very well more than you	omg i think thats too much question
Lawliet Frost	the most awkward interview ever
_alexation _	Omg he look like the guy from EXO
calico **	this interviewer wa kinda disrespectfulğŸ’€ghh
C. Ling	I feel him on the dad part
nana craves for the better world	why doe he talk like that
Crystalmarie Robles	the whole father thing is not okay once he said his father wasn t in the picture you should have stopped it there pushing the issue isn t okay because the whole father subject can be a triggering thing and also no offense that s something insanely personal and that s none of your or our business
Mishal Asif	I don t like how this interviewer handled this
susan jackson	Why are you asking him 50 question about his dad You jerk
Samantha	I love Kris but not this interview nuh uh
Grecia Ventura	Ugh this interview wa really bad can the interviewer have any le enthusiam The amount of time you say ok is ridiculous and it sound so dismissive Also if he say he hasnt ever met his father then thats it like wtf else do u have to ask
Nikki	im actually cringing from the guy asking about his dad continuously
Sarah Azzawi	Isn t the guy s question too private Bruh xD Good job Kris He did great
Ikram Bb	Why dafuQ is the interviewer so curious about kris s father
Lilli-Mae Rudland	Why â€™ d he bring his god damn father up wth And then continue to ask about him wtf
jackson's baby	what the actual fuck is this interviewer doing
Alternative Human	Who tf let this dude become an interviewer
vorpheuss	Guys relax although the interviewer asks a lot of question about Kris â€™ s father but I think he wa given the mission to find out what happened Like I don â€™ t think his tone is that disrespectful and honestly kris seems aight with it so I think it â€™ s best to not blow something up ğŸ™
Sara Rendon	What â€™ s with these rude as question Wtf
Anna In The Work	YEAH
Danielle	Damn I â€™ ve never seen anyone give an interview like this Who doe that He doesn â€™ t know about his dad Why would you keep asking Tf They need to get rid of this interviewer
eggcelent	yo who is this interviewer bc he clearly is not fit for the job
Cherrybomb	â€œ Alright so what happened to your dad â€ â€œ Ok ok â€ Daaa fuq This is hella disrespectful
kmt	this made me feel awkward a fuck why keep asking about his dad yifan obviously felt uncomfortable you can tell by his face
Vivian mj	â€œ be a doctor or a lawyer â€ relatable
Mirae Moon	Wow the interviewer suck
Illusionen	Well This wa so awkward to watch
Camila Medeiros	i honestly can t believe they asked about his father why not ask about his mum
Eunice Chew	Interviewers please give Kris some privacy to be kind and respect him don t ever ask question about his father againğŸ™
m3811md17216b	ã‚¯ãƒªã‚¹ãŒEXOæ™‚ä»£ã«ã¤ã„ã¦è©±ã—ãŸã£ã¦èã„ã¦æ¥ãŸã‘ã©ã€å†…å®¹ã¯æ‚ªããªã„ã‘ã©è©±ã™æ™‚ã®è¡¨æƒ…ã¯ã‚„ã£ã±ã‚Šç¡¬ã„â€¦ãŠçˆ¶ã•ã‚“ã®ã“ã¨ã«ã¤ã„ã¦ã¨ã„ã„ã€å…¨ä½“çš„ã«è©±ã—ã¥ã‚‰ã„ã¨ã„ã†ã‹ã€èã„ã¦ã»ã—ããªã„ã‚ˆã†ãªè³ªå•ã°ã£ã‹ã‚Šã—ã¦ãã‚‹ã‚¤ãƒ³ã‚¿ãƒ“ãƒ¥ã‚¢ãƒ¼â€¦ãªã‚“ã‹æ®‹å¿µğŸ˜¥
Amisha ajith	Wtffff dude so many fokin personal questionsjust shut your damn shit
Frozan Kouhdamani	what the hell this interviewer need to know his limit he can t be going so deep into his personal life It ha nothing to do with him You can tell how uncomfortable it is for Kris I get that you re doing your job but you aren t some sort of detective to dig deep into his personal life love Kris Wu though xx
Loading Nickname	The way MC asked about Kris â€™ dad wa impolite
RÃ³sa Isaksen	This is so awkward and I feel second hand uncomfortableness I don t think that s a word but Idc for Yifan
Amii	the interviewer wa disrespectful dafuq
Shimu Miaw	F k know your boundary Stop asking him such personal question He wa feeling so uncomfortable
Lisa Buhphang	â¤â¤â¤â¤
Leigh Blanca	What an insensitive interviewer
rifvocado	vlad you needa go suck a dick like seriously pushing kris to talk about private issue like his family divorcing and asking about his dad thats literally none of your business
Stephanie Pompey	This interview is full on awkward and stop asking him about his dad
cm	the interview is just disrespectful JUST LOOK AT MY BOY He is uncomfortable
xiumin xiumin kokobop	Who tf keep pressuring him with dad question
TIFFANY LYE SU JIN 3T	hey interviewer stay out of other people s personal business it s none of your business and it s clearly a topic that he doesn t want to talk about if kris doesn t want to talk about it then don t ask about it
Liz S	the f
Priyangi Magotra	kris wu baby u deserve better than this youre a fucking superstar and we love you
Sahra Leeting	i thought his dad wa kind of a taboo topic like everyone just agreed to not talk about it at least back in the day you know
genodiva 2201	Remember that moment when EXO member imitate him cry bout his Mom like MoommmğŸ˜¢ yeah well now I know why
LPS lyra	ayo waddup kris ayo wassuuuuup memory
yoonmen yup	When your an ot12 stan and desperately want to move on but Kris wreck your resolution on letting go Even when you are no longer a part of EXO I would still support and stream your music in my heart you re still in EXO We are one EXO
Farheen Akram	I hate the interviewer WTF DOES HE HAVE TO DO WITH HIS DAD IF HE NEVER KNEW HIM LIKE WHY DOES HE HAVE TO ASK QUESTIONS ABOUT HIM ğŸ˜¤
Ezee Flores	The interviewer is awful for pushing those Dad question no sorry shoving them
Desirae Vaccaro	Kris wa always my bias in EXO and I still stan him wherever he go He is actually a great actor The interview though I also grew up without a father and you don t know what it like unless you went through it Cheers Kris Your fan still support you
nini 06	I m emo over the Dad Qs it s kind of painful tbh but I m so proud of Kris on how he openly shared his answer I wan na cry out of proudness because I can only imagine his younger day going through life without His Dad must have been difficult but he pulled through he did so well He didn t get lost He s always been an inspiring human being to me I love his proud smile when He answered he speaks fluent Korean hehe Some good memory in there I ve always love how Kris answer q about EXO Some thing will remain private a mystery to fan but the fact is HE S ALWAYS BEEN SO GRATEFUL That s one important thing Tbh whenever i recall those bad day a a meigeni i wan na throw back the hate anti splashed on Kris lol But yeah we grow up and whenever I see Kris happy and grateful who am I to attack hate back he s always been so nice and mum about the real harsh thing he have received from some people He never spoke bad against them Such a kind hearted artist I m out of here before my sleepyhead and emo heart get out of control lol Just wan na greet this beautiful person a Happy birthday HAPPY BIRTHDAY KRIS CAN T WAIT FOR 12MN HEHE Congratulations on your new song ğŸ”¥
Deshie X	OMG WHY TF HE ASKING ALL THESE QUESTIONS ABOUT HIS DAD you asked the first one found out they were divorced WHY TF YOU KEEP ASKING annoying af interviewer TRASH
LEM0NCT	ngl this interviewer need to chill wtf even if he doesn t mind answering isa stretch fucking interrogating him about his dad smh nonyadamnbusiness
Mishal Awais	the interviewer is so disrespectful
#KSHIPZKLING #KSHIPZKLING	THIS GUY ASKING SO MANY STUPID QUESTIONS INSTEAD OF INVESTIGATING SOMEONE ELSE S LIFE INVEST IN YOUR OWN STUPID MAN
Nadia Salma	Crying inside
hioji_ kakao	To kris dad your lost Every other dad would want to have a kid a successful a kris ğŸ˜¡ Now kris is the one who hv to answer all the annoying thing that the interviewer ask about his dad whose he never meet or know ğŸ˜¡
Fatihah's Channel	SPILL THE TEA
KOMIKO X MILKY WAY	Even kris wu download music into his mp3 mean doesn t matter for u right
silentmockingjay	damn I just love hear him talk
Constantine_Azrael_Gustav love	Yeah yeah Oh yeah yeah Ahmmm yeah yeah Oh yeah like Like yeah yeah ğŸ˜‚ğŸ˜‚
MAYAZ MANGOZ	Why is he asking about his father I mean like have some freaking respect
lusha rehan	Fighting kris âœŠâœŠâœŠ we love you
Takao Tanaka	i like this interview
3leggedgoddess _032	This is raw I love it No filter Kris is very impressive handling and answering all that question like wow Respect
Clover.TaeTaeâ€™s Paireno	The interviewer â€™ s question about kris â€™ s dad is making me uncomfortable
Tam OConnell	Wooooow Most uncomfortable interview jeez Shout out to Kris Wu for staying focused Surprised he finished this interview and didn t tell Vlad to FO
Charmie	â¤ï¸â¤ï¸
surrila YG	Why ask so much question about a serious topic Why Manners dude
Prakriti Gunjiyal	HE TRULY DESERVES EVERYTHING ğŸ˜­
Ratna Sari TyaDewi	Most of the time he said YEAH YEAH YEAH ğŸ˜…ğŸ˜…
Qianye He	He is cool
Hazel Aboga-a	Vlad what exactly are you doing ğŸ˜’
NIMISHA	the interviewer is such a douchhhhhhhh
xli.lxo	is this the same channel that asked jay park hella question about his past with 2pm and made him hella uncomfortable bc he kept prying and wouldn â€™ t drop the topic now he â€™ s making kris uncomfortable with question about his father bro what is wrong with you ğŸ’€ğŸ’€ğŸ’€ğŸ’€
Shrix J	Damn it sad how he kept smiling n answering such private question he ha come to promote album not tell his sad story the interviewer should know what to ask n what not
vixen r?.	Why ask some personal as question
Iris Wang	When I knew him at 2012 I never thought he could be such a great artist looking fowrd to his antares
Brooke M	wtf is this interview
ë§ˆë¦¬ì•„FutureboundEXE	Damn this boy lived 40m away from me Also y â€™ all shitting on the interviewer stop He â€™ s doing his job if you find out that Kris Wu ha never really HAD his father around and seemingly hasn â€™ t talked about it publicly you â€™ re gon na want NEW info headline etc He definitely pushed the dad thing but he isn â€™ t horrible for doing it He â€™ s doing his job a well a being curious Also Canada Pride fucker We â€™ re winning
ChimmyChimmy Kokobop	Some of these question are way to personal
dmoreno200	Our forever Galaxy
milk and cereals	the interviewer smh
ë°•ì„¸ì¸	WTF who the man asking question you really didnt know how to ak question and what to ask ğŸ˜¤ğŸ˜¤ğŸ˜¬ğŸ˜¬ğŸ˜ ğŸ˜ ğŸ˜¡ğŸ˜¡ğŸ˜¡ğŸ˜¡ğŸ˜¡ğŸ˜¡
Charlie L	so cute
winwin thepooh	urmmm ACTUALLY there are plenty of Asians who are tall what do you mean he s tall for an asian kid
baek.urmylight	This wa so uncomfortable to watch I can t imagine how Kris actually felt doing this The interviewer sound like a prosecutor lawyer who is like questioning him about some crime Those question about his father were really unnecessary Anybody with eye and ear could tell how uncomfortable kris wa I am glad kris talked about Exo And told why he really left It s okay kris People who hate you for this probably don t know that it s okay to move away from one company professionally It happens everywhere in every field i still miss ot12 and i hope that even if you can t go back to be with exo you all become friend again No matter if we know it or not Stay happyâ¤
Eliza Soberanes	Pinchi Kris te amo v
Evelyn Medina	Pinche entrevistador mamÃ³n a ti te viene valiendo verga el puto seÃ±or que se le hace llamar padre hasta en su carita se le veÃ­a lo incÃ³modo triste que estaba
Kaden Nguyen	imagine how popular in america exo would be with an english speaker like kris
Anna Vuu	so do these question go through any type of screening or is it trash on purpose
Touka Kirishima	He look like he wa about to cry
Polly TerÃ¡n	Porque le pregunta tanto sobre su padre wtf
Fadumo Mohamed	The reporter really got ball to ask Kris those question I dare him to ask Nicki Minaj similar question and watch her slap his dumb as out of businessğŸ™‚
deelovesyou	Wtf is this a therapy session Ask kris sum real question Lol
Azumi Cabarloc	â€œ A total of 12 â€ kris uWi I â€™ m cryinggggg
sydeesoo	So uncomfortable to watch him smile while talking about the absence of his father I got second hand embarrassment for the interviewer
therealiamkentot	He just said that HE DIDN â€™ T KNOW HIS FATHER since his parent separated like when he wa just a baby but the interviewer still ask MORE QUESTIONS and I wa like WTF BRO ğŸ¤¦ğŸ»â€â™‚ï¸ğŸ¤¦ğŸ»â€â™‚ï¸ğŸ¤¦ğŸ»â€â™‚ï¸ğŸ¤¦ğŸ»â€â™‚ï¸ğŸ¤¦ğŸ»â€â™‚ï¸
stan red velvet	He looked pretty uncomfortable with the question regarding his father it a pretty sensitive topic He took it like a professional he just smiled through it
candyprincess8353	why the FUCK is he asking so many question about his dad
Lee Jinhue	istg the interviewer need to get his brain checked istg
alice	what an awkward interview
Holly D	How uncomfortable is this
talkingofdragons	Is this an interview or a therapy session lol Were all those family question necessary
jiminIsbeautyjiminIsgraceIwantjiminsnutonmyface	he weird af
At Night	Back at it with them personal and disrespectful question huh Looks like Jay Park wasn t enough for you I m surprised these idol even agree to interview with you They re either too nice to say no or they simply don t know what s in store for them lmao
Kiah Lavarias	Now wtf why you keep on asking him with personal thing Like Border dude hope you knew it
Julie Beachx	I miss Kris being with EXO sm
Just Trash	BRUH THE FUCKING INTERVIEWER IS FUCKING SHIT FKSHSKSHSJ
Jenna Gao	lmao interviewer seemed to know nothing about who he wa interviewing on top of that question were unnecessarily intrusive wack interview shoutout to kris for sitting through it
Cherry Blossom	Awwww poor kris
Leeleeloveskpop A lot	Me trying not to use YEAH in a presentation ğŸ˜‚ğŸ˜‚ğŸ˜‚ğŸ˜‚ğŸ˜‚ğŸ˜‚ğŸ˜‚ğŸ˜‚ğŸ˜‚ğŸ˜‚ğŸ˜‚ğŸ˜‚
Jissel Suazo	This interviewer wa unprofessional didn â€™ t even know many thing about him d question about his dad wa just b like wtf
ShinRan	I felt satisfied when he talked about Exo It just make me so happy that he enjoyed the time with Exo and is able to live his life in peace now We will keep on supporting you Kriiiiisâ¤ï¸â¤ï¸
Georgia M	Disrespectful ğŸ˜’
deer lalu	Aww KrisğŸ˜¢ i still love u
Mohammad Sk8	My son kris for sure felt uncomfortable the whole time
Julianna Yu	This DJ is just so fking stupid and disrespectful These question are so private and hurting
alice beatrice	When he wa talkin about Exo I got emotional â¤
Hiroto Alexandria	Im deaaaddd this interview is so awkward but it s so nice to hear from Kris
Jo Jo	Playing basketball Acting Being part of a Korean boy group Making your own music instead Trying out a lot I think you re doing it right Maybe it s already your music but finally there will be something that feel goddamn right and make you happy with all decision you made Until then I hope you ll be happy anyway
Uyen Nguyen	This bitchass interviewer omfg
Ahgase Still here	i will be always with you â¤ï¸â¤ï¸ love you so much my galaxy ğŸŒŒ
Razane AREQTi	okay like the more he add up question about his dad the more my biiich wtf vibe get louder aaaargh dude why making people feel uncomfortable
Laura Angel	I m sorry but wth is up with these question Like did he seriously ask him why he went back to china HAHSGAHAGHS
KS Jin	u can tell behind his smile that he never wanted to talk about his father it so heart breaking
paper bag queen	Who tf is asking kris and why would he ask this freakin personal question it a shit thankgod he handling it well
Ank6612	This interview made me uncomfortable He don â€™ t wan na talk about his dad He don â€™ t even know his dad well enough to even talk about him
Los tres Mosqueteros	Camila Cabello 2 0 â€œ You know â€
Yosy Ortiz	This interviewer is plain stupid
less avi	ğŸ’•
holly	why yall ask so much question about his dad bruh he look so mf uncomfortable
ë«„	I know he really miss his homies i know he miss Suho srry im KrisHo shipper I really want see all member again together only once
Niso Girl	Can you make a Interview with Tao and Luhan pleaseee I mean Not totally the same but question about EXO I wish they were 12
Brittany Huggins	I â€™ m so proud of Kris for handling the interview a well a he did I don â€™ t think I would have been able to keep smiling like he wa here but Kris is sweet and so so so talented He didn â€™ t deserve the disrespect of being pestered with these intrusive question about his dad and such and then being slighted with small comment about his height and being Asian like so
bby kierra	Wtf is this
syiera	He suppose to not even ask him that Its worst
Mayra L	The person interviewing him wa awful
Monbebe	Wtf this is so annoying why doe the interviewer keep asking about his dad when kris just said he never seen or spoke to him I could tell kris wa uncomfortable Ughh
Kalolaine Ika	Kris started getting uncomfortable on this interview and it hurt my heartğŸ˜­
Gene I3	Same thing with my ma kind of never knew my dad
nouchi lor	I don â€™ t want to blame that interviewer but those question were soo damn cringe worthy obviously awkward a hell Poor Chris
No exo No life	Omfg he is smiling but I can clearly see that he didn â€™ t want to answer those question I feel his pain ğŸ˜­ğŸ˜¢ I wan na cry BUT SERIOUSLY WHY ARE YOU PUSHING HIM SO HARD ğŸ¤¯OMG HE SO UNCOMFORTABLE JEES ğŸ˜¤
pompom2001	I m sure Kris management team okayed this a it s a good way to garner support lol
are you nana?	No era necesario esas preguntas y mÃ¡s si e sobre exo
SBreeze 115	Why the interviewer act like kris is the only person to ever not have a dad in their life
reyanne langrich	This interview is bullshit Dude you don t know how to do an interview
ZHER0	Start from 2 37 did he laugh
Amal Foqhaa	ÙƒØ±ÙŠØ³Ø³Ø³Ø³Ø³Ø³ Ø§ÙˆØ¨Ø§Ø§Ø§Ø§Ø§Ø§Ø§Ø§Ø§ğŸ’–ğŸ’–ğŸ’–ğŸ’–ğŸ’–ğŸ’–â™¥ï¸â™¥ï¸â™¥ï¸â™¥ï¸â™¥ï¸â™¥ï¸â¤ï¸â¤ï¸ğŸ˜˜ğŸ˜˜ğŸ˜˜ğŸ‡µğŸ‡¸ğŸ‡µğŸ‡¸ğŸ‡µğŸ‡¸ğŸ‘‘ğŸ˜ğŸ˜ğŸ˜ğŸ’ªğŸŒ¹ğŸŒ¹ğŸŒ¹ğŸ’•ğŸ’•ğŸ’•ÙØ§ÙŠØªÙ†Øº Ø§Ø­Ø¨Ùƒâ¤ï¸â¤ï¸â¤ï¸â™¥ï¸â™¥ï¸ğŸ’–ğŸ’–ğŸ‡µğŸ‡¸ğŸ˜˜ğŸ˜˜ğŸ‘‘ğŸ‘‘ğŸŒ¹ğŸ˜ğŸ˜ğŸ’•ğŸ’•ğŸ’–
kãƒŠãƒ•ãƒŠ	This interview just making me mad Wtf are those question
Scarlet Ash	This interview is so awkward It is not an even conversation and the interviewer just keep repeating everything he say over and over
Galeanoì•Œë ˆ	I love this man
the ikonic astronaut is not on fire	Damn that interviewer
SlothMode Reacts	I felt like the digging into his relationship with his father wa excessive invasive and unnecessary After a certain point it became too much the interviewer need to be able to read the person they are interviewing
Ø§Ù„Ø¹ÙÙ€Ù†Ù‚ÙˆØ¯	Ok ok okay
Shiro Moo	Can I know who s the interviewer Can I slap him he shouldn t ask him about his private life I feel so uncomfortable
Daddykink with sehun	um i felt very uncomfortable watching this interview wow i wonder how kris felt
exo is my life	I think this interview is about his dad stufff
Val // Frezzepop	What is the name of the person interviewing him ğŸ™‚
Lucas Domingues	I love you Kris Wu
chanwoo's baby	the interviewer is a bit dumb sorry not sorry but my baby ktis wu did well it s okay now
yxxngi	the half of this video is about his father omg I m gon na break something
Kassidy Rose	this interview made me uncomfortable
Ashwin Kumar Kispotta	The interviewer should have asked about his artistry
AyyyYER23	Kris Wu â¤
MiinMiin Chiang	wtf is wrong with the interviewer so disrespectful in many way
ZZ Smile	Are you feeling a uncomfortable a I am Kris you handled this ultra awkward interview well
kylamvickers	Ugh this interview is just a bad a the one he did with Jay Park stereotype and just plain disrespect
k - jesus	â€œ fOr aN aSiAn tHaTs rEaLLy tALL â€ dude not all asian are short
Kiara	Hey man don t be arrogant that Europeans are taller even most tallest men are born in Asia and you have to know that Kris is very famous in Asia and Europe so it s doesn t matter about his personal life he is very talented man and he have gut to face irrelevant question
Linxi Peng	Wow luv my wu
emily aponte	So kris wu is going to join exo again like for real or no CAN someone tell me
BabyJ	WOW HE JUST BASICALLY HARRASSED KRIS why would you invade someone privacy like that I bet they wouldnt like it
Shruyoti Manandhar	Really disrespestful interviewer how many time will u question my kris about his father ğŸ˜¤ğŸ˜¤ğŸ˜‘ğŸ˜‘ğŸ˜ fuck off
Huzaifa Mushtaq	Goddammit stop I wan na slap whoever wrote those question It s such a sensitive topic you don t casually talk about stuff like this and look at Kris his smile look really fake and he look so sad
Flora Q	The interviewer made me cringe so much ğŸ˜‚
Fatma Dewy	i hope you back to EXO Kriss oppağŸ˜¢ğŸ˜¢
Kim 99	Ignore everything just focus on his deep manly voice GGGGODDD
sami islam	the interviewer had no right to put him in the spotlight and ask such and soo many personal question like that he s actually dumb or what
Sian	Why doe this interviewer always ask such shit question He did the same thing to Jay Park Like wtf is it his style to be a douche or something
D H U H A	Uhh this interviewer is so fckin rude plz dude can u be more kindly when u asking about his dad
vashti Assumi	Dumb q
LamLam Joyce	Hey dude please respect to Kris WU â€™ s privacy it is fkn rude
oohstepp	Guys take a shot everytime Kris say yeah lol I hated this interview First half wa so bad Damn interviewer
miss nady	Oh damn I dont know his parent divorced He must been through a lot of pain growing up without a father
Honey Treats	1 You don â€™ t question someone â€™ s absent father and KEEP asking it You practically forced him into a corner to answer his question 2 Your comment about asian weren â€™ t horrible but I just want social medium platform to be used well and not encourage stereotype
Ican'tHandleHobisBoogieBootyAnymoreSendHelp	The interviewer didn t even freakin know he rapped in EXO Plus digging so deep in his personal life with the question about his dad wow what the actual fuck I m so proud of Kris for being so kind keep smiling and answering these idiot question and not just walking off which we all would ve understood supported
Steph GD	Pretty insensitive line of question really uncomfortable Kris is a sweetheart ğŸ’œ
Keizhel VLogs	He chuckled 6 03
ayumi96love	7 40 yeah i interview Jay Park lmao no wonder you sound so familiar youre the idiot with dumb question still wondering why sexy jay will even accept his interview
Chelsea Bless	Poor Kris I feel his pain he s such a sweet and kind person STUPID INTERVIEWER
Annette Edwards	GOSH DAMN IT THIS GUY WHO IS INTERVIEWING KRIS PISSED ME OFF He s SO DAMN DISRESPECTFUL PERSON
skatergirl 123	I â€™ m so uncomfortable can he stop asking him bout his dad ffsğŸ˜©
FIIX ONEZ	ğŸ–¤ğŸ–¤ğŸ–¤ğŸ–¤ğŸ–¤ğŸ–¤ğŸ–¤ğŸ–¤ğŸ–¤ğŸ–¤ğŸ–¤ğŸ–¤kriswuulifan
Cory Holmes	The point of an interview is to ask those uncomfortable question He want to break in american mark especially hip hop He better get use to it This isnt asia where they have all question before interview and it all basically acted out He did a good job Everyone need stop cry Vlad did his job like he always doe
Caticorn K	That â€™ s the saddest interview of Kris Wu he look so uncomfortable while answering the question and I think these question were a little bit to much ğŸ˜”
Won Niyya	Kris look s very uncomfort
LIFE vs LIFE	the dam f ing question about the family is very private you could see it in kris s face
Loverì—‘ ì†Œ_	Interviewer So you are pretty fluent in korea wow Kris yea hehe CuteğŸ˜‚ğŸ˜‚ğŸ˜‚
Bacon	Someone get this interview fired so many of those question were unnecessary and the interviewer could ve just done some research to get the answer Pretty much none of these question provided any insight on a Kris personality
Vivi Jane Charles	Wow The interviewer tryanna squeeze all of Kris intestine out to know about his personal life But Kris being so sweet and professional dealt with this shit moment so well
vicky lee	Yeah counted million time
YONG	hey djvlad this video only get that many like because we wholeheartedly support kris a an artist so i hope you re not sitting there thinking you got lot of like because you re a great interviewer because that s entirely not the case at all while kris wa being super nice and welcoming you were being extremely unprofessional and disrespectful i ve seen a lot of show where the interviewer ask hard hitting question this isn t how you do it i hope kris ha a wonderful day
ffelicia 0h	Ğ²Ğ»Ğ°Ğ´ thank you
Kris Wu	Kris Wu is very strong and gentle to others His first album Antares will be released on November 02 Please pay attention to it
EXO XIUMIN	U DITCHED EXO FOR THAT
Christine Khamo	Kris ğŸ˜­ğŸ˜­ğŸ˜­
tipi topi	Traitor
emma j.	What s up with this interviewer Why is he asking intrusive question More than his personal life he should ask about his professional one
ë¦¬ì•„ë‚˜	Okay but the way he smile whenever he say Yeah make me so happy like AWWWWW BABY ğŸ˜ğŸ˜ğŸ˜
I live for Suho booty	Omg this is just so annoying I don t know about you but I feel super uncomfortable listening to Kris talking about his dad plus am asking the interviewer before asking any celebrity please research some of their information But any way Love you Kris Keep up the work Sorry my English is really bad
Drm Frost	STOP ASKING ABOUT HIS FATHER GOSH
filthy mudblood	WHAT A TERRRIBLE TERRIBLE INTERVIEWER Why the hell would you keep on pushing those question about his dad that wa really unprofessional and uncomfortable to watch Know where to draw a line
Samantha Jacobo	Wait what happened about kris wu with exo
jess mai	wtf is wrong with the interviewer stereotyping asian digging into kris past issue and asking so much of his dad this guy is so fucking rude istg
Amber Rodriguez	PART 2
Ice Aroonpong	Whay is WRONG with the interview Why do you keep asking aboit his dad Damn give a man space Glad he handled it well I wouldve blown my top
sinneruki	What kind of content is this interview trying to give Tasteless
Jmaica Smith	YEAH ğŸ˜‚LOL
Sophia Yamaguchi	I m cringing from him here more than when he wa an exo member holy fuck eyyy thanks for having me brother I bet people cringe the same way I m cringing when i say dude and bro LOL
TaeKook Is My Religion	Fuck this interviewer and his shitty channel
ShinyBusterBaby	Love you Kris Still with you baby boy ğŸ’—ğŸ’—ğŸ’—ğŸ’—ğŸ’—
Michaela Marie Jacoba	I miss the EXO s Galaxy Kris Wu
KevjumbaNigahigaYTF ARMYVIPEXOL	WORST INTERVIEWER I m stressed just listening how he is asking question and reacting to Kris answer Love how Kris is so respectful and polite despite the rudeness and ignoranceâ€‹
boi wot	Y all are fucking nosy fuck u and choke on my dick
wassgud 12	I love you Krisâ¤ï¸ but wtf is up with the interviewer
annie.thinggoes	Aw Kris is so genuine and cute He s so honest and independent
Kendell Salem	I first saw Kris Wu in one of his movie And then I did some searching checked out his music and interview He s such a talented guy I would definitely give him a thumb up lol
Vi er 77	The interviewer is insensitive i can feel that kris is uncomfortable about dad topic
ì•Œë¦¬ì•¼ ë¡œì¦ˆAlliah Rose	He just want to pursue his own thing about music and he can t do it if he s in the team He just love his music but he also love his team I cry when he left but I understand him now more I know he love his team but he just want to grow I hope for his happiness always Keep shining my ultimate bias forever and always
Anju Potsangbam	After seeing this I began to love him more
Makenzye Blackwater	I m sad about his past and the question that were asked but I am proud of Kris handling this interview very well But people who read this just know that VladTV is a personal interviewer who asks deep question I am sad to hear about Kris father but Kris handled it well He also said a lot about EXO thank you Kris I love you Kris and I ll support you no matter what Good luck on your album Antares â™¡â™¡â™¡
Somila Thokchom	I miss when he wa in exo
puta fea y zorra	I love kris n I would â€™ ve throw hand if I had been in his position with that rude as interviewer
sdghv lvhgngv	i live in vancouver and have some how never heard of him he come off like the typical rich chinese kid in this city lol just googled him and he even went to a high school i m familiar with crazy
Cloud Nyne	He s nervous when EXO topic came in
Daddy Longlegs	Chris wa so uncomfortable dnskjsksnsks I would be to tho fhdkksks
Yutbunny Chan	I dont like the interviewer He asked too many private question about his family
Haritha Ashok	Wtf is wrong with the interviewer How can you ask like that about his dad I mean he could just ask once and stop Idiot
cute cutie	Kris Wu wa ma fav Member in EXO n still he ma fav And it okay to not have a daddy and proud of how strong you grew up you be ma mentor from today coz i hv no dad too so is a mom be happy with ya mom n love you 4eva
Nmatczak	All the question about his dad made me upset let the poor boy live
Zahra Tanisha Khan	His smile is absolutely gorgeous ğŸ’• But the interviewer made me so uncomfortable with those question but Kris handled them so well
No Way	Honestly you should apologize for asking too many question about his father At the time when he wa in EXO Kris really wa upset when fan asked him about his family and requested them to not ask those kind of question So tell me why fan which have even a young age group could understand the request but you a grown man can t Ğ¡ĞºĞ°Ğ·Ğ°Ğ» Ğ¶Ğµ Ğ¾Ğ´Ğ¸Ğ½ Ñ€Ğ°Ğ· Ñ‡Ñ‚Ğ¾ Ğ½ĞµÑ‚ Ğ¾Ñ‚Ñ†Ğ° Ğ¸ Ğ¾Ğ½ Ğ½Ğ¸ĞºĞ¾Ğ³Ğ´Ğ° ĞµĞ³Ğ¾ Ğ½Ğµ Ğ²Ğ¸Ğ´ĞµĞ» Ğ·Ğ°Ñ‡ĞµĞ¼ ĞµÑ‰Ñ‘ Ğ±Ğ¾Ğ»ÑŒÑˆĞµ Ğ´Ğ¾Ğ¿Ñ€Ğ°ÑˆĞ¸Ğ²Ğ°Ñ‚ÑŒ Ğ½Ğ°ÑÑ‡Ñ‘Ñ‚ ÑÑ‚Ğ¾Ğ³Ğ¾
Donald Trump	Lol bet his dad regret leaving him ğŸ’µ â­ï¸
h hxlv	You re doing a good job kris I m proud of you You ve worked hard pls be healthy rest well I love you ğŸ’•
jenÃ¸ the sÃ¸ftie	Bit harsh with the question going a bit too in depth about his father Who know maybe Kris didn â€™ t wan na talk about this he seemed a little uncomfortable ğŸ˜‘
Carmen Garcia	I love him so much I â€™ m so glad he â€™ s doing so well with his music career especially since he had to endure a lot of hardship and discrimination in SM I teared up a little when he talked about ot12 He wa one of my faves since day 1 and I â€™ m glad I can still support his musical career outside of EXO
trash	yo this is the worst interviewer he obviously didn â€™ t want to talk about his dad and the stereotyping about his height and being asian is so disrespectful
df julesful	Do you have sibling He s Chinese born in China of course not
WingedBunny	Dude this is how he talk in English I wa not expecting that ğŸ˜‚
Shine Gallarde	What happen to his voice
Leann Pham	fuck those dad question what the fuck
Iris Lu	OMG This interviewer DOES NOT RESPECT Kris at all Stop asking his father okay
agie	bro what is this a public therapy session LEAVE THE MAN AND HIS FAMILY BUSINESS ALONE
natalie hi	All the dad question were really unnecessary but krissisissisis i relate on all level mine flaked on me too lol but it really is how it is
Anna Li	im sorry that sm wasnt more lenient towards krishantao like it wa different six year ago i understand that but they really could ve made an effort to let them work on the music they wanted and be a part of the group obviously not making them work too hard and trying to also give a little free time here and there
Twins Vlog	My babyâ¤ï¸â¤ï¸â¤ï¸
amber loves to cry for her idols, bye	Bitch stop asking about his dad DUH
Christina Leneus	Damnâ€¦you being made press about this kid personal lifeâ€¦Did daddy thisâ€¦ Did daddy thatâ€¦ Where wa ever daddyâ€¦ And daddy if everâ€¦WHAT DAMN MAN GET OFF BOUT IT
vy ngo	i m surprised kris didn t lose his shit during this interview like the past is the past keep it in the past ya fucking as
Nicole Magmanlac	I tried to count how many time kris said yeah yeah I tried ğŸ˜‚
Farin Rahman	I have so much respect and love for Kris for being so polite with the DJ when he wa being super disrespectful and asked so many personal question
Sabihah Islam	I LOVE YOU KRIS but tbh this interviewer is kinda annoying
Jimin	Bruh why ask question about his dad That s his privacy
Dar K	Kris my baby I love youuuuu
kittycath auh	Chicken is not my style our kris wu ğŸ˜
Rina Parliya	Stop asking inappropriate question abt his Dad his past his childhood family It wa terrible for him he deserves more respect a a guest star
Vivi N	Oh my goodness this interviewer really doesn t know what privacy mean or taktgefÃ¼hl I am sorry i only know the german word and i couldn t find a good english translation of it It is kind of the sense of knowing how to properly communicate like being respectful and empathetic That s the best way that i could describe it My point is This interviewer suck
Julie Vo	I â€™ m only 1 minute into this and I don â€™ t like it already Like he just said it â€™ s just him and his mom and I â€™ m reading the comment that he wa asking question abt his dad like wtf
BANGTAN's wifu	we miss you â˜¹ï¸
Abby o	Y all comment are mostly about the damn interviewer going on about Kris dad and I m living for them all lol
rose water	if I had been asked all those question about my dad I would have slapped someone Kris and I have similar situation it seems bUT HE S SO CALM ABOUT IT
oppar	this interview wa a flop lmao
a11 Bb	I AM NOT EVEN AN EXOL NOR DO I KNOW ANYYTHING ABOUT KRIS BUT omfg I â€™ M SOOO ANNOYED BY THOS INTERVIEWER
Jennifer Daniels	You asked about his dad so much I thought we were gon na have a Maury moment and you were gon na come out a his dad WTF man Incredibly disrespectful Kris certainly didn t need to waste his time with you but kudos to him for handling your that gross amount of prying so well First and last video of yours I ll be watching
mericaisg8bcmericaisgud	Wow his English got so much better
Chanyeol's first And last wife	3 42 ğŸ˜¡ğŸ˜¡ğŸ˜¡ğŸ˜¡ğŸ˜¡ğŸ˜¡
Atsuko One	Omg he wa pushing the topic about his father too much like wtf
CHENANIAH DEL ROSARIO	kriiisssss we miss youuuâ¤oppaaaa
Prive BBH	YEA YEAAAA HAHAHAHA
joyita	this is an awful interview i â€™ m sorry kris
Sof.	I felt awkward watching this interview This man is asking him question but doesn t make this interview lively at all He s just jumping from one question to another On top of that he really make this interview even more awkward by asking him sensitive question and keep hammering on them Stop doing that man Not cool
Selina Meier	He â€™ s so cuteğŸ˜­â¤ï¸
avery	my guy ğŸ¦‚ğŸ¦‚ğŸ¦‚
Super Sonic	This guy reminds of some Chinese nerd I went to school with but wa obsessed with hip hop Maybe he is him idk But he sure look like the dude
jeon somi	we hope you were happy now kris ğŸ’• god always bless you ğŸ’• we always love you no matter what ğŸ¤—ğŸ¤—ğŸ¤—
angel ma	if someone keep on asking about my dad i will go NAH i am not gon na answer any of that THIS IS SO RUDE
Ann Lucena	You are the worst bastard I have ever had a misfortune to encounter I get it it s your job but you really didn t have any reason to be a dick about it You don t seem like a professional after this interview I don t give a shit particularly about you getting the hype because one day this will boomerang back to you and I would love to see how your arse deal with it
TrÆ°Æ¡ng KhÃ¡nh	No matter what he is always a part of EXO And I hope that his dad and him gon na have a better relationship
Cirine Trabelsi	i feel like all these question were inappropriate to ask like stop asking him about his father when he already told you there is no contact and the way he wa asked to talk about exo idk why but it made me feel uncomfortable watching it
TaeM Ochi	I never knew he wa in Exo I loved his music a a soloist and I find that inspiring that he knew his path and decided to stop
Chaeyoung Eva	Im cry right now why he is just asking him about his dad T T it so emotional ğŸ˜¢
Eva Gaming	Hell yeah his voice is deeper than my as
Annah Conda	this whole interview wa so fucking disrespectful it s supposed to be an interview about kris but nah let just talk about his dad instead prop to kris for putting up with this bullshit kris management don â€™ t play him so dirty next time
Kim Bangtan Is A Bop	That hairstyle tho wtf
eggtarteu xx	The question this guy asked him wa VERY RUDE STOP IT RN OKAYYYYY
Dragon Butler	I wonder if his dad know he â€™ s an idol
Stream AIIYL Yooo	His reason for leaving is so stupid He is so inpatient If he didn â€™ t leave they could â€™ ve allowed him to write music for his team just like they doing with chanyeol
ã—ã®ã‚€ã®ã²ã®ãŒã®	wth is happened to his hairstyle
Juana Kim	I miss you so much Yifan I m so proudddddd and you deserve all the love I love you and we re always here for youâ¤
Nina Balante	when is part 2
Gabriele Beard	Can the interviewer leave him alone about his dad
Lord Gaia	LOL Kris EXO Fans are funny They probably never watched a Vlad Video and expect from Vlad to ask soft Questions It s nothing compare to the other people that he asked about
supriya hansda	Asking about his dad wa definitely unnecessary But he handled it well So proud of you babe Much love â¤
MsTravelTheWorld	Who is Kris Wu A brave little horse Chinese zodiac to dare to say NO to evil oppression and abuse that led the way for industry change to benefit other artist and a kind giant his height for humanity to bridge the East and the West at least for hip hop music side one step at a time His voice sings for his heart of truth Oh I hope one day he will meet his dad again and father and son unite I m sure he will Of course though he love his mom so much that he will respect most certainly her will before that happens
Aqsa	Damn u can tell how uncomfortable kris wa feeling when he got into detail About his dad I love kris who The fact that he treasure Exo mean a lot to Exo and Exo l
Charlee	I get being a celebrity you â€™ re going to get personal question but the way he answered the first couple of dad question it â€™ s like ok interviewer give it a rest Put 2 and 2 together and let it go There â€™ s only a few way to say there is no relationship with his dad ğŸ™„ I mean I got uncomfortable ğŸ˜¬ Respect to kris for handling it so well
Ø§Ù†Øª Ø­Ù…Ø§Ø±	Am so sad because he didnt see his dad thats so sad
Ruxuan Ma	Why they doing that to him Isn â€™ t that a like obvious sensitive and private question I mean he told you that he and he â€™ s mom wa separate from his dad God The interviewer now a day tho
sarah vivamus	MY PRECIOUS BABY MOONCHILD
Sean B	lmao these first timer getting mad at vlad not knowing he notoriously love to focus on the lowest point of somebody life dope interview though dude fanbase is active
NATASHAA CHOONG	Kris we miss you ğŸ’
Machi L	Great Kris Si proud of you â¤ï¸ğŸ™‚
Zayida Esmeralda	This interviewer is stupid â€œ Have you ever talked to your dad â€ BRO HE SAID HE NEVER MET HIM HOW COULD HE HAVE TALKED TO HIM ğŸ¤¦ğŸ»â€â™€ï¸
coffee jimin	I couldn t watch this Ugh the cringe is so bad get another interviewer please
Intan Jamaludin	Kris baby you re doing great Also interviewer sir you re an as
K-Pop Freak	He must have felt uncomftarble about the question he asked about his relationship with his dad
Bea Abigail	Ayyyy EXO
È˜EHÃšÅ‡ È˜Å¢AÅ‡	I really missed you Please come back to u a soon a we have never forgotten you and will not forget you because we consider you from exo It is true that you are not in the band but you still inhabit our heart a well a tao and luhan We have long lost you so much and so much so So please tell u that we will take care of you so much and i forgot something important i won the arab and we love you very much really and even when you let u understand how you got tired of me and finally i hope you can read me and answer me and i really love you and all the fan exol ğŸ’•ğŸ’•ğŸ’•ğŸ’•ğŸ’•ğŸ’•ğŸ˜ŠğŸ’•ğŸ’•ğŸ’•ğŸ’•ğŸ’•ğŸ’•ğŸ‘‘ğŸ‘‘ğŸ‘‘ğŸ‘‘ğŸ‘‘â¤â¤â¤â¤â¤ğŸ˜»ğŸ˜»ğŸ˜»ğŸ˜» fayting
Lina Derendyaeva	Ğ Ñ Ñ‚Ğ¾ Ğ´ÑƒĞ¼Ğ°Ñ Ñ‡Ğµ ĞºĞ°Ğ½Ğ°Ğ» ĞºĞ°Ğº Ñ€ÑƒÑÑĞºĞ¾Ğµ Ğ¸Ğ¼Ñ Ğ›Ğ¾Ğ»
rawrrr hehehe	6 09
Liyana Rabah	I mean shut up how insensitive are you with the dad question
Katie Liu	Naega wolf naega wolf aoooohh a saranghaeyo
TRE STAYLIT	Yaw have weak skin ğŸ¤¦ğŸ½â€â™‚ï¸
Hargovind Gupta	Hey i am from India i am big fan of kris
Ren __	This is the WORST interview I ever watch They should build a good atmosphere so the interviewee can talk comfortably and you can see here kris feel a little bit UNCOMFORTABLE about some question but luckily kris is a humble person and answer the question kindly What a bad interviewer He didn t even show his face HAHA
Bi Ru Kai	What The Fuck Who s this shitty interviewer
SWAGATA MUKHERJEE	What these question are Ask about his career why so much question about dad He is still a superstar without dad
Rima Rahman	THE INTERVIEWER CAN GET TO F HONESTLY U ARE SUCH A DISRESPECTABLE PERSON HOW CAN U ASK SUCH STUFF why u tryna open wound broo KRIS HONEY JAGIYA dont ever come back to this interviewer
Natt H.	That interviewer is a giant bitchğŸ˜§ğŸ˜§ğŸ˜’ğŸ˜’ğŸ˜’ dickhead
Happy Merry	this must be the worst interview ive watched the interviewer sound stupid always bringing out the dad ğŸ˜¡ğŸ˜¡ğŸ˜¡ğŸ˜¡
SCREWER AH	6 20 yeah that time it wa big absolutely Yeah bro exo is now shinking because the new album is a flop
Neny Chie	This is the fucking saddest video ever
Malsha K.	Why did Kris say Exo wa huge back then They â€™ re still huge
Greg Pittsy	Geez the interviewer is so fuckin annoying
Gilbert Ibuos	Yohhh don t make Kris uncomfortable and just talk about to his Dad I m not an EXO L and this is the first time I watched Kris speak in English and he speaks so passionately and he ha a really deep voice yohhhh I wish they have a reunion
Aliya Maly	HIS ENGLISH IS SOOO FLUENT NOW
byun baek	kris deserves better than to be interviewed by you
hao shang	Just go to his new albumï¼ŒAntares ï¼Œyou will love it
Indira Dey	3 40 For an Asian kid that s pretty tall wtf is wrong with this interviewer Mister for a human being ur pretty damn obnoxious
Charlie Is a Scootaloo	I hate this interview tbh Kris looked so uncomfortable and faked smiled laughed some of his personal question off You can tell we didn â€™ t want to answer them they did the same thing with Jay Wtf I still LOVE You Kris
QuencySVlogs	This is such a crappy interview why the hell yu asking personal question like come son mad disrespect
basic elle	MISS U KRIS â¤ï¸
YoungbaeMadness	Ya ll kept digging and digging and digging and digging about his father smh
Daniela Casaljay	Kris I really miss youğŸ˜ŒğŸ˜¶ when I saw you i click quickly this videoğŸ’• coz you are my idolğŸ’•ğŸ˜ I hope you ve come back with EXOğŸ’•
kpopistakingoverme sendhelpto1234arenstreet	This whole interview is a complete mess the interviewer wa making kris uncomfortable wtf
Yeolie Park	So handsome ğŸ’“
Akisha Nacino	we miss you ğŸ’–
evelyn uwu	this interview is SO uncomfortable
è–‡æ½”æœ±	It s ok It s ok this is so very great man
Jennifer Cabante	I think he s already furious by question His facial expression quite changed
jojoxoxo	I feel like it wa so hard for him to talk about EXO I mean yes not only did he leave and it wa massive drama but I think at the end of the day the boy really meant a lot to him Must have been so hard to leave all of them behind even though it wa definitely for the better ğŸ˜•â¤ï¸
Exo_l we are one	Ù…Ø§ ØªØ®Ø·Ø§Ø´ Ø§Ù„Ø­Ø¯ ÙˆÙ„Ø§ Ø£Ù†Ø§ Ø¨Ø±Ùƒ Ø­Ø³ÙŠØª Wu yi fan you ve got all of our heart
Rylnn Indaeyo	He clearly said â€œ No â€ you dumb as fugly stupid moron
ìœ ë² ì§±	KrisssssğŸ˜­ğŸ˜­ğŸ˜­ğŸ˜­ ot12 Why is the interview asking question that might be toooo personal
Mochi _Suho	Man the interviewer doesn â€™ t know how to shut the fuck Up Like seriously Kris wa so uncomfortable but he handled it like a proâ¤ï¸
min yeol	i miss u
Taehyung_Biased	I hate the interviewer
Kristine Mae Dorado	As much a i want to know more personal stuff about kris i hate hate this interview half of this vid is about his father this should be about his music Like duuuuuuudddddde you see how uncomfy he is with you asking tho dad question he s being modest by even trying to answer the question dude you fuckin dont ask those question like helll My goodness fan don t even ask those question like who the heck are you Shit just quit your job bro you don t know how to do an interview
Calvin Tai	This interviewer is asking too much personal and controversial question Kris already said he never saw his dad and the interviewer keep on fking asking S
Mareta Amanda	i can t bear to hear the rest of the interview
Who let He died	Fuck this interview I think it is an interview not counseling about dad
Bts V	Respect for his mum she wa able to raise a kid like that I think she is proud now
Fighter Phoenic	Im sure the mc who wa asking question is egoistic and prideful like the way he asking question he not giving a damn or any respect or sriousness This is not the way to intrview a prson either great or small are u newbie mc
sad sushi	This interviewer ha way too muhh confidence with these question wtf
Byun Baekhyun	Wow it feel weird to picture him in exo anymore It â€™ s been so long I â€™ m happy he â€™ s doing well This made me wan na go rewatch exo â€™ s showtime ot12 3
amy	he wa so smiley throughout this interview and he handled every question so well i love him so much
ë‚˜ë¯¼ê¹€	With the personal and past question i m proud that kris answered everything with a smile and didn t get angry but at the same time i feel sad that he had to go through a lot That interviewer need to back off on those type of question
feiran he	can they just stop asking question about his ex band that just a period of life history it ha past almost 4 year
Harshita Dubey	Love you my kris and Happy birthday God bless you for your future forever
chenchen cai	Who tf is the interviewer What an asshole
aerasn	I hate it when people keep on asking thing that are private esp the past of a person Stop asking abt Kris s dad it too personal
Lo An	Kris faced with all problem and please don t blame for him about the group because he left Exo when they are in strength time
INFIRE NAMJOONS PAPRIKA	ugh stop asking about his dad it make me uncomfortable because idk my dad a well so fucking disrespectful
Komachou	This dude did the same shit with Jay It seemed so uncomfortable but jay handled it professionally
EL	so sad
Qiuyu Fan	Why are you asking him those question that hurt him the most He s really uncomfortable when you were asking and don t even stop and keep on asking
Freda.e	Dude what â€™ s with the interviewer and his dad question I barely know about Kris but dude for an interview this is too personal Kudos to kris for keeping his cool
Kassandra Badua	Ot12ğŸ’”
Taehyungsshi Army	his fake smile my heart hurt That â€™ s stupid as mc
Sanju	God bless you Kris Wu ğŸ™â¤
Willow Millar	It s not right to expect him to reconnect with his father It should be the other way around
Labliii 11	I love kris but why he always said yeah hahahaha lmao
Brittney Vang	One of the most awkward interview I ve seen with Kris in it
nara heera	Honestly speaking the interviewer is so rude Asking about his dad is one thing but he kept asking after kris said that his parent divorced when he s a baby Please have some respect to someone s private life if you want to interview them
Stan GOT7 Stan CoCo	Well what can you expect from interviewer Kris looked really awkward
kris winkk	luv this guyğŸ˜
KN Victoria	The guy wa asking too much I can tell that Kris wa really uncomfortable when the question wa about his Dad his EXO
ã¿ã‚“	The interviewer is so fucking annoying omg
é¡¾æƒ…å®‰	cool an
GK	lol this interviewer and the tone he us when he asks question is so shit he doesnt engage with anything that kris say lmaoooo okay right yeah
grow taller with hun-aah!!	i hate the interviewer smâ€” like digging about his past his Dad â€“ that s really an unnecessary thing to be asked
Cathy Liu	KrisWu is so cool
Tina Chow	He is a good boy
ì”¨ë 	okay some people dont understand so imma make it clear yall cant say that the man wa asking too much question about kris â€™ father and claim that it â€™ s too private for him to tell in public or to the man like uhh the main point of this video wa to interview kris about his dad and how he became an idol so basically he had to ask question i mean kris wouldn â€™ t just go there without knowing what the interview is about right course he knew the man wa gon na ask question bout his dad and i dont see anything wrong with the thing he had asked and the uncomfortableness kris wa feeling he wa even so chill and i think that he answered all the question maturedly BUT OKAY THANKS FOR COMING TO MY TED TALK YALL SUPPORT KRIS AND EXO AND STREAM TEMPO BYE
Leilanie Escobido	why am I cry sh t I should learn to move on ğŸ˜­
layixing	he sound and look so uncomfortable but it â€™ s nice to know that he treasured his moment with exo
Hey you	I get interviewer want to ask question that no one else ha asked and talk about issue that no one else doe but when you ask them personal question and you can tell they don t want to talk about it it s awkward for u to watch I could have given a better interview with the little knowledge I have of Kris
Rose Mary Calanag Ansay	OT12 HUHUHU We missed you so much My heart is cry right now ğŸ˜¢ I hope one day they ll gon na meet up in one place and perform at least 1 song and and This imagination make me more sad ğŸ˜”ğŸ˜­
exo suho	why you asking like that omg kris fightingğŸ’ªâ¤
stardust â˜„	The interviewer seems like a typical Hollywood airhead that only care about the view this will get at the end of the day First and last video I â€™ ll be watching from this channel Tragic
ikon jinan	you dun need to ask about his father gosh i hate that interviewer
Exh0e	I â€™ m sorry but this is lowkey funny
whitney	this wa gross the interviewer should be ashamed of himself
Kris fanfan	Support kris forever
Dieu Nguyen	Vietsub please
LADY bloom	thank you bro
yeaxjustsmile20	Dj Vlad really know how to make me cringe
Galaxy_ Gemstones	Keep fighting I m really cheer and support you The end I were love you from the mÃ©i gÃ¨ nÃ® ğŸ˜ŠğŸ˜Š
Kazzandrah Ros	OMG kris
Chloe Duvall	Does the interviewer wan na ask one more question about his dad I mean come on he clearly said the first time he ha no contact with him Why keep digging
Paola Wu	Love you love ğŸ˜ğŸ˜ğŸ˜
Louisse Raye	he look awkward when the interviewer asked about his dad
Ur mum loves BTS	I love how Kris handled the question about his past very professional and the title of the video is kinda off
Indie last name	wHY on earth did he keep pushing the whole dad topic ffs doe he not have any people skill like surely you could fucking tell how uncomfortable you were making kris feel ğŸ˜¡ğŸ˜¡ğŸ˜¡ terrible interviewer
Film Won's	Why is the interviewer so stupid and ask too much dad question what is your problem leave my hunnney alone
Alice Feng	ugliest piece of shit ever
byun hye ran	he s laugh is kind a cute and im proud of him for handling the question about his father
Sweet Angel	Man I don t like his style He look so much better with a clean haircut and dress nice you know Back in the EXO day he wa the most coolest and good looking of all the member but what s going on with him
Yazzitsmee	Kris voice sound like a sweggy robot lol
Angie is always watching	Why â€™ d they keep asking the same question about his dad I get it if they â€™ re just asking him once about it respectively but like they need to chill
Kpop Forever	I am glad kris can be the true him now
Kim Marshall	The vibe from this interviewer is off Get it together mate But heyyyy Kris ğŸ’‹
Shahla	dang this trigger me like Jay Park interview
Exo-L 17	wow this interview
Kim Suckjin T_T	Dont show this to Suho
Maryam Razzack	This interviewer did NOT do his research at all
Brahim Bekairi	He Never love exo i sewar
A Person Named Lady	Reading some of these comment it s the Jay Park video comment section 2 0 ğŸ™„ Watch other VLAD video and calm yourselves down This is how it go if the artist doesn t want that he could do interview with other channel Go to Vlad and this is what you get Enjoy the insight fellow viewer Well I haven t watched the video yet D
Fatiya Azzahro	Ge i miss you so muchğŸ˜­ğŸ˜­ğŸ˜­ğŸ˜­â¤
tenchichrono	Wow I liked this interview a lot It help you understand Kris more I respect him a lot more because of this interview
kerexu	I guess his family background explains his personality He is really independent and don t take shit from others knowing his mother raised him by herself make me admire her character and perceive kris in a way more positive light than I already do I hope he agreed beforehand to those question if not it s really inconvenient
Lena	This interviewer I hope you read the comment because you were doing to much with these invasive as question He told you he hasn t seen his dad should have left it at that
Louise Wood	This interviewer is dumb Just dumb
Jiayin Chen	I love getting to know more about Kris but I hope he didn â€™ t feel a uncomfortable a the whole interview looked
Chiara Dewanto	damn kris handled this interview really well because i don t feel like the interviewer is asking relevant or polite question kris really is That Bad Bitch tho hope he keep up tht good shitğŸ’
Luna Bae	The question about his father were really unnecessary I could feel how uncomfortable he wa Even talking about SM seemed easier
ain't yo senpai	Came in YT to support EXO s comeback Tempo and ended up cry watching lot of OT12 moment and what Kris said here made me BADLY MISS THEM SO MUCH LIKE LITERALLLYYYYY CAN WE GO BACK TO THOSE PRECIOUS MOMENTS ğŸ˜­ğŸ˜­ğŸ˜­
Kim Elly	He said Yeah 55 time bitch i counted
Seve Lohe	ğŸ’—ğŸ’—ğŸ’—ğŸ’—
arisaaa a	The interview make him uncomfortable
TTzChan99	Congratulations on 1 Galaxy ğŸ˜˜ğŸ’ğŸ‘ğŸ‘
ryi neng sang	Feels good to hear him talking about exo I wa an exo l back at time in the ot12 era but with so many member leaving the group I kind of lost my interest in them maybe someday I or rather the whole fandom I guess would like to see them doing a reunion or smthng like thatğŸ˜Š
Electric Aubry	I m really mad at this interviewer Kris told you the first time they never talked Then he keep asking him if they have and any picture Shut the fuck up and move on Don t make him answer any question he doesn t want to answer
Manasandkook Talkers	Interviewer GIANT Dick
Donâ€™t Doubt TTM	I feel like they shouldn â€™ t push the question too far I feel bad that he ha to answer all those uncomfortable question
Hun Afifa	i still loving him till now ğŸ˜­ i miss ot12 ğŸ˜­
Tiffany Bo	very good
Syaziey Zaidi	asking such personal question were terrible idea seriously absurd
M Lin	Love youï¼Aways
ì–¸ë‹ˆì¡°	I m very proud of you Kris Wu Yifan I ll support and love you till the end Jiayou Fighting Oh Btw Mr Vlad you have to be careful with your question ğŸ˜¢ğŸ˜­ğŸ’”
Cherry Ngai	I only love my Guangzhou boy ğŸ˜­
Pavlina Efth	How cUte
Ooh Daddyy	yall talking about him being asked uncomftable quostions which i agree on but can we talk how good he look and how cute his smile is
coffeepinklove	I m sorry but what is the purpose of doing this interview cuz the question are so uncomfortable Kris is doing a great job by handling this type of question especially about his dad
NCT 127 I ONLY KNOW A NTC 127	Interesting interview I had never really heard Kris talk about his dad or EXO a whole lot To the people complaining about the interviewer being invasive that â€™ s standard for interview here I mean have y â€™ all ever watched a Barbara Walters interview His past shaped his present It â€™ s relevant
Savanah Louise_2327	Why did this video made me cry ğŸ˜­ğŸ’— I cried after hearing the EXO thing hahaha
Xiao Wei	The interviewer is a big douch ğŸ˜³ like wtf man have some respect
èµµæ™“è±	Hope people can notice more his new album
Haliza Layla Tsabita	Name of the program
estrella wolfsohn	Poor baby the interviewer had no respect he asked way too much question about his dad Kris seemed so uncomfortable
ImogenFAQ	So smart so niceğŸ‘ğŸ‘ğŸ‘listening to your new album Antares ğŸ¶ğŸ¶ğŸ¶
Mia Qistina	I M CRYING
Jennie Lil	I am a huge fan of yours
EXO-L Family	Thank you because asked about EXO
Amber S	Can they like not ask question like that like for real how will you feel if you if someone ask those question i will be pissed I feel so bad for him
Todoki 22	My Cool City Guy ForeverğŸ˜ğŸ˜‡
makayla b	this interviewer is horrible he â€™ s rude and awkward
toink oink	Damn i love his deep voice
SkyBean GT	I watch this video than i thing about my dad very sad my dad ğŸ˜­ miss u a lot dad
R F	Love you kris you worked hard and thank you for hard work ğŸ¤— love you love you love you love you ğŸ˜
Sam Gray	this seems more like a counselling session than an interview
Jayward Punzalan	Imissyouuuuu soo baddd ğŸ˜¥ Takeeecaree alwaysss iloveeeyou yifann no matter whatt
Leemin Ho	Am I the only one who noticed thst kris changed a lot I mean physically
Please stan Cross gene CandY	Pause at 4 11 He is so doneğŸ˜‚
Ivy Feng	I want to hug him Ï€ Ï€
Anika Tabuada	so proud of kris i still whole heartedly support him even if he left exo Im happy he appreciates everything in rhe past and still thankful he experienced with exo
FireOfHikaru	Be a doctor or lawyer lmao every Asian parent
å¹‚å‡¡Galaxy	Krisssss â¤ï¸â¤ï¸â¤ï¸ğŸ˜­ğŸ˜­ğŸ˜­â¤ï¸â¤ï¸â¤ï¸
exolexel	i miss galaxy fan fan
Sakiii	6 â€˜ 1 Isnt he like 6 â€˜ 3 or something
Yoongi's gummy smile	Sorry but not sorry I just wan na punch the interviewer on his face
Niken L. D.	don t mess up my tempo man
Jeojeol Heol	OhMAYGHADEUUUU
DRAKE REDUBLA	Still cool a ever Everything he said seemed to be like a rap hahaha
GroteskAntichrist	I love Kris and I â€™ m really happy he â€™ s doing solo SM is just blocking talent and creativity I see Kris a a solo artist and not a a former member of EXO And I think that is what he also want
Yalie Racquel	i remember the day the news about his departure from exo broke out i literally had a mental and emotional breakdown there were alot of thing circulating around the internet about it and it didn t matter if it wa true or not but my poor young and vulnerable exo fangirl heart had it own defense mechanism for the whole situation and i just chose to believe what felt like the most comforting during that time four year later on today i feel like i ve matured enough to atleast understand what happen back then he just really wanted out of exo wanted a career path for himself but chose the wrong time to do so they were having their first concert just day before he left the whole team and fandom hanging and it wa a whole mess i would ve appreciated it more if he wa honest enough to own up to his decision on why he left back then but i also understand why he couldn t and here we finally hear the reason straight from him he just wanted his own freedom to be able to do the thing he wanted to do without maximum restriction and honestly it just great to see him doing his own thing and exo doing their own thing i guess it still worked out for both party in the end also on a side note the whole dad thing in this interview wa too much i understand that it intriguing and yea maybe interesting but it also kinda off limit he never really mentioned about his dad often and it must ve been awkward sitting through an interview being asked about a person you have the least idea of in your entire life but im just happy he got through this entire interview and i got through watching this even though it kinda painful to watch ğŸ’€
arya s	This interviewer is sick
ANN QIU	what make me more proud of him is that he nwver did say anything bad about exo after he left if he dont answer anything about it from medium he also say few good thing and now he wa actually more open about it and hearing that he treasure the memory make me more proud and that i never regret that he became my first ever bias in exo i love yoy galaxy fan â¤
Hellissou xg	1 52 that laugh tho cutie ğŸ˜‚ğŸ’•
Lestlie Gape	we love u kris we also treasured the moment of you when ur are with exo and till today
dywe huang	Kriswu is a tough boy
kisskimkai	idk why i started tearing
EXO L Ariee	I like that s hehehe
ì†Œì‹œSarah	Is it only me who get annoyed by that host He is quite rude
slob kabob	What a douche bag He kept asking about the whole dad thing It â€™ s so uncomfortable being asked like that Stop digging Gosh PRIVACY
Kris Alexa	yeah yeah yeahğŸ˜‚ğŸ˜­
strllgrc Segundo	I WE WILL ALWAYS SUPPORT YOU KRIS EXO L s and even your fan will always be here for you ğŸ˜˜â¤â¤
Youssra Jose	Awkward ğŸ˜‘ğŸ˜‘
Jongins Thrust	his smile is so adorable tho
Jessica Angela	beside the point of the rude interviewer and ot12 feel my attention is also focused on his smexy pink plump lip and his messy shapeless hair ma boi u need a haircut want u too look like outta manga again
brittney brandt	this interviewer wa such trash why not talk about his amazing career
LÃª DÆ°Æ¡ng	ğŸ’–ğŸ’–ğŸ’–ğŸ’–
good evening.	c chogiwa brother chogiwa
milksomecows	Not only is the interviewer asking question that are irrelevant to Kris music career the question are also really insensitive and the answer kind of private Plus the way he asked the question is really weird There were no emotion used in his speech Poor interview
Suho looks like a pineapple	Those glass reminds me of that orange juice
Tanaka	HE S SO FUNNY ğŸ˜‚ğŸ˜‚ğŸ˜‚
IGOT7 WITHGOT7	Why The Fuck You Asked Him These Question He Is Trying To Move On
çˆ±ä¸½ä¸	I live in Vancouver ahhhhhhh
elf_ grxce	When he said 12 member what ran through his mind wa probably how it became 11 only after he left then to the ot9 now i really hope the interviewer didn t purposely say 11 just to incite his response out of kris because he is already disrespectful enough
Emma	lol my guy definitely skimmed a wikipedia article about kris before this interview wtf
Jessica C	People are getting all up about asking disrespectful question but honestly would you rather him ask the same question that EVERYONE else asks him that we already know the answer to It s the first time that anyone ever asked him direct question about his dad instead of dancing around this question Sure they re rather provocative and probing but artist draw on their own feeling emotion and experience to influence their craft It s part of Kris identity and family and home are some major theme in some of his music and what he talk about I think it give interesting insight into Kris a an artist a a human being because a child s relationship with his parent or lack thereof can be rather telling It make me wonder how much of a pain point it is for Kris not having a father figure in his life In my eye it make him more human le like the superstar celebrity image that is projected in China
Kris Bordon	I can feel that his a bit uncomfortable talking about everything his asking But by the way Kris voice is fucking making me pregnant
Fulla Haliwel	He wa so uncomfortable I can see that charming smile hide a thousand tearğŸ˜­ğŸ˜¢ My poor baby Can u plz don t push in those question that dig dip in old scarğŸ˜·
Feysdoms Perkweys	this make me uwu
tayaballama	ya hear that he doesn t hate them he s grateful for the experience OK now go drink your milk
Sara Intharath	OT9 EXO
Angel rose	How many time did he said yeah
Kristel Fae ii	it s part of the past Kris
Baek's Nutella	So proud of you galaxy fanfan Miss you so much ğŸ’•ğŸ’• Keep doing what you re doing You re doing great on your own career Aja
haha 123	I hate the interviewer
katy B	He s so chill and likable Miss him in Exo though
Hua Lyu	you know what Kris it is coz you are such excellent that is why you mom hope you be a doctor or lawyer
OMG 6194	wow those question i hate it but i loved it Lmao
Bty Y8n	Wan na hug him ğŸ˜­ also Kris Wu x Jay Park collab pls â™¥ï¸
autembor	That wa very inconsiderate asking him about his dad He wa so uncomfortable 1 36
Hajar m	Bitch stop talking about his dad What the fuck is wrong with this shitty interviewer
Nanda Anis	KrisğŸ˜­
Wishes Official	Kris Twelve member in total I don t know why but that hit me He remembered T T I wan na feel happy because today EXO s album will be released not to mention they re nine but this just showed up and yeah I saw Kris so why not I didn t know this will make me feel sad I don t know BAEKYEON
Amber's Chest	The title itself and the question about his dad are way past the limit
anime fangirl	Honestly he sounded like he had a British accent at the beginning
honey thet	stay strong my king
Soh Hyeon	He handled the unnecessary and intrusive question so well His mother would be very proud of the boy she raised
Katherine James	i â€™ m jumping this nigga period
Zenneth Dela Cruz	He lost his smile when the interviewer suddenly started the question with You joined this group fvck pain is creeping whyyyyyyyyy
Jake okok	He look so derpy Lmao
Maryem Chan	This interview is just too much digging so much about his dad is not good he should ve just stopped when he told him they got divorced but i m glad to see him doing okay even though he look really tired
Kiki	This is an interview not a documentation about his life the dad question went a little to far he obviously doesn â€™ t wan na talk about it if he wanted to he would of already done so
YUTA'nÄ±n GAMZESÄ°	WU YÄ°FAN I LOVE YOUâ¤â¤â¤â¤â¤â¤â¤â¤â¤â¤â¤â¤â¤â¤â¤â¤â¤â¤â¤â¤â¤â¤â¤â¤â¤â¤â¤â¤â¤â¤â¤â¤â¤â¤â¤â¤â¤
Nica De Guzman	Toooooo many private question I am cry cause I felt the feeling how u never actually met ur father u don t know what he look like and u never talked to him and just wonder hiw it feel like to have one Like I dont even know his name talking about it always make me cry he is so strong to talk about that and his past member
Tinotenda Sandra	Oh my goshhhh Stop asking him all these private question about his dad Literally you can see him being uncomfortable Like are y all here to talk about his personal life or his music or what Seriously shit is so annoying
kathy sturluson	oh shit he made it to djvlad
Sexcy Ashh	This broke my heartâ˜¹But still Kris did a good job a a Father of EXO eitherğŸ™‚ğŸ’•
Krungy Exo	He s still the cold but cool guy I love him
å¸…é›¨æ±	è¯´çš„å•¥ å±…ç„¶æåˆ°äº†exo
riley grace	Why tf is he pressuring his father Like maybe he doesn â€™ t want to talk about it Wtf omg
Min Hermiognie	pleeaase interview Luhan and Tao like dude ITS A MUST
dance monster	THE INTERVIEW WHERE EVERY QUESTION LEADS TO HIS DAD
Styles and Sprouse	He look really uncomfortable
kei	wa it the interviewer s intention to make kris uncomfortable with all the question about his dad he wa really insisting i hated that
exodrea61yangyang	Who watched the program wherebhe wa in and there wa a contestant who sang overdosed
Karra Solomon	Idk y i want to see a reaction from exo watching this but then again i dnt want them to get into trouble or cry ğŸ˜­ğŸ˜­
Nicolee 00	I feel closer to him
Lauren Liu	youre 6 1 yeah thats pretty tall for an asian kid uh stereotype so disrespectful
Mystomi	These question thou
1cutefreak	The interviewer could ve put more thought into wording his question Glad Kris handled it well
TT _TT	I need more movie from himmmmmm he â€™ s so beautifulllll ğŸ˜ğŸ˜ğŸ˜
Shar Paw	This is the most awkward interview everrrr
Scarlet Empress	I can see in his face he s not comfortable with the situation
Karen Du	Kris didn â€™ t seem to respond with very smart answer but normally he is a wiser person than he wa in this interview
Welsy Chae	Did the dude just ask about kris s dad What the fck
big nig	This dude wa really going deep in the question with his dad That man wanted to dig ALL the way to the root with Kris dad
Shu Qin	Interviews that are very uncomfortable Interviewers ask question and interact without mechanical interaction Very impolite behavior
Mica Garcia	I wish I can choke the interviewer myself
â™”KPOP BOSSâ™”	This wa great Looking fwd to the rest of the interview Proud of you Kris 3
Dragonfly	He looked so uncomfortable poor guy
M C	It make roll my eye every time an interview asks Kris â€œ so u where born in China â€ like fan already know that and he â€™ s said it in 100 different interview ask something else
NotYourYear	for this interview and for Jay Park s this dude is just so stuck in the past like ask them about what they re doing now what they plan for in the future what they have been doing in recent time COME ON They don t want to talk about their past and most likely their not legally allowed to share a lot of information about it anyway This interviewer need to learn to pick up on sign and read body language facial expression to know when it s not okay to continue on with a topic or a question
Serra Rojas ._.	All these dad question got me fucking cringing Like what kind of disrespectful person are you
KOok'Kaii	â¤You re Good Boy My KrisWu ğŸ˜Š
Mystic	You should stop asking them about their private life
chococc99	I m waiting for part 2
ì˜¤ë¬¼ ì˜¤ë¬¼	ì•„ ì œë°œ ë‘˜ê¸°ê°€ ì—‘ì†Œ ì–¸ê¸‰í•˜ëŠ”ê²ƒ ì¢€ FUCKğŸ¤¬ğŸ¤®
king haechan	so basically the interviewer ask the most disrespectful question about his dad exo in general his past but my lil bean never loses his smile even it â€™ s a bit fake at some part and keep being nice i stan the right person but it â€™ s really cute how he corrects him with exo
Sniffthisblossom	he so cute
Kirana Ldp	He like being in EXO ğŸ˜¿ he just need a freedom to choose his type of music
JeeMaeil	I got angry when he kept asking about his father like let a guy breath man
Jun Han	YOU FORGOT MY MOM I HAVE TO BE THE FIRST IN CLASS OR NO INTERNET DO YOU REALIZE HOW HARD IS THAT LIKE I M 20 YEARS OLD AND THERE ARE OTHER SMART PEOPLE IN MY CLASS ONLY ONE BUT SERIOUSLY MY MOM USED TO TELL ME WHEN I WAS 8 Y O TO START THINKING LIKE A FREAKING DOCTOR AND LOOK AT ME NOW HUH I M STUDYING COMPUTER SCIENCE AND I CAME SECOND IN CLASS LAST YEAR SHE STILL DOESN T RECHARGE MY DATA AHHHHHHH I M SO ANGRY MOM I M YOUR YOUNGEST YOU SHOULD TREAT ME FAIRLY LIKE YOUR OTHER GIANT KIDS OMG I SHOULD STOP NOW
felix lover	Dj soooo you wher in a grop a boy grop Kris yup Dj it whas EXO Kris Who is EXO
BORN TO SLAY	note to yourself DO NOT GO TO VLAD
a big fan	damn I mean I should have expected it to go like this with this tittle and after watching jay park s interview but that wa awkward
Alice Shin	Kris might have had the musical position of a rapper and sub vocalist in EXO but to all the EXO L put there who still care about OT12 he wa our Duizhang
Alex	Kris always make talking about exo so awkward I know he doesn t like to talk about it but you think he d be used to the question coming up by now
Hello F	Can he stop with the dad question That â€™ s pretty annoying and kris look uncomfortable there
Jasmine Flores-Jimenez	They didn â€™ t have to ask him about his dad and all he clearly look uncomfortable
Shannon Mc	I don â€™ t even stan and I know that this wa hard interview
wishing you godspeed	Please ask more question about THE ACTUAL MUSIC and not about his personal life He wa just a child and no one chooses how they grow up It really doesn t matter Just acknowledge him for all his work and accomplishment He s an amazing artist and truly deserves all our love and support I agree with everyone who said he did a well job at answering the question He stayed positive and on point He s so sweet Love you Kris ğŸ’›
Nadra KJI	Yo yo kris wu is the best And wtf Wtf is the interviewer doing
my baby gorl you already know	take a shot everytime he say yeah
Malsawmi Hmar	I find this so disrespectful why is he asking him about his dad without any hesitation he ain â€™ t feeling sorry or what Although Kris is having a calm expression i feel sooo bad ğŸ˜­ğŸ˜­
Hmingthankimi Jawhly	I fuckin hate the interviewer
stan kai's jawline	Exo and kris gon na comeback tomorrow let s support themğŸ’œğŸ’œğŸ’œ
Wendy J	This interviewer just made me feel so uncomfortable So many question about his dad ğŸ˜”
Khadija Korepan	ğŸ˜­ğŸ’œğŸ’œ
iffy H	stop asking him about his dad u idiot
eggsoo is my life	the interviewer wa so rude while asking him about his father Kris wa clearly uncomfortable
Punbabell EXO-Lufans OT12 ë¶„ë¹±ì¼ !	OT12 foreverğŸ’‹
Sheila Amolo	He s so cute I can t
Lucy R	Ok Ok Ok Do these â€œ okay â€ ever stop I â€™ m quite annoyed that the interviewer kept pushing with question about his dad Why bring it up in the first place and why ask and ask and ask But anyways I â€™ m so proud of Kris and I just hope someday there will be a reunion and all of OT12 are there â¤ï¸
Saianna Sweet	I don â€™ t really like it I mean this are really personal question and I don â€™ t think that it wa himself who told that he want to do this kind of interview
Superneo	Omg I m one minute into the video and stopped like wtf wa with the interviewer asking so much about Kris father Even the tone of his voice sounded disrespectful Kris must ve felt uncomfortable asf oml
Lit Joohunnit	Can you not you dumbfuck can t you see he s uncomfortable respect boundary smh
galaxy heaven	i respect this man so much i love him with my whole heart you re doing well Kris
jong. min	Why he ask this family thing The disrespect tho
ZTao the little Kitten	Omg It s good to know more about him How he really felt when he wa in Exo It s good to see him smile and laughğŸ˜ŠHe used to refuse to talk about these kind of stuff But he s opened up The tea is so hot Kris WuğŸ˜
Kyungsoo Yaa	I miss Kris but I â€™ m so happy to see that he become big and confident with himself He do what he want and it is great tho The interviewer is so rude to ask him about his privacy stuff So annoying
Jane Lee	why the MC keep asking his dad
Ajusshi leader	When the interviewer asked if Exo had 11 member and he automatically corrected it to 12 ğŸ˜­â¤ï¸
Eve RyLin	mystery solved
army fotmife	He pushed too far with the dad thing
Jannat Ahmed	Bless Kris
TheRoseR nate	Even I got it the first time when Chris first expressed his dad wa not part of his life talk about prying
Yiling Wei	æ€ä¹ˆçº¢çº¢çš„
Bakingremedy	Come on You try to dig someone past like that That s so annoying
Hassan Saleem	Hmm
Kris Liker	For me he too clumsy ğŸ˜† I like himğŸ˜‚
Lshoanviae S	Looking forward to the new song with a little excitement
MeryLand	i miss him
Marc Vecino	the interviewer is kinda rude asking question about personal stuff what the especially with his dad doe the interviewer still know the word privacy
Manogna P	Wtf This is so infuriating How can he be so rude Oh my goodness i feel so bad for him
Henry Shi	It s more like a job interview You can tell he get a little bit nervous and uncomfortable
Anita Carolina	OMGğŸ˜±
Rerkwaris Vorachat	So rude at the beginning Why do you have to ask about his dad so many question
Mazur Mia	ĞĞµ Ğ½ÑƒĞ¶Ğ½Ğ¾ Ğ±Ñ‹Ğ»Ğ¾ Ğ·Ğ°Ğ´Ğ°Ğ²Ğ°Ñ‚ÑŒ ĞµĞ¼Ñƒ Ñ‚Ğ°ĞºĞ¸Ğµ Ğ²Ğ¾Ğ¿Ñ€Ğ¾ÑÑ‹ Ğ´Ğ° Ğ¾Ğ½ ÑƒĞ¶Ğµ Ğ½Ğµ Ñ€ĞµĞ±ĞµĞ½Ğ¾Ğº Ğ½Ğ¾ Ğ²ÑĞµ Ğ¶Ğµ Ğ²Ğ¸Ğ´Ğ½Ğ¾ Ñ‡Ñ‚Ğ¾ ĞšÑ€Ğ¸ÑÑƒ Ğ±Ñ‹Ğ»Ğ¾ Ğ½Ğµ ÑĞ¾Ğ²ÑĞµĞ¼ ÑƒĞ´Ğ¾Ğ±Ğ½Ğ¾ ĞÑĞ¾Ğ±ĞµĞ½Ğ½Ğ¾ ĞºĞ¾Ğ³Ğ´Ğ° Ğ¾Ğ½ Ğ·Ğ°Ğ³Ğ¾Ğ²Ğ¾Ñ€Ğ¸Ğ» Ğ¾Ğ± Ğ¿Ğ°Ğ¿Ğµ
Aica Bunagan	I miss you Kris But I am so proud of everything you have achieved I will still continue to support you ğŸ˜Š
Shippermatic	I feel sad tho
Lee Soo Man	I really hope these question were approved with Kris before being asked
Imu Miu	The interviewer is extremely rude and unprofessional wow
miz fitry	Those mullet hahahahah feel bAd coz Iam laughing but it â€™ s okey kris a long As ur happy then we okey
Nayn Strong	the interviewer think their close to ask What happened to your dad like WHAT and asking Did that bother you a lot growing up I mean com on
Queen AyEnXO	omy ghad I love you Kris ğŸ˜˜ğŸ˜˜ğŸ˜˜ğŸ˜
Kimsophorn Hor	My Kris â¤ï¸
Sooyeon Sshi	If Jessica Jung will ask the same question related to her past group I probably watch it again and again and cry all my heart Im hella miss her Y know miss her with those 8 girl together
park chanyeol	he look want to cry ğŸ˜­ğŸ˜
Din 2	What is this therapy season What s with the private question
Srzahra	You guy are the worst WOULD YOU LIKE IT IF WE ATTACK YOU GUYS WITH THAT KIND SENSITIVE QUESTION RUDE
xxdoby	POOR KRIS STOP TALKING ABT HIS PRIVACY STUPID DUMBASSS
EXO Kai is my Michael Jackson	Why doe the MC keep on asking about his father respect his privacy please
Koko_ B.A.B.Y	if kris fall in love with a girl he will never gon na leave her love u WU YIFAN
Lovelyz Baby Soul, The one, The legend	Whenever I think of EXO ot12 my heart hurt especially since I wa mostly an Exo M stan To see Kris then Luhan and then Tao all leave it wa heartbreaking I â€™ m so glad that all 12 are still doing amazing and making big move Special prop to Kris who really made it work cuz it could â€™ ve very easily gone south
Ø§Ù…ÙŠØ±Ø© Ø§Ø¨ÙŠ	ğŸ˜­ğŸ˜­ğŸ˜­ğŸ˜­ğŸ˜­â¤
luisanggg 30	myghod how i miss this boyy i love you laxy i really do
Seino Aeri	ğŸ˜¢ğŸ˜¢ğŸ˜¢
Aditi Mn	Who TF is this interviewer Asking Galaxy question about his dad and personal stuff
oH mAYn hOLY sHiT	Wtf is it with the dad question WHAT THE HELL IS WRONG WITH THIS GUY he s like a plunger bringing up old shit FOK OFF BRUH NOBODY CARES DUDE
ri_12	SM will let u do whatever u wanted to do once you establish EXO name though Kris T T So this is why you left SM Lack of freedom
Allysa Magarzo	Kris I m your fangirl please do a collaboration with Exo if it s possible Luv u kingğŸ”¥ğŸ‘‘
Ritika Rklx	don t Ask to my baby personal question u idiot guy he s not comfortableğŸ˜’ğŸ˜¡ğŸ˜¡ hate this interviewğŸ˜ 
Nana Mana	0 13 Yeeeeeeeah thanks for having me brotha â€ Hesitates â€œ Absolutely man â€
drippin my love to hyuck	someone can make kris wu s yeah compilation and i would be grateful
Mia Fitriyanti	quit the dad talk it s so invading
Emiline729	I love the fact that despite being screwed over by the company we won t name he still talk nicely about EXO and the fact that he appreciates that it helped start his career I really hope to see Kris continue to gain more love and respect
Rita Hagberg	interviewer need to find a new profession leave this baby alone
I love kris and Chanyeol Exo-l	I love you Kris WuğŸ˜˜
julietsoddeye	I wan na hug him so bad talking about his dad like that I wish they didn t have to ask such intimate part about his life He s selling his music not his privacy ğŸ˜­ğŸ˜­ğŸ˜­
aliya s	kris jawab semuanya padahal sakit pasti kalo dia ingat tentang ayahnya tentang exo mau peluk krisğŸ˜­ğŸ˜­ğŸ˜­
Chan Ouksakphea Noem	I miss you idol com back Exo
Tasneem Haque	Omgsh he wa so respectful and thankful towards EXO and SM although he ha no connection with them I love you so much Kris ğŸ˜­ğŸ˜­
Chanyeol Park	MISS YOUğŸ˜ğŸ˜
MessiJinExoLoonaBigtimerush NamjinCressi	Oh how I miss him in exo ğŸ˜­ğŸ˜­ğŸ˜­
Yang Yang	åŠ æ²¹å‡¡å‡¡ï¼Œä½ çš„è¿‡å¾€æˆå°±ç°åœ¨çš„ä½ 
effi ka	Disrespectfull It s like seeing someone in the street and start asking him him question about his private life He might be famous but I m pretty sure nobody want to awnser such question when they re asked from a random person People only talk about such thing with close friend I m very mad He is famous so why don t ask common question and not one that make him feel uncomftable
Rhada Wu	I really love you Kris
ë”°ë”°ë‘”	ã…Œã…Œã…‹ã…‹ã…‹ã…‹ã…‹ê±ë”´ì‚¬ëŒëë„¤ ë™ì¼ì¸ë¬¼ì¸ì§€ëª°ë¦„ã…Œã…‹ã…‹ ì§„ì§œ ì™„ì „ ì¤‘êµ­ì‚¬ëŒê°™ìŒ
Nurul Ashikin	he just smiling answer question about his dad
william loh	I bet u 1 if u can count how many time he say yeah and like
Stephanie	Is chicken still not his style tho ğŸ˜­ğŸ˜­
Anisa Rei	proud of him he answer the question so precious although it s bother his privacy
Liome Ogunbiyi	Too many question about his dad Omds what is our world
Fall for Red Velvet's Banana	He seems so funny and ridiculous wearing that yellow glass ğŸ˜‚ğŸ˜‚ğŸ˜‚ uwu
Khoirunnisa Maulida Rahma	Without that I would never be who I am today ğŸ˜­ğŸ˜­ğŸ˜­
à¸£à¸²à¸•à¸£à¸µ à¸à¸´à¸™à¸´à¸ˆà¸¡à¸™à¸•à¸£à¸µ	OMG
Where's Chimchim's spaghettt	OT12 ã… ã… 
exo saranghae	Why is he pushing him To speak about his father it s kinda disrespectful
Lexie riche Mangalus	AYOoOooo wassUUPpp He need privacy
chaeyoung bae	STOP TRYING TO CONNECT EXO WITH HIM it â€™ s been 4 fuckin year and best to forget it
Kierra Stelly	Wow you don â€™ t ask a person that Even if you are famous that â€™ s way to personal
jane Ma	he is so cuteï¼
dyororo EXO	Almost of the comment are EXO Ls and Kris Wu probably readin all of our comment
Jan J	I m so glad Kris is doing well Exo L still love you and will always wish you the best
Jennifer Deng	That title about Kris and his father When Kris wa talking about his father I got a bit emotional But I am so proud of Kris being where he is now His new song and collaboration are just amazing
Vanessa Darkness	Ğ“Ğ¾ÑĞ¿Ğ¾Ğ´Ğ¸ ĞºĞ°Ğº Ñ Ğ»ÑĞ±Ğ»Ñ ÑÑ‚Ğ¾Ğ³Ğ¾ Ñ‡ĞµĞ»Ğ¾Ğ²ĞµĞºĞ°
i want to die	the dad part made me so uncomfortable like stop pressing him for answer it so weird man this aint ur life
Jemaa Nessa	This interviewer push such uncomfortable question You ask the dad question once fair enough but move on This isn â€™ t Dr Phil He did that with Jay too ğŸ™„
IMEâ€™s Wonderland	My heart is in peices
Yer C	Did this interviewer really ask about his dad like that
vegan soul	Shit his that is shit why the interviewer found some interesting in that fact
kellycappuchino101	3 43 actually chinese people are relatively tall Theyre basically average american height but quite a few are taller Koreans are slightly shorter than chinese Japanese is VERY short and then southern asian country are the shortest
Hermela Belay	Go Kris Fight the Shit Also EXO FOREVER
M a	I LOVE YOU KRIS ğŸ˜­ğŸ˜­â¤
k b	I MISS OT12
Anonymous	How many yeah Kris said ğŸ˜‚
Tháº§n Láº¡c	I love his voice so coollllllll
shine alforja	ot12 ã… ã… 
NORLAINE GERONIMO	my OT12 HEART ğŸ˜­ğŸ˜­ğŸ’–ğŸ’–ğŸ’–
Paula Sabina Viloria	I am so glaad he s talking about his whole experience in sm like it a blessing in disguise he deserve all the blessing Sml to kris and luhan
Krystal Zhang	Li Jiaheng s mom really raised him well his is respectful calm and independent I salute his mom and himğŸ’–ğŸ’—ğŸ’˜
bao yang	I don t like the interview guy He ask stupid question What he try to know about Kris Wu
kris wu's derp face is my style	Kris is smiling but here I am cryingğŸ˜­
Aye Christy	â€œ That â€™ s kinda talk for an Asian â€ There are million of Asians that are tall asf Welcome to kpop
Gloria Lin	6 19 i can t believe he talking about exo
Limarenla Sanglir	KRIS UWU
Zeze Hassan	He is so cute ğŸ˜ğŸ˜
i stan	No offense but i do not know why people keep prying into the reason he left exo or his family life He kept it private for a reason and we should all respect that Fans or not
Doggy BlackDoggy	Please do not mention exo any more We don t want anything to do with you You are a traitor
java20009 mason	awkwaaaaaaaaaaaard
StÃ¡r Subie	Stay strong KrisğŸŒŒ
Sky Rebecca	Always love you Kris ğŸ˜˜ SendingAllLoveAndBlessingFromIndiağŸ’
HollyHoseok	I feel like he â€™ s uncomfortable with these question ğŸ˜”
cham quang	Anh lÃ  quÃ¡ khá»© cá»§a EXO vÃ  EXO cÅ©ng lÃ  quÃ¡ khá»© cá»§a anh Sáº½ luÃ´n nhá»› Ä‘áº¿n nhau dÃ¹ qua Ä‘i bao mÃ¹a comback vÃ  nháº­n giáº£i
Dara Budiman	I love you kris
fdoctor	Really dude You are REALLY reaching with dad question Let s focus on his future POSITIVITY
TalioniesRex	Somehow I feel like this interview is so awkward tell me I m not the only one He seems so uncomfortable
DO TY	I love the smile draen on his face when say yeah the big time talking about EXO OT12 success make me smile I know and I feel it deep down gi heart I know Kris ha still a lot of respect for EXO And this just make me love him more Kris Wu will always be our Mr Galaxy Chicken is not my style but actually eats chicken ğŸ˜ŠğŸ˜‰ğŸ˜„ğŸ˜˜
asherrine_khleinh	Wahhh I m cry Ot12
sofia benitez	â¤ï¸â¤ï¸â¤ï¸â¤ï¸â¤ï¸â¤ï¸
LikeOrigami	The interviewer is good at his job that job being a dirty past digging journalist lol Nothing wrong with that but he keep applying pressure on topic that are irrelevant and make them uncomfortable Did the same thing to Jay Park It s different from other interviewer but make the interviewee uncomfortable
Cezanne Dutta	When the reporter said there were 11 of you Kris triggered
Suhocidal	Whiny as OT12 bitch THIS ISN â€™ T WEEKLY IDOL GET OVER YOURSELVES
Shin Wu	my heart ğŸ˜­ğŸ˜­ğŸ˜­ğŸ˜­ i missed u
IvanRussiaBraglinski	Yeah I didn â€™ t really like how the interviewer wa digging for info about his dad Kris looked visibly uncomfortable ğŸ™ I â€™ m really happy he seems to be a little more okay about talking about EXO I wish we could â€™ ve gotten a little more info about it all but I also don â€™ t want him to be uncomfortable hopefully he â€™ ll tell u when he â€™ s ready this ha given me a little bit of closure We love and support you kris
Mai pao	I mean wa neccesary ask him about his father and also put it in the tittle of the video ğŸ™„
Nayara Gabrielly	yeah 28228x
Eht	Those question about his dad are too unnecessary
Farhana Syafiqah	Can the interviewer just stfu omg stop pushing him
Mi W	Although he wa asking question that wa emotional for Kris I think he can get past it by simply letting it out and moving on Many kid grow up fine with one parent I learned something about Kris I never knew It make him more relatable and show how he Still excelled
Norsyaza Edmiza	I only know kris wu in exo once his out i dont know him anymore
Nisa pcy's	Kris
Where's My Oppa?	So wa this interview with Kris Wu Or interview him for 5 min about his dad You acting like it â€™ s not normal to not grow up with your dad ğŸ’€ğŸ’€
Kanza Shinji	I miss Kris in EXO ğŸ˜­ğŸ˜­ğŸ˜­
Candy Mak	This dj did a terrible job interviewing kris 1 Asking sensitive question repeatedly and u can tell he wa awkward 2 Did not research before the interview 3 11 Members Did not no he wa a rapper in the group Please do ur homework before hand it â€™ s embarrassing
Lala JG	Not even a whole minute in and the level of unprofessionalism FAR BEYOND Man who let s this dude interview people Terrible way to approach the question and the fact that Kris is kinda awkward make it even worse
Jimin's Shiteu	I m sorry if i m offending any one but i think this interviewer asked kris many question about private thing like about his dad like he wa pushing it and you can tell kris wa uncomfortable while answering
Ezmer	I m just happy exo and kris are chill with each other it just SM ğŸ˜’
Ellen Junhae	I seriously love Kris and he s also from Canada yasss
Qian_qian	Is it only me who find this interview really awkward
HALI	I hate this interviewer the awkward gap of silence
Shimmie Shimmie KokoComeback where are you	Why the fuck he s asking all those dad question what s wrong with you man
HOI YING MA	Haters only know his name but know nothing about his story
KO KO BOP	OML WHAT KINDA QUESTIONS ğŸ˜
My96 Moments	HE DOESN T KNOW HIM MATE GET OVER IT THIS AIN T THERAPY THE INTERVIEWER IS SO RUDE IT S UNBELIEVABLE
Bundle of E'dawn	He s so adorable I miss him so muchğŸ˜­ğŸ˜­ğŸ’•
-SUGA addict-	smh the interviewer shouldn â€™ t have been prying at kris for stuff about his dad but I â€™ m glad he wa able to handle everything well and he deserves so much ğŸ˜”â¤ï¸
Limario	I miss you Kris â¤
frixikwon the most beautiful author	I m so sad about his dad but he look pretty fine
AgustD Suga	I mean why you got ta keep asking him the same shit you literally can see in his eye that he doesn â€™ t like the fucking question when he said he never met him mean he never did why you got ta keep pushing like wow you never met him like it â€™ s a big dam deal smfhğŸ˜’
yanlingmarsh	Kris â€™ s new album Antares released 2 November 2018 on iTunes a very unique album that you should have it you won â€™ t regret
Ê• â€¢á´¥â€¢Ê”ìœ¤ì•„	I m chogicrying
Rad Lord	I â€™ m cry so much my ot12 heart â€™
dotokkidoki	the way he talk about exo ğŸ˜­ğŸ‘ğŸ» i love you kris keep doing you ğŸ¤ğŸ»
96NightRider96	Well I ll see you in 2022 when the contract is null and void and we can get the full story without risk of backlash from SM
yanxoo - elaine	I ll never stop supporting and caring about you Kris â¤
525 000	The real reason he left is because he know he will earn MUCH more in China where the market is bigger and he doesn t have to share his money with 11 other people
Worldwide Handsome	He s a amazing person a amazing artist I love he s song so much I really appreciate and admire him you can see that he is grateful for everything he know the beginning of everything and will never forget about nothing that s admirable â¤ï¸
aysha femin	Whats wrong with interviewer why he is obsessed with kris s dad
AlohaDiana	haven t seen mullet around for a while
Victoria-R .G	Yo this is personal ish man leave my boy Kris alone ğŸ˜
drewbrooks	Joining exo wa his biggest achievement the fact he left and thought he could do better alone is the funniest shit ever considering he ha no talent and the brain of a rock
R I T A	he â€™ s so cute when he â€™ s talking about thing he â€™ s passionate about i love him
xxjinn	Some question were kinda rude I love how Kris awnsered them in a good way
Alexander Chan	Man you are one disrespectful interviewer first and last time ill ever watch this channel
PeterPan Amy	so disrespectful
MURTAZA QURESHI	He ha changed so much Cant match him with kris wu of Exo
Kpop lover	The question that you â€™ re asking are so disrespectful
Josh wang	whats fucking wrong with the interviewerï¼ŸSTOP asking question about his dad especially when he said his parent got divorcedï¼ Im not a fan of Kris but the interviewer is so gross and offensive And for ASIAN kid and ASIAN kidï¼ŸWTHï¼Ÿ Thoses stereotype are really disgusting Plz do some work before interviewing the celebrity Stupid as
jxck lovable	i thought the title said Kris Wu talking about becoming a father ğŸ’€ğŸ’€ i wa liKE HE â€™ S GON NA HAVE A CHILD WHY HAVEN â€™ T I FOUND OUT â€¼ï¸
CameliaJDH	Idk what kind of scope the interviewer is trying to get out of the father issue It s not necessary at all If you are curious ask about it out of the interview I praised Kris for being professional and still smiling while answering It s hard for him to explain what he really feel esp with the EXO topic but my OT12 blossomed when he mentioned 12 member And I m glad he is saying the truth about no freedom in music the main reason he left He explained well regarding the whole situation Good job Kris Wu
å¾«è±ª	Yeah that time wa big yeah actually I cried after he said thisğŸ˜­ğŸ˜­
MissProducer 101	Kris is an angel ğŸ˜â¤ï¸
Random Panda	He is so cute in this video Almost like a child
Lizzy Pachuau	These question were too personal and jumped way over the boundary
Maria Clara Blanch	Im so sad with this interview Kris Wu is a very talented guy and this interviewer wa so incisive about his dad Kris cant speaks about his new song or his movie about how is your next work Because the interviewer only want to talk about personal thing that made kris become clearly uncomfortable My heart is broken I love you Kris â™¡ Sorry for my bad english im trying my best
Alondra Ceja	This voice is so sweet but the interviewer need class on how to interview artist ğŸ˜ª I feel uncomfortable with the way he asks question like he wasn â€™ t paying attention to what Kris saysğŸ˜ªğŸ˜”
Taekookie 05	I understand you guy want to know specific thing in his life but I feel bad for kris cuz these question are really uncomfortable ğŸ˜£
The Mole On V's Nose	Coming from the same situation a Kris I start feeling uncomfortable if people ask more than â€œ where is ur dad â€ It â€™ s pretty amazing how chill he answered those question cuz I â€™ d prbly be flustered and stutter a lot lol Could relate to kris so much cuz pretty much ye obv a a kid u do get jealous of others but then again u don â€™ t even know what it feel like to have a dad so that â€™ s how u get use to it lol
Prischa I. Rosthanty	You re so great I ll always love you and waiting every your comeback ğŸ˜š
Dia Sultana	What kind of person talk about someone s father or family like that in an interview about his career
Chanbaek Lover	I m cry right nowğŸ˜­ if you wouldn t be in the GROUP EXO I would really not gon na support you because I don t know you I feel happy that I met EXO and dig all their past happening and familliarize all of thee member s name and just searching and tryna find out why most of the EXO M member are leaving and even Kris is already not a member in EXO anymore or should I say he is already a former member of EXO every moment that they spend together with all of the member I treasure that so he should too Like most of Kris fan are EXOLsğŸ˜‚ we know Kris becausw of EXOğŸ˜Š I feel happy for Kris The interviewer really went to much in his private life HAHAHHA but I think it is better for u to know what really is his journey and we know that even year ha pas by he didn t forget where he startedğŸ˜Š LIKE WHAT HE SAYS HE DO TREASURES ALL THE MEMORIES BECAUSE HE WOULD T REACH HIS DREAMS WITHOUT THEM member Kris We love you and we will respect you like what we always doğŸ‘ŒğŸ˜Š we will continue to support you until the endğŸ˜Š
ttu tu ttu tu	Yes some of the question were a little too personal but admit it there s this tiny little voice in your head wanting to know the answer to these question Kudos to kris for being mature and a good sport ot12 ğŸ˜¶
Vivian P	i â€™ m not a fan of him a an interviewer he ha one tone with everyone he interview and kris seems really awkward because of him
Lara Army	I like hearing his voice
BEL	FEEL PROUD OF MAMA WU
jinsouljimin	this interviewer fucked me offfff
ç‹é‡‘æ˜Ÿ	ä¸€è·¯å‹‡æ•¢ï¼Œstep by step
shoucandy	OMG I USED TO NOT LIKE HIM ANYMORE WHEN HE HAD THE BALD HEAD STYLE BUT OMG NOW HE HAS HAIR AGAIN ğŸ’—ğŸ’—ğŸ˜­ğŸ˜­ğŸ˜­
latifah nuramadhani	I treasure every moment without that i would never be able to be who i am today so just part of my life Kris Wu
Star Buckssme	I can relate to kris I also never knew my real father or got a chance to see him even in picture My family never talk about him i dont even know where my mom meet him Whenever someone asks me about my father i got really sensitive and awkward because i dont know how will i answer them The interviewer kept asking him about his dad and kris is so uncomfortable I can feel what kris feel in this Such a professional for keeping with the interview
Ika Banjarnahor	Berpisah mudahhhh tak ada kamu dihidup ku aku mampu tapi percayalah menghapus kenangan kita adalah hal paling menyulit kan untukku Bener ga sih Bodo ahhh Pengen nyanyi ajaaa
Aly Loayon	why do i feel uncomfortable for him when they were talking about his dad i mean it kinda sensitive but he handled it so well
Ahripreety Nongmaithem	Love you yifan da â¤ï¸ always be the most gentle n cool guy
Catriona Jay Villarin	KrisğŸ˜­ğŸ˜­
Jay Zel Kim	I love you kris We miss you a lot especially EXOğŸ˜¢ğŸ˜ğŸ˜ğŸ˜
Ahmad Rifaldi	i wonder is kris father know that his son become an artist like now
chaerunnisa rezky	I mean ur question wow Kris u answer it really nice we miss youuu
woof baek	Smh the interviewer really didn â€™ t have to ask so much about his dad he clearly seemed uncomfortable
kir	damn that wa super invasive to keep pressing about his dad he handled it very well but other people might not it â€™ s shitty tbh
F 5	This is the worst Presented i have ever seen
Nadia I. Nitol	The fuck is wrong with this interviewer You asked him once and he gave you an answer FUCK THE MOVE ON Instead of focusing on his current achievement he kept digging at something completely unnecessary How do these people even get job Mindblown
Putri Nur Azizah	Don t you thing it s a little bit annoying but yeah congratulation kris answered it gently for you
riz	Dude at least do some research Isn t that like the basic of an interviewer
yeahitz lmao	I think the question about his dad were quite unnecessary he wa obviously uncomfortable answering them
BÃ­ch Jiniee	Love you Kris ğŸ’“ğŸ”¥
Pear Nitcha	Disgusting question
JigglyChocolateman	I hate when interviewer push really personal question We get it it s interesting but shit man it his business Leave him alone about it
Dhanin Realiza	i feel like cry ğŸ˜­ğŸ˜­ğŸ˜­ğŸ˜­ that moment when he corrected him about ot12ğŸ˜­ğŸ˜­
kaychun515	it s pretty rude to ask these family question actually
melody ladio	he is my first bias in EXO and even he not in EXO now i still support him coz he just do what make him happy and thats what matter the most
NÉªÉ¢Êœá´›ÉªÉ´É¢á´€ÊŸá´‡	This interview is very awkward He did the same thing to Jay Park but they were very nice
Another pinocchio	Why would you repeatedly ask him about his Dad He looked uncomfortable
SONA THOMAS	Awkward personal question
Sivya EXOL	don t blame him for leaving EXO everypne even me my ownself would do the same for what i like and my own freedom
youngin	if he really didn t wan na talk about his father then he could ve told vlad to switch up and find something else to talk about it ain t the interviewer fault even though vlad is a fucking fool with his question sometimes
Ngan Nguyen	please just stop mentioning exo
selene Morreth	Why is he digging into his privacy much like ten question about his dad He declared once and that s enough That s bad and awkward Yikes
Edith balicwey	kris wu I wish that someday you will return in EXO team performing together
nazaiya	Oh my god why is the MC s question so insensitive It s hard to even open up like that even with people you re close with but this And it s a bit awkward too like the MC doesn t respond back to Kris well or he sound like he want to proceed to the next question asap Anyway Kris is amazing and he ha worked so hard So proud ğŸ’•âœ¨
Aeris Sy	Kris and I have a almost same situation about Family He grow up without a Father nad never meet him while Me I grow up without a Parents but I Meet them they have already their own family It just make me sad bcoz how come they can be happy meanwhile me and my big sister grow up without them especially my Mom My Mom live far away from u and my Dad same place with u but need to take a long ride lol still Kris you re still lucky bcoz you have your Mom
tisxx xx	Milla Jovovich walked away when interviewer asked bout her dad She just slammed the glass in front of her and go this is rude when people dont want to talk bout personal thing but u keep pushing him
xixi miss	What doesn â€™ t kill him make him stronger Be a fair audience before you talk
Carissa Francis	Omg the interviewer is just like unneccesarily asking him super insensitive stupud question about him and his dad
Keila Cabrera	We love you and support you kris
nobi dolo	My heart meltsğŸ˜­
moore XBJ	Looking forward to the new album My fanfanğŸ’‹ğŸ’‹ğŸ’‹
å¼µé›²ç¿”	These question are disrespect to him Kris you are the good singer so keep going hope you have a wonderful day
Krizzia Agripa	AyO wAsSupppppp Never forget
nobodylikes mycomments	12 member in total ğŸ˜¢ i wa a rapper in the group For some year I ve been ignoring his feeling and sort of hated him for leaving but now I feel sad watching this it must have been hard Fighting Kris I hope an ot12 reunion happens
kim fxnrxh	The interviewer should at least do a background check on him before he start to interview and I really dislike his way of questioning and it s so unprofessional Kris is a nice sweet guy and he deserve a better treatment
Swen Li	love Krisâ¤ï¸
Skyblue Icecream	his me and my dad is rlly cute and reminds me of his cute side
shbis	why is he prying on his private life like this it insensitive and unprofessional please talk about his album and his upcoming project instead
tiara amanda	I am also curious abt kris wu family But this is rude Leave him alone
Chanyeols muscles got that POWER	Sorry interviewer guy but the fuck wa it necessary to ask that many dad question And you ended up with EXO wow i m just amazed how dumb a interview can be XD Stop digging in the past and promote their current carrier music and stuff
ì¼€ì´íŠ¸EXO-L 1485	My OT12 heart â™¥ is ğŸ˜¢ ğŸ˜£ We miss you Kris ğŸ˜£ğŸ˜­ğŸ˜­
Infinity Alexx	3 00 damn He just explained my life lol But it wasn â€™ t divorce since my mother and father weren â€™ t married And I didn â€™ t move Oof
chicago child	ru sub pls
BlackpinkBlinks InYourArea	May 2014 I remember that day he left EXO and me my cousin cried all night ğŸ˜­ğŸ˜­
Skye Strauss	i love this baby boy so much it break my heart that the interviewer thought it wa okay to dig into his personal life like that Gtfo
Amy Guo	thanks
GOT7 And BTS is Snatching people wigs!	KRISSSSSS ğŸ˜ğŸ˜ğŸ˜
:/	kris is so cute and polite sksjsksk
Jamaica theramore	we miss you kris we miss ot12
Sehunnie's Potato	Wow all this talk about his father is getting too personal like he said he ha no contact that should be enough why are you pressing on to that
Kpop korean Stuffs	I just miss him so much I really want him to comeback to exo his smile is hiding a lot of thingsğŸ˜­ğŸ˜­
justzzzz	Lol is this like an english version of radio star
Joy 88	Kris 12 MEMBERS IN TOTALğŸ˜­ğŸ’–
skarreut	did you know what privacy mean dude
Diana Day	SWAG YI FAN the way he reply every question very gentle even for sensitive question Respect you King ğŸ˜Š
Andi Delilah	Kris EXOL miss youâ™¡â™¡â™¡
Mi Mi	Mi bebe â™¥ï¸â™¥ï¸
ì˜ˆìœ¼ë‹ˆ	ë‘˜ã„±Iã……Hã„²I ì•¼ ë‹ˆ ì–´ë””ê°€ì„œ ì—‘ì†Œ ì–¸ê¸‰ í•˜ì§€ë§ˆë¼
INANG CHEN CHEN 94_21	We love you krisğŸ’•You we know and a sad truth that you left at exo but we will still your fan we still love you and support you thoğŸ–’ğŸ’•
Madalina Maria	My parent are divorced ever since I wa 2 year old and my mom raised me and my sister alone That interviewer is kinda annoying I m saying this because I know what those stupid question can make one feel like He s asking too much You should ve stopped when he said they are divorced because he obviously wasn t comfortable anymore Disrespectful
the statue jin kissed in blood sweat and tears	YEEH
zhuzhengting is goddamn bottom	I swear to my religion this interview is damn disrespectful If i wa kris i dont know how long can i calm for these question about his dad It wa a bad memory and he never want to talk about it again and the interviewer just asking about it
Chika Laurentia	yeahhhhhhh yeahhhhhhh kris wu
ë¼ì˜¨Ra On	I love this boy so damn much He is amazing like really look how he kept his smile on his face even though those question were a bit uncomfortable Kris is so strong and he deserves everything he ha today and even more I am glad to be able to support such a great man My boy Kris my Galaxy my Yifan I am so proud of you and I ll support you no matter what Good luck I love you â™¡
Andrei Marie Habuyo	when kris leave exo i felt bad but i think you just follow your heart and exo l will just support you always
Amber Lee	Interviewer is really dumb as
idazzling fangurl	just when he talk about exo my heart ache Someone call the doctor pls
æ˜³æ¾„	å“¥å“¥åŠ æ²¹ã€‚æ¯ä¸ªä½ éƒ½åœ¨
Aphrodite Angel	YeahğŸ˜‘ I don t like you questioning Kris about his father it s kinda awkward duhhh
sara naza	That time it wa big â˜•â˜•â˜•â˜•â˜•â˜•â˜•ğŸ»ğŸ»ğŸ˜ğŸ˜
Kayleigh Soriano	LISTEN TO HIS VOICE WITH HEADPHONES Fuck it an asmr bitch
Mr. Pepper Roni	Guys dont speak for him Ofcourse it wasnt on the spot interview It wa pitched in to him prior Thats how it work
Yohana Mian	tf
no one xiv	I don t know but shouldn t the interview focus on his music not on his personal matter
ONCE isenough 4 TWICE	Wtf why need to ask about his dad that much ğŸ˜­ and hearing him talk about exo My ot12 ğŸ’”
Yazmeen Villanueva	Why the pressuring question about his father He stated in the beginning that his parent were divorced when he wa little why should it matter why would he want to rekindle soemthing that never wa I really dislike this interviewer
BTS JON KOK LOVE	love kai xiumin Soho
pcy park	my strong manâ¤ wish you always happy kriswu â¤â¤
Della MÃ¡i	Why Kris get asked more about Exo than Tao Luhan Because every time I look up kris it â€™ s always someone bringing up exo and mind you they went from bros to now stranger but when I look up Luhan Tao it â€™ s rarely anything about talking about exo Why is it only haunting kris Low key I started listening to exo a few month ago Because I found out he wa a Scorpio and his birthday 3 day after mine just to find out he left ğŸ˜­
Elin Li	å¿ƒç–¼å´äº¦å‡¡
lucky surya	I guess it s not only me who uncomfortable with the headline and the question but for the most I m happy for you Kris seriously all the hard time you ve been through took you to another level which is good I m glad you life comfortable now and how much I adore you to answer those question Stay healthy KrisğŸ’šğŸ’šğŸ’š
Yan Yannie	ğŸ˜­ğŸ˜­ğŸ˜­ğŸ˜­
Qtzi U	Actually I like that he talked about his mom My favorite aunt Was more of a mother than my mother raised her son without his father He â€™ s now a marketing trainer He is a strong resilient man because of his mom I think it â€™ s sweet
spp nbv	the interviewer is a bit awkward
shannen ericka	50 English 50 YEAH ğŸ˜šğŸ˜‚
Lu	well this wa awkward ğŸ’€ anyway love u kris wu THAT ALBUM DROPPING NOVEMBER 2nd
Kai Kim	Kris hyuuuuuuungggg ğŸ˜­ğŸ˜­ğŸ˜­
mikasa akemii	Man stop askin bout his dad It hurt u know Just stop He s smiling that doesn t mean he s comfortable
Bumi LT	Exactly when exo is being brought up Kris smile disappeared ğŸ˜…
Want to watch P0RN? Search EXO - KOKOBOP on youtube	He s so polite
Beep Beep Imma Dragon	I love how his sunglass coordinate with his shirt complimentary color work so well when done right ğŸ˜
10 piece mcnuggets	oh my god you can â€™ t just ask people what happened to their father if they weren â€™ t present in their life jesus the first portion of the interview wa far too prying at least ask the initial where â€™ s your dad but damn he really went in very very disrespectful
ç½—èŠ·	â¤ï¸â¤ï¸â¤ï¸
Marsaline 7	Oh boyâ˜ºï¸
ç‹çƒ	nice boy
Smile Bright	He s doing so well so proud â˜º
Regular Huh	CHANGE THE TÄ°TLE RN please
Brittany Blessed	This is America you guy are mad about the deep question but you know nothing about this man channel he always ask deep question and some are uncomfortable this isn â€™ t kpop or even China American interview are super open and deep so kris or anyone else should do research about the show they are going on before accepting to come If y â€™ all want baby question and elementary answer then don â€™ t watch this channel or Wendy Williams or the breakfast club or basically any American show
kuroraini	these question are getting a bit too personal
Long Sotheary	OppağŸ˜˜ğŸ˜˜ğŸ˜˜ fighting U are always shine bright in this universe coz just not a star u are the galaxy
Ant-Man	What s up with the daddy question
Tori L	Hes not a kpop idol anymore He wa already aware of the question beforehand otherwise he wouldve stated he wa uncomfortable If Kris wa okay with it we should be This interview is pretty tame composed compared to a lot of american interview Yall needa chill
Oop Ireallywannacry	Man is it bad I cried during this whole interview I love kris so much it hurt so bad when he left exo but to see him flourish and be happy make me happy I â€™ ll always support the boy who left I love them so muchâ¤ï¸â¤ï¸â¤ï¸â¤ï¸â¤ï¸
Khadijah H	omfg why do you keep asking about his dad he clearly DOES NOT want to talk about it or have nothing to say about it
Huiphoria â€˜	I understand you guy don â€™ t like how the man wa asking him question but you guy also have to understand that this is how he asks question to every guest he ha and more than likely kris and his management know this They must have agreed to what is okay to ask prior to doing the interview because that â€™ s how these work Just chill he â€™ s a grown man and can make his own decision
tacky and fabulous	Lmao when he said exo wa big at that time Is he saying they aren â€™ t big anymore ğŸ˜¬
EYA_EXO-L	I love u kris ğŸ˜™ğŸ˜
Shinxran9111	This interviewer rly annoyed me omg Talk about insensitive smh half the video wa like about his father that he DOESNT want to talk about and making him uncomfortable ughhhhh what an embarrassment That guy better be switched with a new guy So terrible Kris is so strong and patient I would â€™ ve just told him to shut up and not to about his father
Rameena Sahibzada	Is this interviewer dumb a fuck He need to stop asking sensitive question
Officer A	This feel wrong man It feel like watching someone force someone to be naked It feel wrongggg Soooooooimout
lee taemin	ot12 forever
Marianna K	I don t know why all these question about his father tho
Giselle Ontuca	Whatever you want to do a long a you are happy and it is good for you lot of EXOLs will support you
sea	i love kris but whenever you interview someone associated with the kpop industry you are so invasive it s not cute
jackeline vargas mendoza	â™¥ï¸â™¥ï¸â™¥ï¸â™¥ï¸â™¥ï¸â™¥ï¸
ìš°ìœ ë°°í† 	I got ta admit those question were too personal
Sky Up In The Sky	EXOTIC HERE
Britt	This company in Korea
sangpuii kholhring	Stupid interviewer How can you keep on asking about his dad when he s so uncomfortable u should know that even from the starting asking once is okay but why forcing him to reveal so much he s a celebrity and u must respect his privacy Dumbest interviewer i ve ever seenğŸ˜¡ğŸ˜£ğŸ˜¤
Slam funk	chong chingn chang phong tong pang
S Lee	With a loving and caring mom Kris ha grown into a great fine man and a very talented artist Looking forward to Kris â€™ new album â€œ Antares â€ coming out on this Friday Music doe not have any border It is a beautiful thing when good music is heard and appreciated by a lot of people around the world
coolkies21	â€˜ they were big at that time yeah â€™ 2018 they are still huge i miss OT12 day TT
Donnamark yang	We know kris miss the Exo member they wa close and good friend I hope they can meet each other again
Aissa Nadjiam	I had to skip the Dad topic love him lot
Carly Raimey	I felt so tense watching him answer the family question but I also think some people are taking this out of proportion At any moment he could have said let s talk about something else Also important to remember these are question NOBODY asks him in detail so there must be a reason DJ Vlad wa asking them in order to give fan answer judging by his expression and response it potentially wa uncomfortable for him but Kris is a grown man and can handle a some pressure We dont need to treat him like a baby he isn t one Overall good interview thanks for the upload
diana casados	Very humble I love and will always support you KrisğŸ’œğŸ’œ
Swey Wayne	Wtf is wrong with the question Why doe he keep asking him about his dad
chenles screeching is my national anthem	Kris ha such a good personality I m glad he got out of SM and succeed â¤ no hate on Exo i love them just SM doesn t treat there idol right which is honestly painful to see and if you don t belive me look up Ncts manger treating them wrong
Army Blinks	I love him even more now
Jade 2muchSauce	I love Kris with my whole heart but those hair are hella terrible please baby change them and start to shine again â¤ï¸â¤ï¸â¤ï¸
KY0627 KY0061	I love you
starving cat	Even if the riporter asked stupid and unrespectful question he smiled so brightly all along I love him so much i can t even express how much
Ruatpuii_Rp Rp	Talking about exoğŸ˜­ğŸ˜­ğŸ˜­
KhadijatheproudEXO-L stan weirdos	look like a talk show for private life is it really like this I m thankful to this video bcoz of this I love Kris even more cause I know he s still cherish the memory he had with exo but what got me is the question is like a shark in a small fishpondğŸ˜±ğŸ˜±ğŸ˜¨
Francis Ann Amor	It wa quite disappointing that the host put too much attention about Kris father and how he didn t get the sense of changing the topic It make me sad in Kris part though and he is obviously not comfortable about that
Samruddhi Gudhe	The interviewer is doing such a bad job It s a miracle that Kris wa being so patient n understanding with him
Murky_doll without_heart	I dont know my father too My parent divorced when I wa 1 5 year old Then he dissapear Kris you are strong And wonderful person with bright smile And extremely dark hot aura
xaxa	i just wan na hug him because this seems more like a fiery interrogation rather than an interview like dude can you try to be a little le insensitive and in his face about it
Khun OC	VLAD WTF MAN HOW MANY GODDAM QUESTIONS U GON ASK MY MANS KRIS WU REGARDING HIS FATHER U RLLY TRYNA MILK DAT DAMN SMH
Ester Margolis	You can tell by the way he talk about exo it still hurt him what happend with sm
BLOSSOM LARRY MUEMA	Am sure Kris approved this question it happens before interview people ğŸ˜­
Mariya EXOL	I don â€™ t know how kris felt but I â€™ m fucking feeling uncomfortable right now watching this
Astro Bear	Yeah i don t think that the question were very well planned Maybe asking briefly about his family but if he say that he grew up with his mom then maybe asking about her why ask about someone that is not even relevant to his career and life I understand that people want to know about their past but it even seemed a little bit rude idk
O.P.1090	that wa awkward
Anna Lewis	this interviewer wa kinda nosy lol but it wa really nice to get to know a bit more about kris
Naw Ra	I miss my chicken is not my style guy kris wu
DaReoCharmer	He wa pretty good in xXx
Juliana Reiterer	Although i â€˜ m not an EXO l since OT12 Time I really do miss him with the member But we can â€™ t change the past EXO L will ALWAYS Love and Support you You have a big Fandom behind you â¤ï¸
The Dragon	Not having your Dad beside you from childhood is quite painful Though he s hurt he did t show up during this Interview I mean wao
super sa	The interviewer is really rude I bet he wouldnt be like that to a white celebrity You dont have right to dig into his personal family life like that
sofia	love this guyâ¤ï¸
Elina Mareta	I am proud of you Kris
Alya DIABIRA	i liked kris wu since exo he s amazing
fraai	interesting guest nice
swimablecorn	This Buffalo rolled far and I m proud
Mikail yamaÅŸito kombamba	how sound his accent to native good or bad
Yane Chelsea	This question about his father kinda awkward ğŸ˜‘
Meigeni MThu	We are proud of you Love from Vietnam ğŸ‡»ğŸ‡³â¤ï¸â¤ï¸â¤ï¸â¤ï¸â¤ï¸â¤ï¸â¤ï¸
Muhammad Latif	You are very good man Kris thank you for your song
devil tilija	Is he still close to ex member
Jearean Mae Mayan	When will Legend of Ravaging Dynasty 2 will be finished Lol
sarah Hamoudi	You did well kris
nctwangjaenim	Geez Did you really have to ask him the detail about his Dad He already answered that he basically doesn t know that much about his Dad wasn t that enough The question were all kinda disrespectful about that
yehet	i love his â€œ yeah â€
goku son	I wanted to know more about kris wu than his relationship with his father weird interview
Arum Dayama Praniti	I love him just the way he is ğŸ˜
Lola Philippi	He wa so freaking nervous while talking about EXO
Sueaz Libe	Stan SF9 http youtu be rQ8MFfg3DHA
park chanyeol will you marry me	wow he really need to wait for EXO to comeback to do this interview good job man
jie lin	Kris Wu fighting
Yifan Wu	I think it â€™ s sooooooooo rude to ask about others private lifeğŸ™„ğŸ™„
pcys black hoodie	I can t help but feel bad for him semms like he still can t talk about those sensitve topic fully comfortably Vlad also seemed a bit insensitive with his question but Kris stayed humble and respectful people need to stop bringing Exo in every damn interview he make I m an Exol myself and that shit is annoying tf out of me ooff move on
Elle Zee	Wow awkward Why is the interviewer probing into such personal matter That s kind of rude I bet Kris wa really uncomfortable That s the kind of conversation you have with people you are close to
Diana K	His smile ğŸ˜
Elisha Gift Gomez	Now i understand why I still love you b I just wish you could have stayed longer but i respect your decision I wish everyone is given a freedom to choose what they love Change your way Kpop industry You might lose really good artist because of this type of issue
Let Me Be ViVi	Kris and his dad me and my dad
ILove JHope!!!	My god this interview wa so awkward and cringy Why such personal question about his dad It s no one s business
Sarang BTS	There â€™ s no privacy for his life all of them wa like how did u start when did u join exo after u left what did u do where did u go like what I thought he wa going to ask abt music and his album etc
Zen Espinoza	wow just woooww
Nadz Amilasan	the interviewer wa so brave it requires a lot of courage man
Hareem Bostan	The interviewer is kind of rude to Kris He shouldn t be talking about someone s father like that
Sehun's Rainbow Hair	When I saw that he wa going to talk about EXO I felt really happy because he will always remember his team
elle	Kris WUUUUUUUUUUU
teenpm838	Finally kris is talking about Exo he always avoided question about it
dhewi casso	So sad to hear about his father I always curious about his dad It s like what i think i always think is his dad and mom divorce Bcs he never said about his dad But now we know the real story ğŸ˜­ğŸ˜­
lh7 trash	Damn this interviewer is so brave Wow
Chung HoÃ ng	Love you like that
Kathleng Tuleleng	ot12 feel
Thammy Vo	Interviewer would benefit from interviewing course Never seen Kris so uncomfortable It go to show doesn t matter how sucessful one becomes all grown up their childhood can still affect them deeply
åˆ˜ç¾ä¿	okay but the question about his father were waaay too personal and really unnecassary
Luhan's Han	I love him That s it Anyway I skipped the interview about his dad bcs you know if the interviewer doesn t know this I still respect the word PRIVACYğŸ˜ Ah but his laugh at 6 02ğŸ˜­ That heheğŸ˜‚ğŸ˜ P S Pre order his new album now It s called Antares
Max Jia	why is he always tied with exo especially interview in America like every single oneğŸ˜•
Flames	I hated to see Kris so uncomfortable while the interviewer keep asking about his dad
ellis	he obviously isn t comfortable talking about his dad why would you ask him so muchğŸ’€
Duyun Dong	Kris always look on the good side of everything I guess that â€™ s why he can gain power from the past and keep moving forward all the time Really respect you I wish all the best to you
Infires Taekook	Handsome face and great personality
Mango Touray	Kris wa an exo member
luna	The family question were a bit too much
Sonia Maria Nistor	He really knew how to answer these question diplomatically but some of this dumbass question are ridiculous I â€™ d probably loose my shit if i wa him but no Kris Wu is Kris Wu ğŸ’ªğŸ’ªğŸ’ª
Ryan Holland	This wa the worst interview ever smh it wa obvious that he didn â€™ t want to keep talking about his father but yet it kept being brought up The question were awful smh
Daisy Liu	Obviously he ha an good mother and ha a deep influence on him I really like him music especially lullaby
Zaldy. S334	knpa bicarain ayah nya sih anjirr
zkdlin Kai	Atleast he still treasure his experience in EXO I will support him no matter what ğŸ˜ğŸ˜
CasaKPOP	I definitely love that Kris is being known not only in the Chinese music market I am so proud of him I love that he is collaborating with artist like Jhene Aiko His music is so awesome I love how he is bringing American music hip hop and Asia together I ve been a fan of his since he wa in EXO and even when he started his solo career
Xiumin	Miss OT12 ğŸ˜£ğŸ˜£
Rhea June Mabaylan	I wish you all the best Kris ge Thank you for everything and goodluck with your new album I look forward to it Can t wait to listen to you Do it your style take care always
GOLDEN -L	WOW OUR BOY IS ALL GROWN UO GOOD ENGLISH THERE
Army Till The End Of Time	this is the most awkward interview i ve ever seen in my life and i m very sorry it happened to kris a lot of couple get divorce a lot of child grow up not knowing their dad or mom so why do you seem so surprised why do you keep asking question abt it even a blind person can tell he didn t wan na keep talking abt it and it wa pretty disrespectful and for the record 6 1 is considered tall everywhere not just in asia sorry but you re a bad interviewer
fah sai	â¤ï¸â¤ï¸â¤ï¸
t m	Wow those were some great question
Josephine Deng	Very good interview actually
nour chaker	The question seem to not really respect his privacy It s not good to ask peaple question like that
VALENTINEB0Y	Yall got no respect for privacy
dancing star	Anyway i love u krisğŸ˜š
Tracey Hayes	3 minute of him asking about his father is not cool anyways Kris good luck with your new album
tell me what is bias	support Kris on his Antares Album it ll release on November 2 and it going to be a bop
TaeTen Jaeno	Kris Wu Director producer Singer Songwriter and Actor Active in China
Rara Azura	Please make Kris speaking Korean again
Holdup	Vlad not everyone grows up with two parent lol he act so surprised
Kpop Oppa Sehun	Ø§Ø±Ø¬Ø¹ ÙƒØ±ÙŠØ³ Ù…Ø´ØªØ§Ù‚ÙŠÙ„Ùƒ Ø§Ø±Ø¬ÙˆÙˆÙˆÙƒ exo ğŸ˜­ğŸ˜­ğŸ˜­ğŸ˜­ğŸ˜­ğŸ˜­ğŸ˜­ğŸ˜­ğŸ˜­ğŸ˜¨ğŸ˜­ğŸ˜­ğŸ˜­ğŸ˜­
Thanh Lam LÃª	I hate how the interviewer didn â€™ t do any real research on Kris Wu and EXO before interviewing him like you might not know who he is but Kris Wu is a big name same go for EXO The whole interview came off a super unprofessional for me especially since the interviewer went into some really personal stuff and say thing like â€œ asian parent and russian parent are kinda similar â€ i wouldn â€™ t imagine otherwise since if you â€™ re talking about asia that includes russia a well Kris handled the whole interview really well he wa chill yet strong the whole time and I respect him for that Good on you Kris
xiuamy	excited for kris s new album antares ğŸ’—ğŸ’—
*Ò“á´œá´¢á´¢Ê ÊŸá´á´ á´‡Ê€ á´‹á´˜á´á´˜*	nnnnnnnnNOPPEEE
my name is	peh lain sia muka
saraa lee hunny	Is there someone who think the same a what I think he still need the exo name to carry exol on every cb
Yvonne She	We will accompany you forever â¤ KrisWu
Gum Bee	The interviewer wa so fucking annoying
Sangita Shrestha	0 57 emotional Kris
Kjsmoov	the interviewer is fuckin awful
Fata Rehn	Now we know FOR SURE that he keep his memory with EXO a a treasure He appreciate his moment with EXO In my opinion Yifan think that this is the perfect time to him to say what he really felt about him a an EXO member without create any scandal So whoever who called him a traitor please stop it He ha reason okay he want to develop his talent and style And also for his family too Lets support him â¤â¤
Valery Kos	Wow the question about his father were completely inappropriate
feary chen	he is so cute
Lira Bermas	WOW OMG KRIS OT12 EXO E X O YOUR BROS
é™ˆæ•	he is a cool boy
Brittany L	Kris is so humble and laid back ğŸ˜ğŸ˜
Chennie kim	Kris album will release in Nov 2 the same day of EXO s comeback
dir-exo-ner	the title really piss me off we can all see how awkward kris got while asked about his father you can clearly see that he wa somewhat upset talking about it even though he wa smiling like can they not understand that this is a very sensitive topic it s so fucking insensitive to ask someone something like that i got so sad i love yifan with my soul and it bother me to see ppl be so insensitive towards him and get all nosy about his personal life
Minjinsor Ganbaatar	Glad he is doing well and do what he wanted Go galaxy princeğŸ™ŒğŸ™ŒğŸ™ŒğŸ’ªğŸ’ªğŸ’ªğŸ˜ğŸ˜ğŸ˜ğŸ˜ I will always be your true fan ğŸ’•ğŸ’•ğŸ’•
sungieluv	Idono how this got on my feed but I kno who Kris is and his hardship in Korea But this is definitely the most prying interview he ha done He s so famous and well known This interview is way too personal Kris is alwsys very professional and with his fluency in English he can totally get thru it without being awkward but dang Interviewing a top star like this is kinda weird Like if ur a new fan of him wanting to learn more Idono if ppl wan na hear him have to focus on his parent divorce and how he grew up not knowing his dad and all that I mean people who kno him both fan and just others respect his privacy of him not talking about his personal life like this This is a really rare thing for him to broadcast this in this way
Cypress Lee Dulmigas	I â€™ m worried cause I can see that he â€™ s kinda nervous answering the question about being an exo member buuuttt I â€™ m proud of you fanfan of what you â€™ re in now I miss that lip ğŸ˜‚
Baekhyunee Exo	6 13 I M CRYIIING MY OT12 HEART ğŸ˜­ğŸ˜­ğŸ˜­ğŸ˜­ğŸ˜­ğŸ˜­ğŸ˜­ğŸ˜­
Iris Lou	woah this is so wierd kris wu used to be my good friend god brother
Abby Fernando	Did his English improve or is it just me
Happiness Delight	Wu na I m From China so â¤ I Love You Always My Kris Wu
Nouchee Lor	Haha I love how Chil Kris is 3
amanda x	He is tough enough for such mean topic I respect that
Nicole Magallanes	Kris Wu my bias in EXOğŸ˜”ğŸ’•
pencil 0126	why ask too much about the absent father it made me uncomfortable so kris must have felt bad what the heck
DONT MESS UP MY TEMPO	Exo l love you kris you always part of our big family We will support you and other too always be happy and keep smile ok we love u kris always remember that we are one okâ¤ğŸ’•ğŸ˜‰
Suho is Love	He s right
Aeri- L	They are STILL huge That s all I am saying
Just Chyna	Bro why tf are they asking about his dad so much Jesus Christ
Notice me Senpai	Ot12
eternalight0506	im so happy and proud to see where you at right now WE WILL BE ALWAYS THANKFUL FOR THE TIME THAT YOU SHARE A MOMENT WITH US WE WILL TREASURE THOSE GOOD TIMES AND BAD TIMES YOU LL BE ALWAYS THE KRIS THAT WE KNOW BACK THEN CONGRATULATIONS AND YOU REALLY DESREVE WHAT YOU HAVE RIGHT NOW KEEP IT UPğŸ’–
Dino Chen	You re the best my baby Kris â¤â¤â¤â¤â¤â¤ I â¤ U sooooo much I m so proud of you ğŸ’ğŸ’
haha t	hh
Lilly C	Talking with my Chinese housemate who s in UK for the first time Me mentioned Kris Wu Her Ohhh he s very famous Me yeah isn t he from Exo Her Exo who I don t know them but Kris is very famous Damn D
BamJIN GotBangtan	That deep voice KRIS ğŸ˜Šâ™¥ï¸ miss him ğŸ˜­ğŸ˜­ GALAXY we love you Galaxy Fanfan fighting
ColaKeiYing	The interview dude is so unprofessional n retarded What â€™ s with his dumb question
Mary Cepeda	5 36 Kris Wu explains NCT
à¸¥à¸¹à¹ˆà¸«à¸²à¸™ à¹€à¸›à¹‡à¸™à¹€à¸¡à¸µà¸¢à¹€à¸‹à¸®à¸¸à¸™	à¸„à¸·à¸­à¹„à¸¡à¹ˆà¸„à¸§à¸£à¸–à¸²à¸¡à¸à¸µà¹ˆà¸„à¸£à¸´à¸ªà¹à¸šà¸šà¸™à¸µà¹‰à¸™à¸° à¹„à¸£à¹‰à¸¡à¸²à¸£à¸¢à¸²à¸—
à¸§à¸±à¸Šà¸£à¸²à¸§à¸¥à¸µ à¸™à¸à¸—à¸­à¸‡	The question from mc is not good why ask like that It s enough he have a goood mom Love Kris wu so much Kris wu is the best
Aye Chanmoe	The interviewer should respect Kris s privacy As a fan I like Kris love his song and movie but don t want to know seriously about his family I hate that interviewer ğŸ˜ˆğŸ˜ 
Aaliyah Nicole Padilla	ğŸ’—
Dian Puspita Dewi	Why he keep asking about his father Obviously he did not want to talk about that
andres luo	Quien puede subir espaÃ±ol ï¼Ÿ
Cathy huang	I kind of share the same background Mom and Dad divorced when I wa 5 year old Sure it ha big influence on my rest of life I feel sad about Kris He never like to introduce this topic His father must have really hurt his feeling
Bae Ssi	He said he treasure every moment and without that he will be not where he is today
Brandon Leeâ€™s crazy vids	The interviewer making me feel uncomfortable man imagine the silence in real life if i feel this awkward through video
Kpop Maexo	We treasure you tooâ¤
jitlogs Jitlogs	why would he go there that wa a touchy subject
Sage	EXO L s WILL ALWAYS BE WITH YOU ğŸ’“
MoÃ¯rane dance	Honestly too much question about his father i can feel that he wa uncomfortable about this topic and rather than talk about his family situation I think it would be better to talk about these project in detail and these dream just my opinion ğŸ™‚
Jessica Nguyen é˜®å¸Œ	Kris is my idol and I will support him in whatever he doe He ha worked hard ever since he wa a trainee He trained four year to be with Exo and now ha left to do his own music I myself am part chinese and can totally understand his situation after leaving Exo SM Ent and Korea So let â€™ s all give him lot of love and support and buy his album Btw I really don â€™ t like the title of this video I feel like their using it just to get view Also it must have been quite difficult for him to answer question about his past with Exo because there â€™ s prob a lot of information he can â€™ t mention and also very awkward to him
giovanni dinda	6 09 exo
rykrae	This interview is so fuckin nosy Feels more like a paparazzo stunt than an actual fucking interview
Sweetbaozi_99 Kim	We miss you KrisğŸ˜¢always remember that no matter what EXO L s are always here to support you For u you will always be our EXO M LeaderğŸ˜‰LOVE YOUğŸ’‹
Zackie J	He s not supposed to ask his personal life bcause it s a pain one ğŸ™„
YOMOMOMAMA	Vlad you a bitch trynna always dig up dirt from people fuck u
mary rose barrientos	i really miss kris wu
Huy	mÃ¡i tÃ³c bá»±a vcc
H. L	Antares coming soon Nov 2 Stay tuned plz
Mike Sheridan	It s crazy that Vlad doesn t have the same reaction when a black dude say he don t know his father ğŸ˜ğŸ¤”
Starry Jewel	ğŸ’•ğŸ’•ğŸ’•
choco mint	we been knowing his dad wa never around notice how he turn the question about his mom
Sandy He	dude you spent 40 of this clip asking about his father when he already told you he wa never there what doe that have to do with him making music and breaking into the hiphop scene i just don t get it can you chill out and start asking relevant question like do better research
claras	woah these are some real personal question
Aishwarya Shah	asking about dad and piling up question about his dad is too much thats stupid the question were so stupid like there is thing called privacy dude
Obey The Sun	So now yall bringin kpop weirdo here smh vlad I would smaick the shit outta of you
the technicstechnishion	Have no clue who he is
imane Exol	KRIS I MISS UU OT12 FOREVER
Nam Kook Bang	I lost count on how many time Kris said â€œ ya â€™ know â€ but yeah he really improved and im happy that he â€™ s comfortable to talk about his past â¤ï¸ gon na wait for his album
Chim da Mochi	Interviewer So what s the last time you guy actually talked Kris in his head Yeah well I guess the time I had this really deep conversation about life and stuff when I wa about 0 2 year old yeah
Bahar Ramadani	What a sweet gentle soul
Lordpraisethe	WOOOOOOAH
Lenna h	Oh my god why the fuck did they focus so much on the dad it s like a fourth of the video leave it alone dude
MRH 92	My EXOğŸ˜­ğŸ˜­ MY OT12ğŸ˜­ğŸ˜­
LalÃ¡	all my love and respect for him â¤
disney chanyeor	WAIT KRIS WU KNOWS JAY PARK HIT US UP WITH A SONG PLEASE
XIV Gothica	my boy wa attacked with personal question but he did well
Majesticool Muffin	The MC asking the question is TERRIBLE ok ok ok ok dad dad your dad ok dad ok stop asking about his dad that s such a personal and awkward topic MC made this interview so awkward like what the heck Kris deserves more respect than what wa given here This is stuff Kris can talk about with his friend if he want but prying personal information out in this interview
Shine On Em	Tough one
Purejoy Ogunbiyi	This interviewer is asking kris the most rubbish question ngl I just want him happy ğŸ’–ğŸ’–
Seeking Knowledge	Rude interviewer
Vera Grassi	Ğ¡Ğ´ĞµĞ»Ğ°Ğ¹Ñ‚Ğµ Ñ€ÑƒÑ ÑÑƒĞ±
Tessa Jade	Why doe this feel like an interview for casting porn ğŸ¤£ğŸ¤¦ğŸ½â€â™€ï¸
Sasha Feria	4 00 to 4 07 BIG ASS MOOD LMFAOOOOO
oh eunwoo!	4 39 is where he start talking about the sm audtition and exo
Altaire Versailles	Vlad s clickbait he chose for you to get you to watch this wa Kris Wu on never knowing his father If you simple minded as dummy dont realize Vlad is making fool out of you nigga daily I dont know what to tell you
Baekhyun's Girl	That interviewer is such a disgusting person Doesn t he have some emotion or something Instead of talking about his career or music he asked him about his father and past issue
sara C	These question were invasive Kris handled it all well tho But I hope people wouldn â€™ t ask him such private question Everyone who like kris miss him or is his fan please check out ANTARES It â€™ s dropping on Nov 2nd Finally he â€™ s having an album and you already know it â€™ s gon na be LIT
23slickid23	this nigga look like a pop start from the 80 s with this glass and haircut lol
Kylen Casteel	Honestly I don t know Kris very well I just know that he s an amazing artist who ha been though enough shit for an entire lifetime I hope he keep doing what he love for a very long time
Nol123 Maisnam	Stay strong my king ğŸ‘ğŸ‘
ghrqueen	Those time are really beautiful a very beautiful memory Thank you for all the smile laugh and tear thank you for all the beautiful moment I m not a fan of you now but I hope you re doing well â˜º
Harshita Das	We love you Kris Exols always by your side ğŸ˜­ğŸ˜­ğŸ˜­ğŸ’–ğŸ’–ğŸ’–ğŸ’•ğŸ’•ğŸ’•ğŸ’•ğŸ’•ğŸ’•ğŸ’•ğŸ’•ğŸ’•ğŸ’•
DÎÎ”N	0 58 1 25 1 34 2 40 I don t think you can just ask that that s rude
Victoria SÃ¡nchez.	Ugh you can clearly say he felt uncomfortable But he managed to stay calm in some way I love how he wa so respectful and thoughtful of what he said Keep going I hope you always do well
Farah Nabila	The interviewer asked him about his dad When he said that he never met his dad you should stop asking more about it It look too awkward for me And Kris doesn t look like he like it
Regi Wu	I m a 6years Kris Wu yifan fan and it s my first time hearing him talking about his family life on public ğŸ‘ğŸ‘ğŸ‘ğŸ‘ he changed a lot wow good luck Kris I m so proud of you ğŸ’ŸğŸ’™ğŸ’œâ¤ğŸ’› Antares 11 02
namita singha	Man those question abt his dad just broke me n kris answering it with a smile
Vondy Adicta	I m so proud of Kris and his first album antares I can t wait
maria lee	this wa kinda disrespectful i mean exo AND his father why did he have to bring up the past especially his family it â€™ s rlly important and private to him i guess his mom is an amazing woman
Tee 357	I m assuming he never doe movie in America because I never heard of him ğŸ¤·ğŸ¿â€â™‚ï¸
sammy	y wa he so adamant on talking about his dad tho
kris's style not chicken	That interviewer made me angry like why u keep asking him about his dad
#ë§ˆë¦¬	This is the most awkward interview ever especially the start what kind of question are those
Oro The Nymph	Good luck Kris dear inverviewer y might want to work on your interview style which come across a incredibly disrespectful
Noelle	Proud of you Kris it must be hard to talk about all of this but I am glad you got to this point
Nancy Lei	I swear to God these interview question are making me so hella uncomfortable Like why force somebody to talk about his father if you can tell that he doesn t want to Like dude are you blind or just plain ignorant This is absolutely unacceptable and unprofessional behavior
Maral Imanalieva	â¤
Ice Joy	When will the part2 be out
ELLE SANTOS	Thats our boy right there But how come all the topic are pretty much sensitive one about his uncontacted father like wth man thats a pretty awkward question leaving exo deym x10 Anyway we will always support you whatever you do Kris getting through it all the harships thats our Wu yifan go get it mah boi
Magneto Kwa	Who the hell is this
Sanjana Simon	ONE OF THE MOST PRECIOUS INTERVIEWSğŸ˜„ğŸ˜¢
zkdlinexo _	FIRST OF ALL WHY DOES THIS INTERVIEW MAKE ME TEAR UP I mean about his dad and all it wasn t easy but you are doing great Kris keep it up
Charmiley Madamba	Hey all EXO L s eris out there am i the only one who cried when our galaxy oppa spoke about EXO ğŸ˜­ğŸ’– ot12 feel ğŸ’”
Abdalah Pulcra	cool dude
Sevan Almasoud	Exols are always with you
Jason Le	Without a father it â€™ s a lot harder for young men to move on to become gentleman
TheAshMaster1000	kris is so damn as cool
forKriswu Jang	thx for sharing expect Kriswu s album love his music so much
sinigang na kimchi	galaxy fanfan ğŸ’—ğŸ˜­ğŸ˜
Krystal ypr	l love Kris Wu
Aeri_Tempo_XO	We all know EXO is his back story n it ll be forew BUT stop asking him abt it on every intw stop making ma boy hurt n uncomfortable ğŸ˜­ IT S FOUR YEARS AGO COME ON LET S MOVE ON
That sensitive psychopath	When he say that sad shit about his dad while smiling that shit be breaking my ğŸ’“
O.L. Wilson-Marlow	This wa a bit left of uncomfortable to listen to Still love that Yifan is getting himself out there on his own
Alex Chen	He wa worth everything
SuperCaliFragiListicExpiali DopeShit	ğŸ˜‚ğŸ˜‚ğŸ˜‚ğŸ˜‚ This dude look like that Asian gangster from the movie King of New York who say I ain t no grease ball named Ardie Clay
Chanbaek's Love	I ve missed you so much Kris I m so proud of you good luck on your career and I got you back big man
WENWONJUNJEON	This interview saddens me but feel so proud about Kris All along I â€™ ve always been curious about Kris â€™ family but haven â€™ t been able to do some research about coz there â€™ s really nothing on the internet regarding about it but now I feel like Kris deserves all he ha now after all he went through in life â¤ï¸ Kris be healthy and always show that gummy smile to everyone ğŸ˜Š
Fitria AS	I miss you galaxy hyung
FinalxHearts	KrissssğŸ’™ğŸ’™ğŸ’™ğŸ’™ğŸ’™
jay Davis	Some how Vlad is softening him up to say he move brick of smack
yolanda finza	I MISS YOUğŸ˜­â¤
Vyka Wu	Kris wu is king u r awesome no matter what else those hater say there r huge army behind u and I am so proud be a part of that army
purpelle	That s too private Like can you just ask when his career first started or some sort Why continously ask about his dad Love you Kris I m so proud of you ğŸ’œ
Umi Wakhid	We are so sorry Yifan honestly after you not a member of EXO I m verry disappointed of you But now I understand what you feel Thanks for everything that you have to do with EXO I hope you and EXO doing big collaboration Be successful our Galaxy Fan2 ğŸ˜­ğŸ˜­ğŸ˜­ğŸ˜­
jian shan	Kris Wu ï¼So charming and cooooolï¼i love him so muchğŸ”¥ğŸ”¥ğŸ”¥
duan duan	â¤ï¸ğŸ”¥
MsZeeDot	Interviewer seems so disrespectful His tone that is
Mancy kk	I m proud of youï¼KrisğŸ’“
Yohana Zira	ğŸ˜­ğŸ˜­ğŸ˜­
Alice Monko	This is a sensitive subject He rarely talk about his father ã€‚
Intan Pasek	Its kinda annoying to hear the interviewer talking serious about his mom and dad being divorce He even didnt laugh when kris tried to laugh to make the situation not serious I mean Is he blind or something Look at kris eye he look uncomfortable with all of that question How disrespectful
XIUMIN XIUMIN	Please don t forget u EXO EXOLğŸ™
Steven	all the question about his dad his smile went from BIG to damn man my feeling hurt lol
Ayu Mutiaa	i love my leader
Alexa Mae Barroca	i m so happy that he know that the exo ha 12 member he remember it i m cry ğŸ˜­ i still want him to be part of exo my ot12 heartğŸ˜­ğŸ˜­
PCY Hanbin	huhuhuhu KRIS
Raven Jihyo	so much maturity in kris supporting you all the way
Felicia Felicia	my boy Kriswu â¤ï¸
Evan Sheng	Kris Wu
nguyen ngan	glad that you still remember EXO
Weirdlywired Exol	That is a very insensitive title I mean we really don t need to sensationalize everything At least leave people s personal life out of this
dyugh	Miss u laxy
Esra Uysal	Why so many serious stuff going on in this interview Anyway he s a strong man so even though he went trough hard time now he is comfortable talking about them Galaxy is ours Peace out my meiniggas
se hun Oh	ğŸ˜
xiumin toyourworld	I cried
McKenzie Hart	Great interview It s nice to get to know the artist a a person and how he got started I m looking forward to the seeing the rest of the interview
suho's belly button	Kris talk about OT12 cry in chogiwa language
yenicall xian	He is a very good boy I believe he will get what he want and look forward to his album Antares
yiæ¬¢	ğŸ•ŠğŸ–– fighting
EXO-L	Im not cry
artemis do	i miss ot12 i ll support you no matter what
Tia Sy	I m very proud of Kris to see where he is today
Iris Chang	Well thanks for having Kris Wu But to be honest I don â€™ t feel well about the title of this talk Cuz we know how much Kris ha been through with his mom Kris just let go of the past that â€™ s what ha made who he is today Finally first new album is coming on 11 2 this Friday Can not wait Much love baeğŸ˜˜
THE LOGICAL NEGRO	I watched this video just to see if Vlad the impaler would bring up some old beef that happened year ago and try to reignite it like he doe with Black people and of course he didn t
tamara sky	I m glad he learned English and changed his whole persona for himself
Rubisita Saori	Te amo Kris WuğŸ˜
Glitchy Glitchy	Why get on the interviewer s case for asking question He s not a child who need to be coddled and avoid topic about his past at all cost He wouldn t have agreed to the interview if he wa really that uncomfortable talking about these thing Past experience make a man who he is today
crystalrose	Thanks for asking about exo maybe I can finally have some closureğŸ˜
j w	Omg quit the Dad question okayyy Stop digging that past that he doesn â€™ t want to talk abt ğŸ˜¢
KateK	I ve been his fan since he wa in Korea Most of the fan know he is from a single parent family no us to ask that I dont see how it would help to promote the upcoming album I can tell that he wa a bit uncomfortable
Rio Santos	wow thanks for this wish the interview lasted longer been wanting to see him opening up on his personal side looking forward for more interview on kris really love this guy amazing talent ğŸ˜ŠâœŒğŸ»ğŸ¤ŸğŸ»
Yutaka Namikawa	Am I the only who noticed Kris still feel uncomfortablle when he talk about exo
BigBabyJesus	Wu
Forgi Wrist	Damn Harold Gloed Up where kumar at tho
Emily KS	This interview is kind of awkward You can tell from his face and reaction that he isn t quite comfortable with the conversation The interviewer is asking question that he doesn t really have the right to know
Dorothy Ababon	Kris Wu is really cute rnğŸ˜»
Charlie Wingate	Please don â€™ t make interviewing these Japanese KPOP nigga a thing ğŸ¤¦ğŸ¾â€â™‚ï¸ğŸ¤¦ğŸ¾â€â™‚ï¸ Fucc Em ğŸ–•ğŸ¾
Dzuthovolu Nienu	This made my day â¤ï¸ Just so proud of him
Hannia Gonzalez	Ily Kris â¤ï¸
Puteri Balqis Azzawiyah	Can someone explain to me why I am cry when the interviewer say EXO to Kris
Ron McDon	i wish these people would make their own genre and stop jocking urban music it annoying couldnt find an urban center for the life of them but riding dick i should open up a kung fu dojo
Manjun Li	no hate what i am trying to say is how u closed to be a pro basketball player when people score on U like eating chip ğŸ¤£ğŸ¤£ğŸ¤£
Trixia Dadia	The interviewer wa so rude Why would you asked about his situation with his father Dafuq
é¹¿å®‰å‰	his english is killing meeeeeeeeeeeeeeeeeeee 3
Thandar Bo	The interview question about his dad is too personal But we get to see how strong and talented our Fan Fan wa thru the year Jia You Fan Fan We re so proud of you for everything You will always be part of this universe because you re the galaxy â¤â¤
Hannah SaldaÃ±a	Yeah Kris Wu yeahhh â¤
Elisabetta Cancrini	I dislike all those question about his father I found it disrespectful honestly Questions about his past in Korea would ve been awkward enough but still bearable but this It s really not okay Anyway everyone please anticipate Kris Wu s new album Antares out on November 2 âœŒ
Its Tina	Can t wait for the album I waited for 4 year I m so happy ğŸ˜ğŸ˜ğŸ˜
skwlgl	so what happen to your dad Omg i would stop questioning about his godamn dad after i heard divorced Its not being asian or western it about being respectful and common sense Kris wu deserve better than this
Yunan Dinta	I wish Exo or Exo cbx could collaborate together with kris somedayğŸ˜‚
exols 9	ğŸ˜‘ğŸ˜‘ğŸ˜‘ğŸ˜‘Thanks for this interview there are many point I want to ask u about it he is sensitive against Exo and his father why can U all stop asking him for many time why
Charlene Ocampo	Why d you have to pursue his family situation what s that got to do with anything The moment he said divorced you should ve just stepped back and moved on
Chuyá»n Háº£i	Kris you want to have your own solo career i can understand but you should have chosen the right time to left EXO at that time everything wa very sensitive all the member were very upset they felt like being you left the group without saying anything do you remember how worse at that time then after your left Tao and Luhan left Lay is the only China member in the group how many suffers ha he been through do you know Lay said please don t hate me when he came back to China for solo debut everything wa very bad do you know your left take how much of our tear do you know you hurt our heart both EXO and EXO L However time can erase everything we have become better hope your career going well but EXO L never forget how hurt you brought to them toKrisWu
Mandy Li	This host asked way too many question on Kris â€™ s personal life You could tell he didn â€™ t feel comfortable It would of been really hard to express a well The main focus should have been on his upcoming album I find it extremely rude and disrespectful
EXSOW	Yung mukha ni kris hindi maipinta nung binaggit yung exo
à¸”à¸²à¸§ à¸§à¸´à¹‰à¸‡à¸§à¸´à¹‰à¸‡	à¸¡à¸µà¸„à¸™à¹„à¸—à¸¢à¸”à¸¹à¸¡à¸±à¹‰à¸¢ à¹‚à¸„à¸£à¸•à¸‹à¸¶à¹‰à¸‡à¹€à¸™à¸­à¸° à¹€à¸£à¸²à¹„à¸¡à¹ˆà¸„à¸´à¸”à¸§à¹ˆà¸²exoà¸¡à¸µ9à¸„à¸™à¸«à¸£à¸­à¸ à¹€à¸à¸£à¸²à¸°à¹€à¸£à¸²à¸„à¸´à¸”à¸¡à¸²à¸•à¸¥à¸­à¸”à¸§à¹ˆà¸²exoà¸¡à¸µ12à¸„à¸™
Linda To	I really can t wait anymore for his new album releasing on 11 2
CraetonDaDonBeats	I wan na work with him
durga raja	Kris Iam really happy that you were able to do independent music enjoy doing your work we will always support you
Oshi Byun	This man just made me cried so muchhhhh i miss hiiiim ğŸ˜­ğŸ˜­ğŸ˜­ğŸ˜­ğŸ˜­ğŸ˜­ğŸ˜­ğŸ˜­
Ø®Ø¨ÙˆÙ„Ø©Ø©exo exo	mmmmmmmmmmy baby i really love him when i wa ten year old now im 18 and i love exo and luhan and tao
Alice Leed	I love you Kris this interview gave me life
Tsinta Alfiyatin ni'mah	
OWL 757	I love you Kris so much exciting shout your album Jiayo
Trang Quá»³nh	someone translate it into Vietnamese please
Mr. Jones	He should name his album The Real WU story
Awkward	To be honest if it weren â€™ t for EXO I probably wouldn â€™ t have supported kris at the start of his solo career but damn I respect him so much for doing him and being true to himself His music is bomb and he â€™ s an amazing writer We â€™ re proud of you 3
Hazel Ampoloquio	Krrrrrriiiiiiis T T
anisa guswara	I love you so much Kris Wu â¤â¤â¤ my galaxy fan fanğŸ’
Christopher Chesler	Dude Looks like he could be from either the 1980s or somewhere in the 2080s
Sophia Charmaine	he deserve all the love and happiness in the world i feel emo
EXO Is Lifeu!!!	Aaawwww KrisğŸ˜­ğŸ’” our galaxy
IWAITISMYNATIONALATHEM	if i got a penny for everytime he said yea i
Meg White	Is it just me or is this a really awkward and invasive interview
Master Nim	I hope you always happy kris â¤
heechulliebabo	I see this is why he missed his mom so much I also think he s really just better off being on his own given how independent he is and how much he wa influenced by hip hop As an EXO L I m glad he made it big on his own
Amal A.	He s done so many hip hop single that made him look like a totally different Kris Wu Yi Fan but here he is in this video sitting and talking and nodding and doing that thing with his eye that I know he s still the same Kris ğŸ˜¢ All the best Kris It s kind of cool that he and EXO are both releasing their album on 2 11 What are Tao and Luhan doing that day lol
å´å¤«äºº	kris wuğŸ˜ğŸ˜ğŸ˜
Adrisha Affendi	We miss you so much Kris You were one of the best leader in EXO and we will never forget you We will always support you Can â€™ t wait for your new album
Kris wu Blank reaction	Guess I ll change my username again
Adelline Santos	I love you Mr Galaxy that s all ğŸ’š
Yuti	The excessive digging on his relationship with his father wa unnecessary and uncomfortable Proud of Kris for handling it well I hope speaking about Exo wa comfortable for him Wish ot12 would meet sort it all out and be friend again
lai wa Ip	He contains about 43millions of fan on Weibo that â€™ s why he would come back China to start his solo career a here is his home Anyway EVERYONE is waiting his first album â€˜ Antares â€™ on Nov2 You should probably pre order it it won â€™ t make u disappointed
Baek The Puppy 'á„‰'	He s an independent artist now they should stop asking him about the past I mean I know they ask about the past but they should not invade this much about the father he s certainly comfortable
diares em	proud dad here
Putri Casanova	â¤
Ccl Galaxy	KirsWuğŸ‘ğŸ»ğŸ‘ğŸ»ğŸ‘ğŸ»
Lin Sun	Kris super talented and passionate super cool and nice Deserves much love Love your music full of a kind of special unique yet very positive energy Your effort on music and new album will be seen soon Can t wait for album Antares
Nini Wu	Kris WuğŸ”¥ğŸ”¥ğŸ”¥
Kkaebsong Chogiwa_6104	My man his so strong to show that his ok but still I love him since he debuted with exo
love 1106	Looking forward to ANTARES the upcoming album
kris liu	I love his new song called COUPE
unbekanntes etwas	KRIS WU TAKE ALL MY LOVE
Andrew Lee	I guess it â€™ s good at least since this is a interview in the west they are able to talk about thing he wouldn â€™ t talk about in Asia Same a for jay park talking about 2pm Exo China member don â€™ t talk about exo at all
Dinda ayu	12 member actually omg kris ğŸ˜­ğŸ˜­ğŸ˜­
å¼ è‰ºå…´YIXINGBAOBEI	Aaaaaa k hiá»ƒu gÃ¬ háº¿t Ã½ å‡¡å•Šï¼Œæˆ‘ä¸èªè­˜é€™å€‹å¤–èª
Jswift255	Vlad asks personal question all the time in his vids Why all these kpop fan so sensitive
Red VelBaek	It s already 2018 and people are still asking him the same question over and over again It s getting really annoying to the point that I could actually feel his discomfort ğŸ˜ Anyway good luck to your new album Galaxy boy â¤
