jaun ajram	3 idiot
Ijaz Butt	U R gr8 man s
Ashraf Zaman	Ø°Ø±Ø§ Ù…ÙˆÙ„Ø§Ù†Ø§ ØµØ§Ø¨ Ú©Ø§ Ø§Ø³ Ø³ÛŒÙ†Ø§Ø±ÛŒÙˆ Ù…ÛŒÚº Ú©Ø±Ø¯Ø§Ø± Ù…Ù„Ø§ Ø­Ø¸Û Ú©Ø±ÛŒÚºÛ” Ú†ÙˆØ±ÙˆÚº Ú©Û’ Ø¯Ø±Ù…ÛŒØ§Ù† Ú¯Ù¹Ú¾ Ø¬ÙˆÚ‘ Ú©Ø±Ù†Û’ Ú©ÛŒ ÚˆÛŒÙˆÙ¹ÛŒ Ú©Ø±Ø±ÛØ§Ú¾Û’Û” Ø§Ø³Ú©Ùˆ Ø§ØªÙ†ÛŒ Ø´Ø±Ù… Ù†ÛÛŒ Ø¢ØªÛŒ Ú©Û Ø®ÙˆØ¯ Ú©ÙˆÙ…ÙˆÙ„Ø§Ù†Ø§ Ú©ÛÙ†Û’ ÙˆØ§Ù„Û’ Ú©Ùˆ Ø§ÛŒØ³ÛŒ Ø°Ù„ÛŒÙ„ Ø­Ø±Ú©Øª Ú©ÛŒØ§ Ø²ÛŒØ¨ Ø¯ÛŒØªÛŒ Ú¾Û’ØŸ Ù¾Ø§Ú©Ø³ØªØ§Ù†ÛŒ Ø¹ÙˆØ§Ù… Ø°Ø±Ø§ Ú¾ÙˆØ´ Ù…ÛŒÚº Ø±Ú¾ÛŒÚº Û” Ø±ÛŒØ´Û Ø¯ÙˆØ§Ù†ÛŒØ§Úº Ø´Ø±ÙˆØ¹ Ú¾ÙˆÙ†Û’ Ù„Ú¯ÛŒ Ú¾Û’Û”
Tanveer Ahmed	Hmari awam KI ankhe kholne K liye kafi he jab pakre Jane ka waqat Ata he ye rona dona shro kr dete he
Maria Khan	yha hukumat gerana itna Asan h b voting Dalo or gerao Mgr chor ko pakr k saza Dena itna mushkal h AK chor ko thora torchar kro to wo sach boldeta h Mgr yha to sabot hi pory nh hoty
MsSahil92	ÙˆÛ Ù†Ø§Ø³ÙˆØ± Ø§Ø¨ Ø§Ù† Ú©Û’ Ù„ÛŒÛ’ Ù…ÙˆÙ¹Ø§ ØªØ§Ø²Û Ø³ÙˆØ± Ø¨Ù† Ú†Ú©Ø§ ÛÛ’ Ø§ÙˆØ± Ø³ÙˆØ± Ø²Ø±Ø¯Ø§Ø±ÛŒ Ú©ÛŒ Ù¾Ø³Ù†Ø¯ÛŒØ¯Û ÚˆØ´ ÛÛ’
suhail akbar	Brghairti ka doosra naam ZARDARI BILAWAL S HAREEFS
Dr Samina Yasin Shaikh	True spirit BC Sabir Shakir well done others
ali imran	Salay kuttay zardari ne pee hui hai Is pe medium kyun nahi bolta
Ashly Chauhan	Rizwan rightly said people please whoever you are regardless of the faith and religion please wake up before we all are reduced to invisible particle on the geographical map please dont listen to these nibbler they both are look at these what they have done and what their qualification were whatever IK is can a single person stand like him at the time extreme dilemma can one person no doubt the team is there to assist him yet there needed one man lead them all and IK is here who wa called by bloody that he is this and that and play boy He wa a boy therefore he could play and it need gut to play the one who dont even have ball s to play
Arshad Hamid	PPP PMLN is a group of choors and money laundrers and killer and gaddars All must hang
taswar iqbal	Ù†ÙˆÙ† Ù„ÛŒÚ¯ Ù¾ÛŒÙ¾Ù„Ø²Ù¾Ø§Ø±Ù¹ÛŒ Ø§ÙˆØ± ÚˆÛŒØ²Ù„ Ù¾Ø§Ø±Ù¹ÛŒ ÛŒÛ Ø³Ø¨ Ù…Ù„Ú© Ú©Û’ ØºØ¯Ø§Ø± Ø§ÙˆØ± Ú†ÙˆØ± ÛÛŒÚº Ø§Ù¾Ù†ÛŒ Ú†ÙˆØ±ÛŒØ§Úº Ú†Ú¾Ù¾Ø§Ù†Û’ Ú©Û’ Ù„Ø¦Û’ Ú¯Ù¹Ú¾Û’ ÛÙˆ Ø±ÛÛ’ ÛÛŒÚº Ø§Ù„Ù„Û Ø§Ù† Ú©ÛŒ Ù†Ø³Ù„ÙˆÚº Ú©Ùˆ ØªØ¨Ø§Û Ú©Ø±Û’ Ø¢Ù…ÛŒÙ† Ù¾Ø§Ú©Ø³ØªØ§Ù† Ø²Ù†Ø¯Û Ø¨Ø§Ø¯ Ø¹Ù…Ø±Ø§Ù† Ø®Ø§Ù† Ø²Ù†Ø¯Û Ø¨Ø§Ø¯ â¤â¤â¤
m. akram	Allah pak Pakistan k dusmenu ko tabah kary Ameen
Yabaqi Yabaqi	Saheb bachakar Saheb Meri ungli Civil Hospital doctor na hone ki wajah se ek imported ki wajah se tut gayi hai Imran Khan ko batao
Advocate. S.S.H Rizvi.	Shah shaib Because Fasil Raza Abdi still in jailed shamed Alls political party choor carpet bad Laws justice system PPP and other s PMLN choor carpet bad news ğŸ“° shamed ğŸ˜ª ğŸ˜·
Irfan Ghulam Nabi	Ú¯Ù„ÛŒ Ú©Û’ Ù„Ù†Ú¯Ú‘Û’ Ú©ØªÛ’ ØµØ±Ù Ø¨Ú¾ÙˆÙ†Ú©Ù†Û’ Ú©ÛŒÙ„Ø¦Û’ Ù†ÛŒØ§Ø²ÛŒ Ú©Ø§ Ù„Ù†Ú¯Ú‘Ø§ Ú©ØªØ§ ÛÛŒÙ„ÛŒ Ú©Ø§Ù¾Ù¹Ø± Ù…Ù°ÛŒÚº
Babar Hussain	Ø§Ù† ØºØ¯Ø§Ø± Ú©Ùˆ Ù¾Ù‡Ø§Ø³ÛŒ ÛÙ†ÙˆÛÛŒ Ú†Ø§ÛÛŒÛ’
Sadiq-ul-Islam zunnoon	The player on the Chess Board fight with each other violently but when game is over they embrace with each other with all comfort at the same Board so Political Chess Board is the same
RED ON YELLOW	ZARDARI THO NAWAZ SAY BARA CHOR NIKLA YAAR LOG AB BI INKAY LIYE LARNAY MARNAY KO TAYAR HAIN AFSOS HOTA HAY
Munawar Mazari	Nice opinion
malik shahzad Latif	Ù…Ø¬Ú¾Û’ ÙØ®Ø± Ú¾Û’ Ø§Ù¾Ù†Û’ Ø³Ú†Û’ Ø§ÙˆØ± Ú©Ú¾Ø±Û’ Ø¹Ø¸ÛŒÙ… Ù‚Ø§Ø¦Ø¯ Ø¹Ù…Ø±Ø§Ù† Ø®Ø§Ù† ØµØ§Ø­Ø¨ Ù¾Ø±
sohail Ansari	your program is so good sir
ghulam akbar	chief justice saqib nisar ka time 2 saal or bara dena zaroori hai naya judge jo bhi ay ga pata nahi wo kaisa ho or saqib nisar ny jo case start kiye hai acha ho ga agr un ka faisla bhi wo hi kr k jay
Amtul Shafi	insha Allah Imran khan ya Pakistan ko Kuch Nahi ho ga
rana mudassar	Kaha tha na rolano GA ab Rona in ka muqadar ha chooron ka Imran khan zindabad
Farzana Rahman	Shahid please tell about trouser off at American airport hahaha ğŸ˜„ğŸ˜„ğŸ˜„ğŸ˜„ğŸ˜ƒğŸ˜ƒğŸ˜ƒ
Farida Khajawall	Aur tu gareebon ka masiah hai Tum tu sab say ziada gunda aur napak insaan hai
Shoib Malik	Ù„ÛŒÚˆØ± Ø¢Ù Ù¾Ø§Ú©Ø³ØªØ§Ù† Ø¹Ù…Ø±Ø§Ù† Ø®Ø§Ù† ØµØ§Ø­Ø¨ Ù†Û’ Ø³Ø¨ Ú©Ùˆ Ù†Ù†Ú¯Ø§ Ú©Ø±Ø¯ÛŒØ§Û”Û”Û”ğŸ’ªğŸ’ªğŸ’ª
fahid sultan	Ø²Ø¨Ø±Ø¯Ø³Øª Ù¾Ø±ÙˆÚ¯Ø±Ø§Ù… Ø³Ø± Û” Welldon sir
majboor Khan	Jab ye program dikta ho tu rona ata hai
muhammad tuqeer	Pti zindabad
Jan Mauz	Salam Tu Shahin hai Afg ki nazar se Tohri twaja chahtahon Aap chor sepahi kelo ge udhar Sarhad pe tufan hai Kaptan Khan ko tanha nakaro 1nazar Sarhad paar Racko Ham ko apas me larraya ab Aap se ham ko larwayega
Vickey Bhatti	ye u turn nahi
Danny Boy	Imran Khan the hero of east west should very quickly crush these lannatti makroo munafikeens animal like Nawaz Sharif shahbaz Sharif asif Zardari all soor si aulads plus there makroo lannatti family supporter affilieats follower on a fast pace Task force should very quickly recover all the en looted money wealth from these lannatti makroo animal munafikeens traitor ghaddars of state of Pakistan above
princess zoni	Ab bhe waqt hy pakistani awam jag jao khudaya ALLAH ki khas rahmat ai hy imran khan k shakl me is moka ko zaya na kro khaudara zardari nawaz mafad parst haine
Farooq Khan	Zardari chore imran Khan sahib banzir income support program bi band karna chyaya ismy bi cruption Hy
rebhos1	All of u Know these MF Shariff and MF Zatdari are thief but greater MFs are the general of the Pak Army the CJ of the SC who allowed them to loot the country MF Musharraf wa the main guy responsible to let these MF flourish Hope a new Martial law is there who will and MUST HANG these MF
Kareem Khan	love u imran khan
Mohammad Afzal	Zoordari you are a mad dog of the lowest cast who bark and bite it own owner Time ha come when you will be dealt with properly Nevermind you join another choor but all of you have to be accounted for and this will be done soon You want and see son of a bitch
Fiaz Dar	These are the politician who lik their own spit from the floor They are not trust worthy
Raju Cage	Ehtesham yeh aap hath se bato he bato mein koun se simble banay Tay ho illumanati ho Kya aap ya pher free manson ho dajjali simble banay Tay ho aap aksar mein note karta Hun aapko
naz khan	Allah Pak nawaz sarif ko gark kary ji ny mamtaz qadri ko pansi di insahAllah is ko saza milay gi
Aftab Ahmed Malik	Great program even my small kid like it s complete proceeding Bravo boy
Farozan Bokhari	Anchors of the reporter why don â€™ t you help IK n cm buzdar by compiling list of honest bureaucrat n give to them I love this program but it beyond my comprehension why can â€™ t u guyz help this made in Pakistan government We only watch ur show n dr Shahid Masood coz u talk honestly plz help the govt off the show also thnx a ton if I wa there I would definitely do it
Ahsanali764 Ali	Ø´Ø§Û Ø²ÛŒÙ† ØµØ§Ø­Ø¨ Ø³Ø¨ Ø³ÛŒØ§Ø³Øª Ø¯Ø§Ù†ÙˆÚº Ú©Ø§ Ø¨Ø§Ù¾ ÛÛ’ ÙØ¶Ù„ Ø§Ù„Ø±Ø­Ù…Ø§Ù†
Shazia Tabassum	ØªØ®Øª Ø±Ø§Ø¦Û’ ÙˆÙ†Úˆ Ú©Ùˆ ÛÙ„Ø§Ø¦ÛŒÚº Ú¯Û’ Ø§ÙˆØ± Ù¾Ú¾Ø± Ø§Ø³Ú© Ù†ÛŒÚ†Û’ Ú†Ú¾Ù¾ Ø¬Ø§Ø¦ÛŒÚº Ú¯Û’ Ù„ÙˆÚ¯ÙˆÚº Ú©Ùˆ Ú¯Ú¾Ù…Ø§Ø¦ÛŒÚº Ú¯Û’ Ø§ÙˆØ± Ù¾Ú¾Ø± Ú†Ù¾Ú©Û’ Ø³Û’ Ù†Ú©Ù„ Ø¬Ø§Ø¦ÛŒÚº Ú¯Û’ğŸ˜‚ğŸ˜‚ğŸ˜‚ğŸ˜‚ğŸ˜‚ğŸ˜‚
Yfgjd Yghjje	Nice porogaram
Waseem Ashraf	Sir Barister Ehtsham Ud Din i have been watching your show since long time it s a very brilliant show you people are giving brilliant knowledge to our young generation and making them literate regarding conspiracy against our country it s a great effort that you people are doing now our young generation ha woken up in the election of 2013 this young generation wa kid and now they have become literate and they know who is corrupt and who is better for our country and we have only one choice none other then the great Imran khan i will just request to our young generation please please give him atleast 5 year then we will see that what he ha done for Pakistani nation and in Shah Allah he will do this please please give him time if we can tolerate Nawaz Lal Nehru and Mr 10 corruption for 30 year and we can imagine that how they have looted this country shame on them these looter have forgotten about day of judgement where they will have to answer about there work that they have done for there nation they have done nothing they are just trying to save there corruption and there corrupt mafia s but In Shah Allah this time they won t be successful i will request one more thing to our young generation that please please prey for Imran khan s long life in every Namaz and I will request one thing to Barister Ehtsham Ud Din please please telecast this show atleast 5 day in a week many regard Waseem Ashraf
Akhtar Ghumman	Sabir shaker saab you very slow in these day no give any special new where are you
Ayaaz Auras	Ø²Ø±Ø¯Ø§Ø±ÛŒ ØµØ§Ø­Ø¨ Ú©ÙˆØ¦ÛŒ Ø´Ø±Ù… ÛÙˆØªÛŒ ÛÛ’ Ú©ÙˆØ¦ÛŒ Ø­ÛŒØ§ ÛÙˆØªÛŒ ÛÛ’
HAFEE good Nice song	Lanat Lanat Lanat Zardari
Abdul Wahid	25 ØªØ§Ø±ÛŒØ® Ú©Ùˆ ÚˆÛŒ Ø¬ÛŒ Ø¢Ø¦ÛŒ Ø§ÛŒØ³ Ø¢Ø¦ÛŒ ØªØ¨Ø¯ÛŒÙ„ ÛÙˆÚ¯Ø§ Ø§ÙˆØ± Ù†Ø¦ÛŒ ÚˆÛŒ Ø¬ÛŒ Ø¢Ø¦ÛŒ Ø§ÛŒØ³ Ø¢Ø¦ÛŒ Ø§ÛŒÚ© Ø§ÛŒÙ…Ø§Ù†Ø¯Ø§Ø± Ø§Ù†Ø³Ø§Ù† ÛÛŒÚº Ø§Ù†Ø´Ø§Ø¡Ø§Ù„Ù„Û ÛŒÛ Ú†ÙˆØ± Ù†Ø§Ú©Ø§Ù… Ø±ÛÛ’ Ú¯Û’
Sarwar Khan	Tumhare khan Kia kahta tha phir sub Chor age peeche Hain
Amir Cheema	Arif bhatti sab sabeir shakeir sab ehtisham sam good Pm sab abi ien churo ko chuorny waly nahi ha g inshallah g
Bashir Zaman	Inshallah choron k acche din chale gai aur ab in ka ihtisaab Khan sahaab karega
Anwarulhaq Khan	ğŸ‘
Abid Khattak kenty ka mely ga	Khan zinda abad
Mohammad Ahmad	Zardari or shareef ko pura zoor laga dena chahye kyunki pakistan abhi ventilator pe thoda zor laga den to zarur kamyab honge
S & S Vines	We wish nab and pti walay bhi ye program dekha karain hire them
Mirza Ateeque	Ú†ÙˆØ±ÙˆÚº Ú©Ùˆ ÙÙˆØ±Ø§ Ø³Ø²Ø§ Ø¯ÛŒ Ø¬Ø§Ø¦Û’ Ø¹Ø¨Ø±Øª Ú©Ø§ Ù†Ø´Ø§Ù† Ø¨Ù†Ø§ÛŒØ§ Ø¬Ø§Ø¦Û’ Ø§ÙˆØ± Ø¨Ø¬Ù„ÛŒ Ú†ÙˆØ±ÙˆÚº Ú©Ùˆ Ø¨Ú¾ÛŒ Ø³Ø²Ø§ Ø¯ÛŒ Ø¬Ø§Ø¦Û’ Ú©Û Ø¢Ø¦Ù†Ø¯Û Ø¨Ø¬Ù„ÛŒ Ú†ÙˆØ±ÛŒ Ú©Û’ Ù„Ø¦Û’ Ú©Ù†ÚˆØ§ Ù†Û Ù„Ú¯Ø§Ø¦Û’ Ø¨Ø¬Ù„ÛŒ Ú†ÙˆØ± ØªÙˆ Ø®ÙˆØ¯ ÙˆØ§Ù¾ÚˆØ§ Ú©Û’ Ù„Ø§Ø¦Ù† Ù…ÛŒÙ† Ú¾ÛŒÚº
rokhan shah	In 2008 ppp govt dollor rate 65 rupee after five year 2013 dollor rate increase 35 rupee and reached 100 rupee
Zeus7777 Appolon7777	WHY NAB HAS STILL NOT FILLED THE APPLICATION AGAINST THE LAHORE HIGHCOURT DECISION OF NAWAZ GANJA BAIL
Hashim Ali	ğŸŒ¹ğŸ˜ğŸ˜˜â˜•ğŸŒ¹ğŸ˜ğŸ˜˜â˜•ğŸŒ¹ğŸ˜ğŸ˜˜â˜•
sabghatullah kakar	Ye sb mill k b khan ka ball bika ni krskta ab wo time chala gaya
Zuhaib Pitafi	Imran khan zinda bad aj akela waqat k feraono k sath akela muqabla kr raha hi
Umar Afridi	Imran khan â¤â¤â¤â˜ºğŸ˜˜
Shakirullah Khan	Ø¢Ø¬ Ø¢Ù¾ Ù†Û’ Ù…Ø§ Ø´Ø§Ø¡Ø§Ù„Ù„Ù„ÛÙ Ø§Ú†Ú¾Ø§ Ù¾Ø±Ùˆ Ú¯Ø± Ø§ Ù… Ú©ÛŒØ§ Ø¨Ú¾Ù¹ÛŒ ØµØ§Ø­Ø¨ Ø¨Ú¾ÛŒ Ú©Ú¾Ù„ Ú©Û’ Ø¨Ùˆ Ù„Û’ Ø§ÙˆØ± ØµØ§ Ø¨Ø± Ø´Ø§Ú©Ø± Ø¨Ú¾ÛŒ Ù…Ø§Ø´Ø§Ø¡Ø§Ù„Ù„Ù„ÛÙ Ù„ÛŒÚ©Ù† Ú©Ø§ ÙÛŒ Ù¾ÛŒØ³Û Ù†Ú©Ù„ Ú¯ÛŒØ§ Ù…Ù„Ú© Ø³Û’ ØŒØªÙˆ Ú¾Û’ Ú©Ùˆ ÛŒ Ø¬Ùˆ Ø±Ùˆ Ú©Ø³Ú©Û’
Muhammad Adnan	As vatan mn kuch be ho sKta ha
Saqib Dilawar	Ù…ÛŒÚˆÛŒØ§ Ú©ÛŒÙˆÚº Ø§ÛŒØ³Û’ Ú†ÙˆØ±ÙˆÚº Ú©Ùˆ Ø¨Ø§Ø± Ø¨Ø§Ø± Ø¯ÛŒÚ©Ú¾Ø§ Ø±ÛØ§ ÛÛ’
Fakhar Abbas	Very nice
Kulsoom Hussain	Yeh dakow Imran Khan ka akaily kuch nahi begar sakhty haa app jaisy medium mafia ka sath daity ji tarah shoro din sy tum pti ky pechy pary too mojhy yaqeen hy IK khod Assembly toor daingy too pehar medium mafia samait sary dakow ka woh woh by lag ihtesab hoga keh yeh lifafy or dollar app sy ultya karwa kar nikilwaya jaya jega
chick chick	Bhatti sahub Zindabaad
Asghar Ali	zardari NWA s bai bai
Raja Asad Saghir	Imran awam Ko sachai bta raha hai k mulk kaisy chalta hai Metro ğŸš‡ bnao awam Say 20 lo or bqi imf say asian development bank yah world bank say loan lo yah kise department ka budget dosry main dalo or awam ko phudo laga k govt karo Os k badh 5 yr k badh rona shuru kar do
mushtaq butt	Ø®ÙˆØ±Ø´ÛŒØ¯ Ø´Ø§Û Ú©ÛŒ Ø´Ú©Ù„ Ù¾Ø± ÛØ± Ø±ÙˆØ² Ø§Ù„Ù„Û ØªØ¹Ø§Ù„ÛŒ Ú©ÛŒ Ù„Ø¹Ù†Øª Ù†Ø¸Ø± Ø¢Ù†Ø§ Ø´Ø±ÙˆØ¹ ÛÙˆ Ú¯ÛŒ ÛÛ’ Ø§ÙˆØ± Ù…Ø²ÛŒØ¯ Ø¨Ú‘ØªÛŒ Ù†Ø¸Ø± Ø¢ Ø±ÛÛŒ ÛÛ’
Aamir Iqbal	ÛŒØ§Ø± ØªÙ†Ú¯ Ø¢ Ú©Ø± Ø¨Ø§Øª Ú©Ø± Ø±ÛØ§ ÛÙˆÚº ÙˆÛŒØ³Û’ Ù…ÛŒÚº Ø§ÛŒØ³ÛŒ Ø¨Ø§ØªÛŒÚº Ú©Ø±ØªØ§ Ù†ÛÛŒÚºÛÙˆÚº ØªÙ… Ø¬ÛŒØ³Û’ Ú¯Ú¾Ù¹ÛŒØ§ Ø§ÙˆØ± Ø¨Û’ÛÙˆØ¯Û Ø§ÙˆØ± Ø¨Û’ ØºÛŒØ±Øª Ú†ÛŒÙ†Ù„ Ø§ÙˆØ± Ø§ÛŒÙ†Ú©Ø± Ù†ÛÛŒÚº Ø¯ÛŒÚ©Ú¾Û’ Ø§ÙˆØ± ÛŒÛ Ø¹Ø§Ø±Ù Ø¨Ú¾Ù¹ÛŒ ØµØ§Ø¨Ø± Ø´Ø§ Ú©Ø± Ø¹Ù…Ø±Ø§Ù† Ø®Ø§Ù† Ø¬ÛŒØ³Û’ Ú©Ù†Ø¬Ø± Ú©ÛŒ Ø¯Ù„Ø§Ù„ÛŒ Ø§ÛŒØ³Û’ Ú©Ø±ØªÛ’ ÛÛŒÚº Ø¬ÛŒØ³Û’ Ø§Ù¾Ù†ÛŒ Ø¨ÛÙ†ÙˆÚº Ú©Û’ ÛŒØ§Ø± ÛŒØ§ Ø§Ù¾Ù†ÛŒ Ø¨ÛŒÙ¹ÛŒÙˆÚº Ú©Û’ Ø®ØµÙ… Ú©ÛŒ Ø¨Ø§Øª Ú©Ø± Ø±ÛÛ’ ÛÙˆ Ù„Ø¹Ù†Øª ØªÙ… Ø¬ÛŒØ³Û’ Ø¯Ù„ÙˆÚº Ø§ÙˆØ± Ú©Ù†Ø¬Ø±ÙˆÙ† Ù¾Ø±
ZAHID KHAN	Ø¹Ù…Ø±Ø§Ù† Ø®Ø§Ù† Ø²Ù†Ø¯Ø¨Ø§Ø¯
A G Sayyal	Ú©Ø§Ø´ Ø§ÛŒØ³Û’ Ù„ÛŒÚˆØ± Ú†Ø§Ø¦Ù†Û Ù…ÛŒÚº Ù¾Ú©Ú‘Û’ Ø¬Ø§ØªÛ’ Û”
Rizwan Ahmad	Plz donate for dam thx
Shahzad Ali	Ú†ÙˆØ± Ù†ÙˆØ§Ø² Ø´Ø±ÛŒÙ Ú†ÙˆØ± Ø²Ø±Ø¯Ø§Ø±ÛŒ Ø§ÙˆØ± Ú†ÙˆØ±ÙˆÚº Ú©Ø§ Ø¬ÛŒÙˆ Ù¹ÛŒ ÙˆÛŒ Ù¾Ø± Ø¬ÙˆØªÛ’ Ù…Ø§Ø±Û’ Ø¬Ø§Ø¦ÛŒÚº
Imran Wiseem	Randi aurat apni chori bachane k liye sab choor akhte ho rhe hain lakin in ko yeh pta nahi ha in k samne imran khan ha ji ny agge barna he seekha ha
Rao Shahid Muzammil	Haqeeqat TV well done ğŸ‘ ğŸ‘ ğŸ‘
Naila Zafar	Because of Ehtasham Don â€™ t want to watch this programme any more I wa a regular watcher of this program Sad Can â€™ t stand mr ehtesham
Kiffal Kiffal	zardare dako ha allah pak zaror e hrame ko ibrat ka nashan bnaya ga
Babar Babar	Bati Saab ap ko ktny passy dya p t I na
Faisal Hussain	Love Imran khan
Nazir Khan	Bhatti Sahib in next few day many Chores are going to be arrested so they will have no time to buy vote
Miruna Levarda	In Sha Allah in ko Mun ki khani pare gi Jis ke saath Allah ho u ka koi kuch nahi bigar sakta
Shekh Khalid	News waloo siraf aag lagao
Din Afzal	Ø³Ù†Ø§ÛÛ’ Ù‚ÙˆÙ…ÛŒ Ù…Ø¬Ø±Ù… Ø§ÛŒÚ© Ø¨Ø§Ø± Ù¾Ú¾Ø± Ø§Ú©Ù¹Ú¾Û’ ÛÙˆØ±ÛØ§ ÛÛ’ Ø®Ú©ÙˆÙ…Øª Ú©Û’ Ø®Ù„Ø§Ù
Zahida Parveen	Prime minister Imran Khan is the best
Ali rizwan	jago Pakistaniyo ab n samjo gy tu kabi n ye nawz ghardari bhai bhai
Shah Gul	Ú©ØªÙ†Ø§ Ø§ÙØ³ÙˆØ³ Ú©Ø§ Ù…Ù‚Ø§Ù… ÛÛ’ Ú©Û ÛŒÛ Ú©Ø±Ù¾Ù¹ Ø³ÛŒØ§Ø³Øª Ø¯Ø§Ù† Ú©ØªÙ†ÛŒ Ø¯Ù„ÛŒØ±ÛŒ Ø³Û’ Ø¬Ú¾ÙˆÙ¹ Ø¨ÙˆÙ„ØªÛ’ Ú¾ÛŒÚº Ø´Ø±Ù… Ø§Ù† Ù„ÙˆÚ¯ÙˆÚº Ú©Ùˆ Ø¨Ù„Ú©Ù„ Ù†ÛÛŒÚº Ø¢ØªÛŒ ÛÛ’ Ú©Ø¨Ú¾ÛŒ Ú©Ú†Ú¾ Ú©ÛØªÛ’ ÛÛŒÚº Ú©Ø¨Ú¾ÛŒ Ú©Ú†Ú¾ Ú¾Ù… Ø¹ÙˆØ§Ù… Ú©Ùˆ Ø¹Ù‚Ù„ Ú©Û’ Ù†Ø§Ø®Ù† Ù„ÛŒÙ†Û’ Ú†Ø§ÛÛŒÛ’ Ú¾Ù… Ù„ÙˆÚ¯ÙˆÚº Ú©Ùˆ Ø§ÛŒØ³Û’ Ø¯ÙˆØºÙ„Û’ Ø³ÛŒØ§Ø³Øª Ø¯Ø§Ù†ÙˆÚº Ú©Ùˆ ÙˆÙˆÙ¹ Ù†Ú¾ÛŒÚº Ø¯ÛŒÙ†Ø§ Ú†Ø§ÛÛŒÛ’ Ø¬Ùˆ Ú¾Ù…Ø§Ø±Û’ Ø³Ø§ØªÚ¾ Ø¯Ú¾ÙˆÚ©Û Ú©Ø±ØªÛ’ Ú¾ÛŒÚº Û”Ø¨Ú¾Ù¹ÛŒ ØµØ§Ø­Ø¨ Ø¨ÛŒØ±Ø³Ù¹Ø± Ø§Ø­ØªØ´Ø§Ù… Ø§ÙˆØ± ØµØ§Ø¨Ø± Ø´Ø§Ú©Ø± Ú¾Ù… Ø¢Ù¾ Ú©Û’ Ø´Ú©Ø± Ú¯Ø²Ø§Ø± ÛÛŒÚº Ø¬Ùˆ Ø§Ù¾ Ø¹Ø§Ù… Ù¾Ø§Ú©Ø³ØªØ§Ù† Ú©Û’ Ø¹ÙˆØ§Ù… Ú©ÛŒ Ø¢ÙˆØ§Ø² Ø§Ù¹Ú¾Ø§ØªÛ’ ÛÛŒÚº
junaid warich	Ø¹Ù…Ø±Ø§Ù† Ø®Ø§Ù† Ø²Ù†Ø¯Û Ø¨Ø§Ø¯ Ù¾Ø§Ú©Ø³ØªØ§Ù† Ø²Ù†Ø¯Û Ø¨Ø§Ø¯ Ù¾Ø§Ú© ÙÙˆØ¬ Ø²Ù†Ø¯Û Ø¨Ø§Ø¯
Akbar Pti	Arif bahti is not good man
M Ishfaq M Ishfaq	Imran Khan shab please inlogun ko chorna Ni please Ni to hum apko maf ni karen gen
Mjavead Iqbal	Ø§Ù† Ø¨Ú¾ÛŒÚ‘ÙˆÚº Ú©Û’ ÛØ§ØªÚ¾ Ù…ÛŒÚº Ø§Ø¨Ú¾ÛŒ Ú©ÙˆØ¦ÛŒ Ø´Ú©Ø§Ø± Ù†ÛÛŒÚº Ø¢Ù†Û’ ÙˆØ§Ù„Ø§ Ø¨Ú¾Øª ÛÙˆÚ¯ÛŒØ§ Ø¨ÛØª Ù„ÙˆÙ¹ Ù„ÛŒØ§ Ø¢Ù¾ Ù†Û’ Ø§ØµÙ„ Ù…ÛŒÚº ÛŒÛ Ø³Ø¨ Ø¨ÛŒÚ‘ÛŒØ§Úº Ø§Ø³ Ù„ÛŒÛ’ ÙÚ©Ø±Ù…Ù†Ø¯ ÛÙˆÚ¯Ø¦Û’ ÛÛŒÚº Ú©Û Ø¬Ùˆ Ø§Ù†Ú¾ÙˆÚº Ù†Û’ Ù…Ø§Ù„ Ù¾Ú†Ú¾Ù„Û’ Ø³Ø§Ù„ÙˆÚº Ù…ÛŒÚº Ø¨Ù†Ø§ÛŒØ§ ÛÛ’ Ø§Ø³ Ú©ÛŒ Ø¢Ø¨ Ù¾Ø±Ø³Ø´ ÛÙˆÚ¯ÛŒ Ø§Ø³ Ù„Ø¦Û’ Ø§Ù† Ú©Ùˆ Ø§Ø¨Ú¾ÛŒ ØªÚ©Ù„ÛŒÙ ÛÙˆÚ¯ÛŒ Ø§Ù† Ú©Ùˆ Ø¬ÛŒÙ„ Ú©ÛŒ Ø³Ù„Ø§Ø®ÛŒÚº Ù‚Ø±ÛŒØ¨ Ù†Ø¸Ø± Ø¢Ø±ÛÛŒ ÛÛŒÚº
safeey awan	Ø§ÛŒÚ© ÛÛŒ Ø­Ù„ Ù¾Ú¾Ø§Ù†Ø³ÛŒ Ø¨Ø³
Ahmed Salama	Double faced traitor They think Pakistan is their property Allah s mill grind slowly but surely
N. K. Khan	Mujhayy yehh game abb kucch kucch sammajhh aaa rahhii hayy Wohh yehh k mulllkk k karrtta dharrtta â€™ on ne plan yehh bannayya ho gaa k Imran Khan ko iqqttaddaarr de karr burrree tarrahh naakkaam karr diyya jayye Kiyya Pakistan k awwaam ko nazzarr nahhi aaa rahha k Kappttaan ko kiss tarrah musshkillaatt se guzzarr â€™ na parrr rahha hayyy Aajj takk aisssa nahhii huwwa k mullk ka Prime Minister yeh kehhtta huwwa nazzarr aaye k Police aurr bureacracy mujhhayy kaaam nahi karrnnayy de rahhii Pakistan kkii awwaam ko bayywaqooff bannayya ja rahha hayy yehh kahh karr k mullk ka khaazzaanna ko loooottnnay waallayy corrupt politician k khillaaff kaarrawwayyee ho rahhii hayy aurr unnse looottee huee daullatt waappass le karr unnkka political career hummesha k liyye khattam kr dya jaye ga Mujhayy tohh greater plan yehh lagg rahha hayy k Kappttaan ko iqqttaddaarr de karr aurr usssayy her front pr burree tarrah naakkaam karr k yehh saabbitt kiyya jaa sakkkayy k hukkoommattiii muaamllaatt challaanna Imran Khan k bass kkii baaatt nahi Basss phirrr siyyassii career unn luttaerron aurr chaurron ka nahi ball â€™ k Kappttaan ka khattam karr diyya jaye ga Phirr awwaam me yehh mashhooorr ho jaye gaa k Imran Khan ko awwaam k kehhnayy pr moqqa diyya gayya lekkin Imran Khan ne siyyassatt ko cricket ka ground samjhha i liyye naakkaam ho gayyya Bhaiyyyo Mullkk aissayy hhii challlayy gaa aurr abb unnhhii luttaerron aurr chaurron kkii aullaaddon k zarriayye mullkk ko challayya jaye gaa Pehhllayy Marriyyam aye gee aurr phirr Bilawal Phirr Marriyyam aur phirr Bilawal phirr inn donnon kkii aullaaden hum pr hukkoomatf karren gee Duaa karren k me jo kucch socch rahha hooon wohh billkulll ghallatt saabbitt ho jaye Aameen ğŸ¤²ğŸ¤²ğŸ•‹ğŸ•ŒğŸ¤²ğŸ¤² Pakistan Zindabad ğŸ‘ğŸ»ğŸ‡µğŸ‡°ğŸ‘ğŸ»
FATA PuKHT00N	Ø²Ø±Ø¯Ø§Ø±ÛŒ Ù†ÙˆØ§Ø² Ø¨Ú¾Ø§Ø¦ÛŒ Ø¨Ú¾Ø§Ø¦ÛŒ ğŸ˜¬ğŸ˜² Ù…Ø±ÛŒÙ… Ù†ÙˆØ§Ø² Ú©Ø§ Ù†ÛŒØ§ Ù†Ø¹Ø±Ø§
Shahid Khan Khan	Ø§Ù„Ù„Ûâ€ Ú©Û’ Ù„ÛŒÛ’ Ø§Ù† Ú©Ø±Ù¾Ù¹ Ù„ÙˆÚ¯Ùˆ Ú©Ùˆ Ø§Ù„Ù¹Ø§ Ù„Ù¹Ú©Ø§ Ø¯Ùˆ Ø¹Ù…Ø±Ø§Ù† Ø®Ø§Ù† Ø§Ù„Ù„Ûâ€ Ù†Û’ Ù…ÙˆÙ‚Ø¹ Ø¯ÛŒØ§ ÛÛ’ Ø¢Ù¾ Ú©Ùˆ Û”
Osaimi Shafqat	I love pti
Pyarali Khoja	If PPP AND PMLN ARE PLANNING DIRTY GAMES AGAINST PTI AND REMOVE THEM POWER THEN ARMY MUST COMI IN AND TAKE OVER
Raheel Ch	wasay ye bt kro tu sb e chor hain sb syasi log apnay faiday dakhty wo ppp hu pml n hu pti hu mqm hu jui hu anp hu ğŸ˜…ğŸ˜…ğŸ˜…
abdulhameed khan	Ù¾Ø§Ú©Ø³ØªØ§Ù† Ù…ÛŒÚº Ú©Ø±Ù¾Ø´Ù† Ú©Ø§ Ù†Ø§Ù… Ø¬Ù…ÛÙˆØ±ÛŒØª Ú¾Û’ Ø§ÙˆØ± Ø§Ø³ Ø¬Ù…ÛÙˆØ±ÛŒØª Ú©Ùˆ Ø³Ø§Ø±Û’ Ú©Ø±Ù¾Ù¹ Ù„ÙˆÚ¯ Ú¾ÛŒ Ø³Ù¾ÙˆØ±Ù¹ Ú©Ø±ØªÛ’ ÛÛŒÚº Ø§ÙˆØ± Ø§Ø¨ ÛŒÛ Ù†Ø¸Ø§Ù… Ø§Ù¾Ù†Û’ Ø¢Ø®Ø±ÛŒ Ø³Ø§Ù†Ø³ Ù„Û’ Ø±ÛØ§ ÛÛ’
Sohrab Khan	Ye batin sirf ap jasy or hum jasy logo ko samaj aty hay or patwariu or jialu or zebru ki logo ko samaj nai arahi ye bigyrat logo nai mulk ko lutta en kuttu ko ulta latkana chaye or kutty ki muat marna chaye en bigyrat logo ko
Azmat Hussain	Ehtesham bhai hakumat chal sakti hy or chaly gi InshaAllha ppp or pmln Waly isliya mil rahy hen kion k apny aap ko bcha saken haman imran Khan py 1000 trust or yakeen hy ham khan sahib ko 5 sall apna PM dekhna cahty hen Allha unko sehat tandrusti dy Ameen
M Younas	Ù†ÙˆÙ† Ù„ÛŒÚ¯ Ø§ÛŒÚ© Ù†Ø§ÛÙ„ Ù„ÛŒÚ¯ Ø§ÙˆØ± Ú†ÙˆØ± Ù„ÛŒÚ¯ Ú¾Û’ Ù¾ÛŒÙ¾Ù„Ø² Ù¾Ø§Ø±Ù¹ÛŒ Ø§ÛŒÚ© Ù¾Ù„ÛŒØª Ù¾Ø§Ø±ØªÛŒ Ø¨Ù† Ú©Ø± Ø±Û Ú¯Ø¦ÛŒ Ú¾Û’ Ø§ÙˆØ± ÙØ¶Ù„ Ø´ÛŒØ·Ø§Ù† Ú©ÛŒ Ø¬Ù†Ø³ Ú¾Û’ Ù…Ú©Ø§Ø± Ø§ÙˆØ± ØºØ¯Ø§Ø± Ú¾Û’ Ø§ÙˆØ± Ø§Ù† ØªÛŒÙ†ÙˆÚº Ø³Û’ Ø¨Ú‘Û’ Ø¨Û’ ØºÛŒØ±Øª ÙˆÛ Ù„ÙˆÚ¯ ÛÛŒÚº Ø¬Ùˆ Ø¨Ú‘Û’ Ø¨Ú‘Û’ Ø¹ÛØ¯ÙˆÚº Ù¾Ø± Ø¨ÛŒÙ¹Ú¾Û’ ÛÙˆØ¦Û’ ÛÛŒÚº Ø§Ú¯Ø± ÛŒÛ Ø¢ÙØ³Ø± Ø´Ø§ÛÛŒ Ø§Ù¾Ù†Û’ Ø¨Ø§Ù¾ Ú©ÛŒ Ø§ÙˆÙ„Ø§Ø¯ ÛÙˆØªÛ’ ØªÙˆ Ù¾Ø§Ú©Ø³ØªØ§Ù† Ú©Ø§ ÛŒÛ Ø­Ø§Ù„ Ù†Û ÛÙˆØªØ§ Ù„ÛŒÚ©Ù† Ù†Ø§Ø§Ù…ÛŒØ¯ÛŒ Ú¯Ù†Ø§Û Ú¾Û’ Ø§ÙˆØ± ÛÙ… Ù†Û Ø§Ù…ÛŒØ¯ Ù†ÛÛŒÚº Ø§Ù„Ù„Û Ø³Ø¨Ø­Ø§Ù†Û ÙˆØªØ¹Ø§Ù„ÛŒ Ú©ÛŒ Ù„Ø§Ù¹Ú¾ÛŒ Ø¨Û’ Ø¢ÙˆØ§Ø² ÛÛ’ Ø§ÙˆØ± Ù…ÛŒÚº Ø¯Ø¹Ø§ Ú©Ø±ØªØ§ ÛÙˆÚº Ø§Û’ Ø±Ø¨ Ø§Ù„Ø¹Ø§Ù„Ù…ÛŒÙ† Ø§Ù† Ø¸Ø§Ù„Ù…ÙˆÚº Ù¾Ø± Ø§Ù¾Ù†ÛŒ Ù¾Ú©Ú‘ Ù…Ø¶Ø¨ÙˆØ· Ú©Ø± Ø§ÙˆØ± ØºØ±ÛŒØ¨ÙˆÚº Ù¾Ø± Ø§Ù¾Ù†Ø§ Ø±Ø­Ù… ÙØ±Ù…Ø§ Ø¢Ù…ÛŒÙ† ÛŒØ§Ø±Ø¨ Ø§Ù„Ø¹Ø§Ù„Ù…ÛŒÙ†
Mohammad Yousuf	Ú†ÙˆØ±Ù…Ú†Ø§Ø¦Û’ Ø´ÙˆØ±
atique ur rehman baig mirza	Allaha nay in ko apni akhirt or logo ki duniya savrny ka moga dia magr in ke tarjehat kuch or thee
sajjad Baga	Ø³ÛŒØ¯Ú¾ Ù…ÛŒÚº Ù¾ÛŒÙ¾Ù„Ø²Ù¾Ø§Ø±Ù¹ÛŒ Ù†Û’ Ù¾Ú¾Ú†Ù„Û’ 40 Ø³Ø§Ù„ Ù…ÛŒÚº Ú©ÛŒØ§ Ù„Ù† Ú©ÛŒØ§
LD TEK	Khursheed sahib if pti made next 5 year then pti will go to inner sindh and Imran can show them what he did for pakistan then ppp will loose all the seat in sindh maybe few seat they keep imran khan not a dishonest person and he have feeling for his nation And InshaAllah he will produce what he is saying he is not a business men neither need million of dollar for him self it s only 60 day 2months u can cry and try to put them under pressure basically don t take action on corruption But Imran khan Will not compromise he need to clear corruption from the country If they give hard time then Imran khan give it to army to take over and finish corrupted people s
Zaki Khan	Ø¹Ù…Ø±Ø§Ù† Ø®Ø§Ù† Ú¾Ù…Ø§Ø±Ø§ Ù„ÛŒÚˆØ± Ú¾Û’ Ø§Ø³ Ú©Ùˆ ØªÙ…Ø§Ù… Ù¾Ø§Ú©Ø³ØªØ§Ù†ÛŒÙˆÚº Ù†Û’ ÙˆÙˆÙ¹ Ø¯ÛŒØ§ Ú¾Û’ Ø§ÙˆØ± Ø§Ø¨ Ú¾Ù… 2 Ø³Ø§Ù„ Ú©Ø§ ÙˆÙ‚Øª Ø¨Ú¾ÛŒ Ø¯ÛŒØªÛ’ Ú¾ÛŒÚº Û”
Umar Siddique	Ya ye mulk bachy ga ya ye chor bachy gy Yad hai na PM ki bat Or InshaaAllah ye mulk bachy ga
Javed malik iqbal	Good Bhatti sb
Azhar	Let s have referdam on nawaz zardari to hang them they are certified beqarats and thevies
nuzhat jehan	They both want to loted Pakistan money
Shawn Ali	Great info Bhati sahib you â€™ re great
Mubashar Iqbal	PTI aur Imran Khan ko wqat dain plz 35saal ka hasb ley rehy hain
Masood Ahmed	Agr inngon ne koe ghalat harkat ki to yeh dabadgose ho jaen ge
best videos	Pakistan Kay log dua dainge AGR in corrupt logo say Jan chot jaye to
Abu Hamash	Ø­Ù…ÙŠØ¯ Ø¨ØªÙ‰ Ø­Ø±Ø§Ù…Ù‰ Ø´Ø±Ø§Ø¨Ù‰ ØµØ§ Ø¨Ø± Ø´Ø§ÙƒØ± Ø­Ø±Ø§Ù…Ù‰ Ø´Ø±Ø§Ø¨Ù‰ Ø¯ÙˆÙ†Ùˆ Ø­Ø±Ø§Ù…Ù‰ Ø´Ø±Ø§Ø¨Ù‰
Ghulam Mustafa	Nawaz or zardari aik sekey k dow rokh hain Kal yehi bat Imran khan k barey main nawaz shareef kehtey they Aj to pmln s or ppp s supporter ko kuch na kuch dont mind sharn to a rahee ho ge
storm gaming	Bhatti sb zindabad
asif Khan	I love my ledar ik
usman awan	Imran khan in choro ko ni chora ga inshaAllah
dilbaz malik	Dakoo gang ko jub loota mal k pakra jana ka khatra ho to aik ho jata hain
Sajad Khan	Hang all the corrupt people soon please Pm khan is a grt leader
Qaiser Khan	Ú©Ø¨Ú¾ÛŒ Ú©ÛØªÛ’ Ú¾ÛŒÚº Ø¯Ø§Ú¾Ù†Ø¯Ù„ÛŒ ÛÙˆÛŒ Ú¾Û’ Ú©Ø¨Ú¾ÛŒ Ú©ÛØªÛ’ Ú¾ÛŒÚº Ù„ÙˆÚ¯ÙˆÚº Ù†Û’ Ø±Ø§Ø¯ Ú©ÛŒØ§ ÛŒÛ Ù¾Ø§Ú¯Ù„ ØªÙˆ Ù†ÛÛŒÚº Ú¾Ùˆ Ú¯ÛŒÛ’ Ú©ÛÛŒÚº
Ismaellkhan Khan	Pakistan zindabad PTI zindabad imran khan khan zindabad NAB zindabad FIA zindabad JIT zindabad
Mian Sajid	Allah Pakistan pe rahim kryy Ameen
zahid rafique	Pakistan Mein Naik movie wala role model chaiye
Aftab Arzo	Pak awaam intahai jahil hain jo in chooro ko vot deti hain
Jawad Ahmed	Zardsri dog Nawaz dog
Imran Ali	chlo kush sahfi to achy han
Siddique Ù…Ù„Ú©	Ø°Ø§ØªÛŒ Ù…ÙØ§Ø¯Ø§Øª Ù¾Ø± Ø²Ø±Ø¯Ø§Ø±ÛŒ Ø§ÙˆØ± Ù†ÙˆØ§Ø² Ø´Ø±ÛŒÙ Ù…ÙˆÙ„Ø§Ù†Ø§ ÙØ¶Ù„ Ø§Ù„Ø±Ø­Ù…Ù† Ø¬ÛŒØ³Û’ Ù†Ø§Ø³ÙˆØ± Ø§Ù†Ø¯Ø± Ø³Û’ Ø§ÛŒÚ© Ú¾ÛŒ Ú¾ÛŒÚº Ù…Ù†Ø§ÙÙ‚Øª Ú©ÛŒ Ø³ÛŒØ§Ø³Øª ÚˆØ§Ú©ÙˆÙˆÚº Ú©Ø§ Ù…Ø´ØºÙ„Û Ú¾Û’ Ø¹ÙˆØ§Ù… Ú©Ùˆ Ø¨Û’ ÙˆÙ‚ÙˆÙ Ø¨Ù†Ø§ÛŒØ§ Ø¬Ø§ØªØ§ Ú¾Û’
Qadir Khan	Chrou ke mot Ana vali ha
Abdul Qayyum	Saray corrupt wish I can hang them khaqan abbasi who couldn t win from his own area 2 seat s and that Nawaz Sharif Ka Nisha and zardari lanti munfiq
Javed Malik feroz	Good show
Avinash Kumar Avinash	Bhtti sb jardari nawaz ko ek crne valo me aap log imran khan adaliya Esteblisment samil hen
Niaz Muhammad	Hara kanooni nezam fail ho choka hy jo zardar our nawaz ko 3 salo main saza na de saki
Amjid Ali	3 good man salaam 3 ko
MegaGullala	Nawaz Sharif Zinda Baad
Asim Ali	Imran khan zindabad p t i
Ijaz Awan	â€Ø§Ú¯Ø± Ù†ÙˆØ§Ø² Ø´Ø±ÛŒÙØŒ ÛŒØ§ Ø²Ø±Ø¯Ø§Ø±ÛŒ Ø¬ÛŒØ³Û’ Ø¹Ø¸ÛŒÙ… Ù„ÛŒÚˆØ± Ú†Ø§Ø¦ÛŒÙ†Û Ú©Û’ Ù¾Ø§Ø³ ÛÙˆØªÛ’ ØªÙˆ 10 Ø³Ø§Ù„ Ù¾ÛÙ„Û’ ÛÛŒ Ù¾Ú¾Ø§Ù†Ø³ÛŒ Ù„Ú¯ Ú†Ú©Û’ ÛÙˆØªÛ’ ğŸ˜
Abu Bakar	Allah inchoro sy bachay
mario khan	Ø¹Ù…Ø±Ø§Ù† Ø®Ø§Ù† Ø²Ù†Ø¯Û Ø¢Ø¨Ø§Ø¯ Û”Û”Û”
Kazi Shahid	Ù†ÙˆØ§Ø² Ø´Ø±ÛŒÙ Ù…Ù†Ø§ÙÙ‚ ÛÛŒÚº Ø²Ø±Ø¯Ø§Ø±ÛŒ Ù…Ù†Ø§ÙÙ‚ ÛÛŒÚº Ø§Ù„Ù„Ù‡ Ú©Ø±Û’ Ú©Û Ù¾Ø§Ú©Ø³ØªØ§Ù†ÛŒ Ø¹ÙˆØ§Ù… Ú©ÛŒ Ø§Ù†Ø³ÛŒÛ’ Ø¬Ø§Ù† Ú†Ú¾ÙˆÙ¹ Ø¬Ø§Ø¦Û’
Shah zain	Ù†ÙˆØ§Ø²Ø´Ø±ÛŒÙ Û” Ø²Ø±Ø¯Ø§Ø±ÛŒ Ø§ÙˆØ± Ù…ÙˆÙ„Ø§Ù†Ø§ ÚˆÛŒØ²Ù„ ÛŒÛ Ù„ÙˆÚ¯ Û”Û” Ø³ÛŒØ§Ø³ØªØ¯Ø§Ù† ØªÚ¾ÙˆÚ‘ÛŒ ÛÛŒÚº Û”Û” ÛŒÛ Ø³Ø¨ Ø¬Ø±Ø§Ø¦Ù… Ù¾ÛŒØ´Û Ù„ÙˆÚ¯ ÛÛŒÚº Û”Û”Û”
Razi Sin	Zardari aur nawaz khandaan ko fori andar karo yeh buhat hi zalil log hai
Haji Ajmal	Ø¯ÙˆÙ†ÙˆÚº Ú†ÙˆØ± Ø¨Ú¾Ø§ÛŒ Ø¨Ú¾Ø§ÛŒ ÛÛŒÚº
Raina Khanum	Reporters report is based on fact honest true analysis ğŸ‘ğŸ‘
Mike Waheed	aik hota hai Aqeeda aur doosra hota hai ehtaram yeh eak janglee loog hai aur janweroon ki tarah goonda gardee society may maal banay kay liyaee qatal aur maar koot karwatay hain apnay naukeroon say enka kisee per na tu aqeeda hay aur na hi ehtaram aur yeh Zardaree jaisay loog apnay Baap say yehee seekh ker aaj baray politician hain jo keh mera joota bhee saf kernay kay qabil nahee
Ad Ad	Ø¹Ù…Ø±Ø§Ù† Ø®Ø§Ù† Ú©Ùˆ Ù¹Ø§Ø¦Ù… Ø¯Ùˆ Ø¹Ù…Ø±Ø§Ù† Ù…Ù„Ú© Ø¨Ù†Ø§Ø¦ÛŒÚ¯Ø§
Rukashana Waheed	tow theaf together lakdelanet lakdelanet lakdelanet lakdelanet ğŸ‘‹ğŸ‘‹ğŸ‘‹ğŸ‘‹ğŸ‘‹ğŸ‘‹ğŸ‘‹ğŸ‘‹ğŸ‘‹ğŸ‘‹fatamue lanet Lanet lakthelanet
Ali jan afridi	Ù…Ø¬Ú¾Û’ Ø§Ù† Ù„ÙˆÚ¯ÙˆÚº Ú©Û’ Ø¹Ù‚Ù„ Ù¾Ø± ØªØ¹Ø¬Ø¨ Ú¾Û’ Ø¬Ù† Ù„ÙˆÚ¯ÙˆÚº Ù†Û’ Ù¾ÛŒÙ¾Ù„Ø²Ù¾Ø§Ø±Ù¹ÛŒ Ú©Ùˆ ÙˆÙˆÙ¹ Ø¯ÛŒØ§ Ú¾Û’ Ø³Ù†Ø¯Ú¾ Ú©Û’ Ù„ÙˆÚ¯ Ø³Ù†Ø¯Ú¾ Ù¾Ø± Ù‚ÙˆÙ… Ù¾Ø±Ø³ØªÛŒ Ú©Ùˆ Ø°ÛŒØ§Ø¯Û ÙÙˆÙ‚ÛŒØª Ø¯ÛŒØªÛ’ Ú¾Û’
Muhammad Malik	You are really Talented
Shoaib Memon	Imran khan ne bhi to bohot sangeen ilzamat lagaye the MQM MLQ or yahan tak ke independent candidate pe to phir kiya imran khan ne zarorat ki khatir unse hath nhen milaya Imran khan Nawaz Sharif or Asif Zardari Subh aek cheez han
Adee Khan	PTI ZINDABAD IMRAN KHAN ZINDABAD ASAD UMAR ZINDABAD CJP ZINDABAD PAK ARMY ZINDABAD â¤ï¸
MALIK ASIF	BEGHRAT PPP AND PMLN
Waseem Akram	Pigggg nawaz piggggg pmln
Hina Niazi	Ø¨Ú¾Ù¹Ùˆ ÙˆÛØ§Úº Ø²Ù†Ø¯Û ÛÛ’ Ø¬ÛØ§Úº Ø¬ÛØ§Ù„Øª Ø²Ù†Ø¯Û ÛÛ’ Ù†ÙˆØ§Ø²Ø´Ø±ÛŒÙ ÙˆÛØ§Úº Ø´ÛŒØ± ÛÛ’ Ø¬ÛØ§Úº Ø¬ÛØ§Ù„Øª Ú©Ø§ÚˆÚ¾ÛŒØ± ÛÛ’ Û”Û”Û”
Shah Zaib	Allah kry IK khamyab ho
