Pradeep Kumar	Super bro jai janasena ğŸ‘ŒğŸ‘ŒğŸ’–ğŸ’–
Sridhar Palle	Nice
keerthana printers	edi ma village frnds
rao43533	Great inspired song
miriyala ashok	Superb song
durga prasad	Superba jai janasena
saisiddartha saisiddartha	Sprr voice and lyric greatâ™¥ï¸
Siva Jakkampudi	excellent song super
Mahesh Macharla	Super
gantala balu	mind bloving
mahesh palabindela	Jai Telangana
Sivaiah Y	song is nice Pawan Kalyan is best
bonela eswararao	Mn msdj
dj songs 2018	Jai pavan kalyan
Akshith goud	Nice Song Lacation
sai krishna	fiastval ku kudda rajacehama
Kurakula Suresh	Jai Jena sena
Anil Anil	Anna super jai janasena jai pawan Anna ğŸ’–ğŸ’–ğŸ’–
Yashow TV	à°¨à±‡à°¨à± à°¸à°‚à°—à±€à°¤à°‚ à°¸à°®à°•à±‚à°°à±à°šà°¿ à°—à°¾à°¨à°‚ à°šà±‡à°¸à°¿à°¨ à°œà°¨à°¸à±‡à°¨ à°¬à°¤à±à°•à°®à±à°® à°ªà°¾à°Ÿà°•à± à°¸à±à°ªà°‚à°¦à°¿à°‚à°šà°¿ à°ªà°µà°°à± à°¸à±à°Ÿà°¾à°°à± à°œà°¨à°¸à±‡à°¨à°¾à°§à°¿ à°¨à±‡à°¤ à°ªà°µà°¨à± à°•à°³à±à°¯à°¾à°£à± à°—à°¾à°°à°¿ à°¨à±à°‚à°¡à°¿ à°…à°­à°¿à°¨à°‚à°¦à°¨à°²à± à°°à°¾à°µà°¡à°‚ à°¨à°¿à°œà°‚à°—à°¾ à°¨à°¾ à°…à°¦à±ƒà°·à±à°Ÿà°‚à°—à°¾ à°­à°¾à°µà°¿à°¸à±à°¤à±à°¨à±à°¨à°¾à°¨à± à°‡à°‚à°¤ à°®à°‚à°šà°¿ à°ªà°¾à°Ÿ à°šà±‡à°¸à±‡ à°…à°µà°•à°¾à°¶ à°®à°¿à°šà±à°šà°¿à°¨ à°®à°¾ à°ªà±à°°à±Šà°¡à±à°¯à±‚à°¸à°°à± à°ªà°µà°¨à°¿à°œà°‚ à°¸à°¤à±€à°·à± à°°à±†à°¡à±à°¡à°¿ à°—à°¾à°°à°¿à°•à°¿ à°¦à°°à±à°¶à°•à±à°¡à± à°°à°¾à°®à± à°¨à°¾à°°à°¾à°¯à°£à± à°—à°¾à°°à°¿à°•à°¿ à°°à°šà°¯à°¿à°¤ à°µà±†à°¨à±à°¨à±†à°² à°¶à±à°°à±€à°¨à°¾à°¥à± à°—à°¾à°°à°¿à°•à°¿ à°œà°¨à°¸à±‡à°¨ à°«à°¾à°¨à±à°¸à± à°ªà±à°°à°¤à°¿ à°’à°•à±à°•à°°à°¿à°•à°¿ à°¨à°¾ à°•à±ƒà°¤à°œà±à°à°¤à°²à± à°¤à±†à°²à°¿à°¯à°œà±‡à°¸à±à°¤à±‚ à°®à±€ à°¯à°¶à±‹ à°•à±ƒà°·à±à°£
Parkash Dhotare	prakash dhotre
Ch Venkatesh	Jai janasena
Masapogu Eranna	supper
Ram Narayan	Thank you all for the lovely response reached one million view and counting JAI JANASENA
Shaik Meera	jai Janasena
Inala Someshwar	ğŸ‘ğŸ‘ğŸ‘ğŸ‘ŒğŸ‘Œ
Ixifxifxigx Ufxitxoy	Superb
E Surendra	nice song
power thimmy 4443	Supur Janasena Bathukamma Song
Uady Bhanu	Super
Venkateswarlu Parri	op
Pavanyadav Pavanyadav	Love you power star annaya
Srineevas bodasingi	Jai batukamma Jai Telangana jai janasena Jai Hindh
Anil Pasupulate	Super super super
Krish Murali	Nice bro
Kasi Chiru	Super song
Johnunocompromise Vanaparla	Super osm jai jana sena
kasipeta swamy	Chaala bagundi
Devasoth pavan rathod chinna prc thanda 7995651875	bathukama super song
Nuto Mondal	Jai janasena p pk Suresh janasena p pk Suresh janasena p pk Suresh ğŸ’ªğŸ’ªğŸ’ªğŸ’ªğŸ’ªğŸ’ªâœŠâœŠâœŠ
Vikram nayak	I am watching after my god tweet and jai powerstar jai telangana
Killaka Mahesh	Annayya super song excellent jai janasena
Chandu Adepu	Nice job brother
Giri Babu	super nna
meera Nagul Meera	jai janasena pk
udp pawanisam	Osm song jai janasena
veeresham Mahankali	Nice
Dattatreya Naik	Pawan Kalyan Anna chusaava nimeeda Prema
Telangana janasena party	Jai janasena happy dasara
Prasad lovely	Sprr Anna song
Satiah Sama	jai Janasena
Siva Narla	super
Usman Md	Superb Anna Dis usman from hyd Dancer
jeebley driver53	à°¬à°¤à±à°•à°®à±à°® à°ªà°‚à°¡à±à°— à°¶à±à°­à°¾à°•à°¾à°‚à°•à±à°·à°²à± à°ªà°¾à°Ÿ à°šà°¾à°²à°¾ à°¬à°¾à°—à±à°‚à°¦à°¿
Srinivas K. Srinivas	Srinivas Super song
Munavath Raju	Super rrrrrr
Ashokgude Mhbd	à°ªà°µà°¨à±‚à°•à°²à±à°¯à°¾à°¨à±‚ à°¤à±‡à°²à°‚à°—à°¾à°£ à°ªà°Ÿà±à°²à°¾ à°µà°¿à°¶à±à°µà°¾à°¸à°‚à°—à°¾ à°‰à°‚à°Ÿà°¾à°¡à°¨à±à°•à±‹à°µà°¡à°‚ à°®à±‚à°°à±à°–à°¤à±à°µà°‚ à°®à°¾ à°¤à±‡à°²à°‚à°—à°¾à°£à°•à± à°¤à±‡à°²à°‚à°—à°¾à°£ à°ªà°¾à°°à±à°Ÿà±€à°²à± à°¤à±‡à°²à°‚à°—à°¾à°£ à°¬à°¿à°¡à±à°¡à°²à±‡ à°¨à°¾à°¯à°•à°¤à±à°µà°‚ à°µà°¹à°¿à°‚à°šà°¾à°²à°¿
SSK Raju	Bokka la undi
Syed Imran	Superb anna
Shankar Ravulakola	0
Surender Kumaar	jai telangana song super
Yanjaneyulu Yamala	jai Jana sena 2019 cm pspk pakka
Raju Ammulu	Very nice sogu
Narsimhasambana Sambana	Jai janasena
santhamkumar 143	Super song anna love uou
Mohan Nayak	super ana p
Damodar Dasari	Super song jai janasena
k venkata sivaiah	Nice Song
Chiranjeevi dasari	Chiranjeevi my
Rameshbabu Babu	à°¸à±‚à°ªà°°à± à°ªà°¾à°Ÿ
Nani Anusuri	Andaru bagundali andhilo pk undali
Shaik Abdhulla	super song jai janasena
Nokine Rakesh	Jai Pawan anna
Jyothi J	Super song jai Janasena âœŠâœŠâœŠ
Aravind Model	Jai pavan kalyan super song think s pavan kalyan anna
G Prathap	Super song
à°¶à±à°°à±€à°§à°°à± à°—à±‹à°°à±†à°‚à°Ÿà±à°²	Hatsoff to you sathish reddy à°’à°• à°¸à°¿à°¨à°¿à°®à°¾ à°šà±‚à°¸à°¿à°¨à°Ÿà±à°Ÿà±à°‚à°¦à°¿ à°®à°¾ à°µà±†à°²à±à°—à±à°ªà°²à±à°²à°¿ à°¨à°¿ à°ªà±à°°à°ªà°‚à°šà°¾à°¨à°¿à°•à°¿ à°‡à°‚à°¤ à°…à°‚à°¦à°‚à°—à°¾ à°šà±‚à°ªà°¿à°‚à°šà°¿à°¨ à°¦à°°à±à°¶à°•à±à°¨à°¿à°•à°¿ à°µà°‚à°¦à°¨à°¾à°²à± à°’à°• à°µà±†à°²à±à°—à±à°ªà°²à±à°²à°¿ à°µà°¾à°¸à°¿ à°—à°¾ à°¨à±‡à°¨à± à°—à°°à±à°µà°ªà°¡à±à°¤à±à°¨à±à°¨à°¾à°¨à± à°®à°¾ à°µà±†à°²à±à°—à±à°ªà°²à±à°²à°¿ à°‡à°‚à°¤ à°¬à°¾à°—à±à°‚à°¦à°¿ à°…à°¨à°¿ à°¨à±‡à°¨à± à°•à±‚à°¡à°¾ à°…à°¨à±à°•à±‹à°²à±‡à°¦à± à°®à°‚à°šà°¿ à°¨à°¿à°°à±à°®à°¾à°¤ à°¨à±à°‚à°¡à°¿ à°®à°°à°¿à°•à±Šà°¨à±à°¨à°¿ à°µà±€à°¡à°¿à°¯à±‹à°ªà°¾à°Ÿà°²à°¨à± à°•à±‹à°°à±à°•à±à°‚à°Ÿà±à°¨à±à°¨à°¾à°‚ à°…à°¦à°¿ à°•à±‚à°¡à°¾ à°µà±†à°²à±à°—à±à°ªà°²à±à°²à°¿ à°²à±Šà°¨à±‡ à°·à±‚à°Ÿà°¿à°‚à°—à± à°šà±‡à°¯à°¾à°²à°¨à°¿ à°¡à°¾à°¨à±à°¸à°°à±à°¸à± à°²à°¿à°°à°¿à°•à±à°¸à± à°à°¡à°¿à°Ÿà°¿à°‚à°—à± à°¸à°¿à°‚à°—à°¿à°‚à°—à± à°…à°¨à±à°¨à±€ à°µà°¿à°­à°¾à°—à°¾à°²à± à°¸à±‚à°ªà°°à± à°®à°¨ à°µà±†à°²à±à°—à±à°ªà°²à±à°²à°¿ à°—à±à°°à°¿à°‚à°šà°¿ à°ªà°¾à°Ÿ à°šà±‡à°¸à±à°¤à±‡ à°¬à°¾à°—à±à°‚à°Ÿà±à°‚à°¦à°¨à°¿ à°¨à°¾ à°…à°­à°¿à°ªà±à°°à°¾à°¯à°‚
Ranjith Pidugu	Jai Janasena jai Telangana
chandramouli karanam	ğŸ‘ŒğŸ‘ŒğŸ‘ŒğŸ‘Œ
Dasari Dhananjaneyulu	Super song
Sambaraju Manchala	Super song
Galinki Prakash	ğŸ‘ŒğŸ‘ŒğŸ‘ŒğŸ‘ŒğŸ‘ŒğŸ‘ŒğŸ‘ŒğŸ‘ŒğŸ‘Œ
vijay pspk	Jai janasena vijay pspk
Jitesh pawanism	Jai jansena
Shekar Shekar	Anna Super ga Undi Anna song inka MA power star Pawan Kalyan Annayya dhi Oka padu anna
raki N.R.P	jai p s pk jai T G
MARMAM NAGESH	ğŸ‘ŒğŸ‘ŒğŸ‘Œ
Prem Bupelli	jai telangana jai pspk
shiva shankar	super song ğŸ‘ŒğŸ‘ŒğŸ‘Œ super mucic ğŸ‘ŒğŸ‘ŒğŸ‘ŒğŸ‘ŒğŸ‘ŒğŸ‘Œ super lyric ğŸ‘ŒğŸ‘ŒğŸ‘ŒğŸ‘ŒğŸ‘Œ
VIKAS	Wow
Nalamada Suresh	Super song anna
Srikanth M	à°¸à±‚à°ªà°°à± à°¸à°¾à°‚à°—à±
Madhireddy Reddy	Song is touched Anna voice is too good and location nice
Subbu Subbu	Super song
Ramya Kumari	e year vachina bathukamma song edi top1 lo untadi bagundi song nenu oka 100 time vinnanu
Saikumar Mangali	Super à°œà°¨à°¸à±†à°¨
Gopi Naidu	Jai janasena
Kola Prasad	Jai janasena
Kishore C	Super song
Rathod Ramesh Kumar Rathod Ramesh Kumar	à°’à°• à°¸à°¿à°¨à°¿à°®à°¾ à°šà±‚à°¸à°¿à°¨à°Ÿà±à°Ÿà±à°‚à°¦à°¿ à°®à°¾ à°µà±†à°²à±à°—à±à°ªà°²à±à°²à°¿ à°¨à°¿ à°ªà±à°°à°ªà°‚à°šà°¾à°¨à°¿à°•à°¿ à°‡à°‚à°¤ à°…à°‚à°¦à°‚à°—à°¾ à°šà±‚à°ªà°¿à°‚à°šà°¿à°¨ à°¦à°°à±à°¶à°•à±à°¨à°¿à°•à°¿ à°µà°‚à°¦à°¨à°¾à°²à± à°’à°• à°µà±†à°²à±à°—à±à°ªà°²à±à°²à°¿ à°µà°¾à°¸à°¿ à°—à°¾ à°¨à±‡à°¨à± à°—à°°à±à°µà°ªà°¡à±à°¤à±à°¨à±à°¨à°¾à°¨à± à°®à°¾ à°µà±†à°²à±à°—à±à°ªà°²à±à°²à°¿ à°‡à°‚à°¤ à°¬à°¾à°—à±à°‚à°¦à°¿ à°…à°¨à°¿ à°¨à±‡à°¨à± à°•à±‚à°¡à°¾ à°…à°¨à±à°•à±‹à°²à±‡à°¦à± à°®à°‚à°šà°¿ à°¨à°¿à°°à±à°®à°¾à°¤ à°¨à±à°‚à°¡à°¿ à°®à°°à°¿à°•à±Šà°¨à±à°¨à°¿ à°µà±€à°¡à°¿à°¯à±‹à°ªà°¾à°Ÿà°²à°¨à± à°•à±‹à°°à±à°•à±à°‚à°Ÿà±à°¨à±à°¨à°¾à°‚ à°…à°¦à°¿ à°•à±‚à°¡à°¾ à°µà±†à°²à±à°—à±à°ªà°²à±à°²à°¿ à°²à±Šà°¨à±‡ à°·à±‚à°Ÿà°¿à°‚à°—à± à°šà±‡à°¯à°¾à°²à°¨à°¿ à°¡à°¾à°¨à±à°¸à°°à±à°¸à± à°²à°¿à°°à°¿à°•à±à°¸à± à°à°¡à°¿à°Ÿà°¿à°‚à°—à± à°¸à°¿à°‚à°—à°¿à°‚à°—à± à°…à°¨à±à°¨à±€ à°µà°¿à°­à°¾à°—à°¾à°²à± à°¸à±‚à°ªà°°à± à°®à°¨ à°µà±†à°²à±à°—à±à°ªà°²à±à°²à°¿ à°—à±à°°à°¿à°‚à°šà°¿ à°ªà°¾à°Ÿ à°šà±‡à°¸à±à°¤à±‡ à°¬à°¾à°—à±à°‚à°Ÿà±à°‚à°¦à°¨à°¿ à°¨à°¾ à°…à°­à°¿à°ªà±à°°à°¾à°¯à°‚
Durgaprasad entertainment	Super song meaningful lyric beautifull place excellent music finally mind blowing song finally ğŸ‘ŒğŸ‘ŒğŸ‘ŒğŸ‘ŒğŸ‘ŒğŸ‘ŒğŸ‘ŒğŸ‘ŒğŸ‘ŒğŸ‘ŒğŸ‘ŒğŸ‘ŒğŸ‘ŒğŸ‘ŒğŸ‘ŒğŸ‘ŒğŸ‘ŒğŸ‘ŒğŸ‘ŒğŸ‘ŒğŸ‘ŒğŸ‘ŒğŸ‘ŒğŸ‘ŒğŸ‘ŒğŸ‘ŒğŸ‘ŒğŸ‘ŒğŸ‘ŒğŸ‘ŒğŸ‘ŒğŸ‘ŒğŸ‘ŒğŸ‘ŒğŸ‘ŒğŸ‘ŒğŸ‘ŒğŸ‘Œ
mahendra chilkala	ni
Mukunda Nayak	Excellent
Gulipalli Eswara rao Ewara rao	jai janasena âœŠ
Vamshi krishna Kappala	Jai Janasenaâ¤ï¸
Sivaji Yeripalli	Super nice
Shiva swamy Swami	super
Ramu Ramanji	good song spr
Lingaswamy Yadav	xlent
Ashok Irugadindla	Jaipawananna
venkey valluri	super
Nani Reddy	Super
Narendra B	Telangana Prajalandariki batukamma ShubhakanshaluğŸ’ğŸ’ğŸ’ğŸ’ğŸ’ Janam mechhe nayakudu janasenuduki batukamma ashissulu yeppudu undalani korukuntu ğŸ™ğŸ™ğŸ™ ğŸ‡®ğŸ‡³Jai Janasena Jai HindğŸ‡®ğŸ‡³
Krishna Kavali	jai janasena jai Pawan Kalyan jai Telangana
satyannarayana reddy	à°®à°¾ à°†à°‚à°¦à±à°° à°²à±‹ à°•à±‚à°¡à°¾ à°¬à°¤à±à°•à°®à±à°® à°‰à°‚à°¡à°¿ à°‰à°‚à°Ÿà±‡ à°¬à°¾à°—à±à°‚à°¡à±à°¨à± à°…à°¨à°¿à°ªà°¿à°‚à°šà°¿à°‚à°¦à°¿ à°­à°¯à±à°¯à°¾ à°ˆ à°ªà°¾à°Ÿà°¤à±‹ à°¬à°¤à±à°•à°®à±à°® à°•à°¿ à°¨à°¾ à°¹à±ƒà°¦à°¯ à°ªà±‚à°°à±à°µà°• à°¨à°®à°¸à±à°•à°¾à°°à°‚ à°šà±‡à°¸à±à°¤à±‚ à°œà±ˆ à°œà°¨à°¸à±‡à°¨ ğŸ‘ŠğŸ‘Š
Kiran Maramulla	Janasena vennelanna bathukamma song super
Kishore kumar G	supper
Surpam Arju	Wow
Srikanth Methukupally	Fantastic song brother
MUTHYALA CHARAN	Jaijanasena ğŸ‘ŒğŸ‘ŒğŸ‘ŒğŸ‘ŒğŸ‘ŒğŸ‘ŒğŸ‘ŒğŸ‘ŒğŸ‘ŒğŸ‘ŒğŸ‘ŒğŸ‘ŒğŸ‘ŒğŸ‘ŒğŸ™ğŸ™ğŸ™ğŸ™ğŸ™â­â­â­âœŠ
chinnu varun	Jai jcp
Neelam jayasree	M verry happy to be in this song ededu lokaala poola poojalu Line lo unnaduku
Bukya Balaji Naik	Super song à°…à°¨à±à°¨
Sai naveen	2018 s wonderfull batukamma song Velugupally
Praveen Kumar Yadav	Super song And Depth meaning
Eswar Budireddy	super song
murali datti	Pata Lo feel prema nature talli kanipistundi Super fantastic video song All the best for your bright future anna
Nookaraju Sabbi	Jai pawan
Chandu Chandu	Super
pranay nikii	Nyc
krish krish	Xxxlent
shanigaram bikshapathi	Superb anna
Sandeep dsp	Super video Jai janasena
paparao majji	Nice fock song
Kethepally Krishnaiah	Super Anna
Reni Srinivas Yadava	à°œà±ˆ à°¤à±†à°²à°‚à°—à°¾à°£ à°œà±ˆ à°œà°¨à°¸à±‡à°¨
Devi prasad	Jai Power star
Shiva Shankar goud	super Anna
pk janani	Jai Telangana Jai janasena
Mudavath Hari	Jai pavarstar
santosh beesa	Nice à°œà°¨à°¸à±‡à°¨ à°ªà°¾à°°à±à°Ÿà±€ à°•à±‚à°¡à°¾ à°’à°• à°ªà°¾à°Ÿ relese à°šà±‡à°¯à°¡à°‚ à°šà°¾à°²à°¾ à°¸à°‚à°¤à±‹à°·à°‚à°—à°¾ à°‰à°‚à°¦à°¿
Mohan Mohan	pspk
Pomar Nagaraju Pomar Nagaraju	Super Anna Adirindi super Akka Jai Jai janasena Jai Jai Pawan Kalyan
Sukumar Reddy	Jai pawanism janasena
manjunath V.	Wounder full meaning
SUDHEER ODAPELLI	Nillala liriks nunddi kirrak vunddi ilet super ğŸ‘
Bhanu Chand Varikunta	Superb song à°œà±ˆ à°œà°¨à°¸à±‡à°¨
Srini Vas	Super Anna jai power star jai janasena
Sombabu Pinninti	Jai janasena
Rajamallu Sonaveni	super jai PS
Jilakara Venkatrao	Jai power starrrrrr
KUMARASWAMY AGURLA	à°®à°‚à°šà°¿ à°¬à°¤à±à°•à°®à±à°® à°ªà°¾à°Ÿ
prashanth kumar	anna pata edhi dinni manam modati sthanamlo unchali anna jai pawan anna
shiva srinivas	Wow nice song
Vamshi teja22	Nice song
Lakshman Perla	song is very nice
Kindigeri Venu	Jay
Kampasati Satheesh	Super
Prasad Batchala	Janasena
Venkatesh Erothu	Jai Janasena
Animireddy Sannynaidu	Jai janasena
Pawan Kalyan	Superrr song love you Pawankalyan
Sudhakar M	à°¸à°¾à°‚à°—à± à°šà°¾à°²à°¾ à°¬à°¾à°—à±à°‚à°¦à°¿ à°¸à±‚à°ªà°°à±
RAJU KURVA	Jai janasena ğŸ™ğŸ™ğŸ™ğŸ™ğŸ™
Pasula Ganesh	chandu chandu
ours parushuram	super song
GURU SWAMY	à²œà³ˆ à²œà²¨à²¸à³‡à²µà³† à²œà³ˆ à²ªà²µà²°à³ à²¸à³à²Ÿà²¾à²°à³ à²ªà²µà²¨à³ à²•à²²à³à²¯à²¾à²£à³
MEGA RAMS CLUB	super song audio video rendu bagunnai pawan is great
Sreekanth Sreekanth	ary bathukama song ni rajakiyam chestara meru bagupadaru ra
Sadhe Raju	Supppooaarrr
srinivas marka	http youtu be k8MAWcr4cGw à°¨à±ˆà°¸à± à°¸à°¾à°‚à°—à±
Datta Madival	ğŸ‘ŒğŸ‘Œ
RaVi McA	à°’à°• Level à°²à±‹ à°‰à°‚à°¦à°¿ à°…à°¨à±à°¨ Song ğŸ˜²ğŸ˜²ğŸ˜² Jai Power StarğŸ’ªğŸ’ªğŸ’ª Jai Janasena âœŠâœŠâœŠ
sabavat rameshchowhan92	super Anna
Emmadi Arjunaiah	jai jenasena
Rajanarsimha Cherry	Superb
Lokesh Pspk	Jai pavaisam
CHALLAGALI CNU villeg life	à°¤à±†à°²à°‚à°—à°¾à°£ à°¸à°‚à°¸à±à°•à±ƒà°¤à°¿ à°µà°°à±à°¥à°¿à°²à±à°²à°¾à°²à°¿
nagesh naik	Super Songs Com
desham kosam	Jai janasena jai telangana
superbbb Aadi Kalyan	superbbb song
Sandeep Sillam	jai janasena
Sivaji Pawan	Jai janasena
Riyaz Riyaz786	Super song
Sandya Ajmera	jahaho janasena jaya jaya hooo
chittari Anand	Jayahooooo janasenaaaa
Ravi Kumar	Nice Song i am watching after pk sir tweet
Banavath Seenu naik	im from andhra telangana adapaduchulandariki bathukamma subhakhanshalu
Ms Vikas	song chala bavundhiğŸ‘ŒğŸ‘ŒğŸ‘Œ
Village memorable videos Village	Jaipawan
Satya Saravana	e year mee song super 1st place of the batukamma song
Pillutla Srinivas	ğŸ‘ŒğŸ‘ŒğŸ‘ŒğŸ‘ŒğŸ‘Œ
S Balakrishna S Balakrishna	Santhaparapu balakrishna
Ranjith Penjarala	Super song jai Jena Sena
Ramesh Thurla Ramesh	jana sena bathukamma
Balu Desam	Super song
Raj Raj	à°…à°•à±à°•à°šà±†à°²à±à°²à±†à°²à±à°² à°¬à°¤à±à°•à°®à±à°® à°ªà°‚à°¡à±à°— à°¶à±à°­à°¾à°•à°¾à°‚à°•à±à°·à°²à± à°œà±ˆ à°œà°¨à°¸à±‡à°¨ à°œà±ˆ à°ªà°µà°¨à± à°¸à±à°Ÿà°¾à°°à±
sameer shaik	Jai janasena
kathi kala Kalamma	pspk
Sruthi Dubba	Jai jana sena
Kosuri HK Naidu	Super Anna tq Anna jai pawanism jai Jana Sena jai kisan jai javan jai jai jai hind
Shakar Shakar	Extrdanary
Bhadri gunnampalli	à°¬à°¤à±à°•à°®à±à°® à°ªà°‚à°¡à±à°— à°•à°¿ à°°à°¾à°œà°•à±€à°¯ à°ªà°¾à°°à±à°Ÿà±€à°² à°°à°‚à°—à±à°²à± à°ªà±à°²à°¿à°®à±‡ à°¨à°¾à°¶à°¨à°‚ à°šà±‡à°¸à±à°¤à±à°¨à±à°¨à°¾à°°à± à°•à°¦à°°à°¾
tiru perika	song is good jai pk
Ganesh Jakkala	Nic
Munikesava Raju	I really loved this song
Sai Kiran Goud	Festival song lo Jana sena adi ra meru me veshalu
Said reddy Ch	Jai mahilasena Jai Pawan
Potti Karthi	Tq jai power star Spr
BOTKU RAMAKRISHMA	Jai jenasena
M D Shafik	Hi
nagi nagiteju	jayaho pavananna
Ciddu Pspk	Okka song baga Led ani feel avthunnam bro Kani ee okka song saripothadhi ika
Thumma Srinath	Jai Telangana jai batukamma
Konne Krishna	Time vest song
Madhu power pk janasena	Ts Akka chellalaku andhari batukamma pandhu subakankuchalu
Laxmipathi Rathod	Maaku telangana vachchindani vaaram rojulu thinakunda badapadda manushula ki Maa bathukamma meeda Paata chese hakku Ledu Paata ki karakulaina prathi artist ki na hrudayapurvaka abhinandanalu plzz aa party Peru use cheyakandi aayana mana telangana vyathirekhi
naveen yadav	Superb song
Rama Chandrudu Chikkam	à°¬à°¤à±à°•à°®à±à°® à°ªà°‚à°¡à±à°— à°à°²à°¾ à°— à°‰à°‚à°Ÿà°¾à°¦à± à°¤à±†à°²à°¿à°¯à°¦à± à°•à°¾à°¨à°¿ à°¯à°¶à±‹ à°Ÿà±€à°µà±€ à°µà°¾à°°à± à°•à°³à±à°³à°•à± à°•à°Ÿà±à°Ÿà°¿à°¨à°Ÿà±à°Ÿà± à°šà±‚à°ªà°¿à°‚à°šà°¾à°°à± à°…à°¦à±à°­à±à°¤à°®à±ˆà°¨ à°¸à°‚à°—à±€à°¤à°‚ à°®à°¨à°¸à±à°¦à±‹à°šà±‡ à°šà°°à°£à°¾à°²à± à°…à°‚à°¦à°®à±ˆà°¨ à°²à±‹à°•à±‡à°·à°¨à± à°†à°¡à°µà°¾à°°à± à°•à±‚à°¡à°¾ à°šà°•à±à°•à°Ÿà°¿ à°¨à°Ÿà°¨ à°šà°¾à°²à°¾ à°…à°¦à±à°­à±à°¤à°‚à°—à°¾ à°¤à±€à°¸à°¿à°¨ à°¨à°¿à°°à±à°®à°¾à°¤ à°—à°¾à°°à±à°•à°¿ à°¯à°¶à±‹ à°—à°¾à°°à±à°•à°¿ à°œà°¨à°¸à±‡à°¨ à°¬à°¤à±à°•à°®à±à°® à°¬à±ƒà°‚à°¦à°‚ à°µà°¾à°°à°¿à°•à±€ à°ªà±‡à°°à± à°ªà±‡à°°à± à°¨ à°°à°¾à°·à±à°Ÿà±à°° à°œà°¨à°¸à±‡à°¨ à°ªà°¾à°°à±à°Ÿà±€ à°¤à°°à±à°ªà±à°¨ à°…à°¬à°¿à°¨à°‚à°¦à°¨à°²à± à°œà±ˆ à°œà°¨à°¸à±‡à°¨ à°¤à°¾à°³à±à°²à°°à±‡à°µà± à°®à°‚ à°®à±à°®à±à°®à°¿à°¡à°¿à°µà°°à°‚ à°¨à°¿à°¯à±‹à°œà°•à°µà°°à±à°—à°‚ à°¤à±‚à°°à±à°ªà±à°—à±‹à°¦à°¾à°µà°°à°¿ à°œà°¿à°²à±à°²à°¾ à°†à°‚à°§à±à°°à°ªà±à°°à°¦à±‡à°¶à±
Suresh V	Pspk
B Rajesh	jAi janasena
Krishna bolaram	Herts up Anna super song jai janasena jai pawan anna
Prasad Boddapu	Jai telangana jai jana sena
Shanmukha Akula	Osm song jai janasena
Æ˜Ó‡Æ›Æ§Æ–M S	Super Anna machi song with janasena song
Sissa Simhachalam	Jai janasena Jai bathukama
Bunny Ravi	ğŸ‘
Parshaveni Venu	jai telagana jai kcr
Dakshina Murthy	Super
Pavan Nayak	Jai pavanijam ğŸ˜‰ğŸ˜ super bhayya
Sudhakar Pasula	Jai janasena Jai Bhavani Jai Telangana
Mr Ronanki	Best song
sandeep edla	Jai jenasena
NAMALA VINAY	SUPER SONG TQ SIR FOR UPLOAD THIS SONG JAI PSPK JAI JANACENA
Gali Sivakumar	Super song Anna Jai janasena
ashok sho	Assume jai janasena ğŸŒ¹ ğŸŒ¹ ğŸŒ¹
srishylam Yadavking	super bro
Ramavath Shekar	Jai pspk
rakesh Ulli	2 23 voice super akkaya
Ch.srinu 1234	à°œà±ˆ à°œà°¨à°¸à±‡à°¨ à°ªà°µà°¨à± à°•à°²à±à°¯à°¾à°£à±
Simon Lion	Janasena bathukamma endhi ra ayya mottaniki rajakiyam chesthunnaru ga ğŸ˜ğŸ˜ but song superb
Marali Bala	Na telangana Adapaduchulaki batukamma shubakankshalu Jai jsp
vijay macha	à°œà±ˆ à°œà°¨à°¸à±‡à°¨âœŠ
Mittireddi Santhu Mittireddi Santhu	Super
Pallapu Prasad	Super hit song
Katrava Vijaykumar Vijay	Super song
Kanoor Ashok	jai janasena nice d song
Divya Paramesh	mast Jai pawan Jai hind next AP CM Pawan sir
Santhosh Enumula9912	year helight song jai janasena
Khammam don vÄ“Ã±ky	Jai JanaSenaâœŠâœŠâœŠ
Ramulu Nagapuri	Super song jai Pawan
Prakash Rallabandi	Jai PSPK Andhariki bathukamma Subhakankshalu ğŸ˜˜ğŸ˜˜ğŸ˜˜
Anusri Dontharaveni	Super Jai janasena
K Samba	Super ğŸ‘ŒğŸ‘ŒğŸ‘Œ
Siddharth Sai	Jai power star jai hind
Raj raj	08 to 34 second song super ofter 34 second routine song
AMBADAS AMBADAS	Nice
pothabathini ramakrishna	Annya supra supra jai pspk
Balu Goud	jai powe Star
kothapalli krishna	Good song anna tq Jai janasena
V Ravindar	à°¸à±‚à°ªà°°à± à°…à°¨à±à°¨
Bala sai9160609607	Super ğŸ‘ŒğŸ‘ŒğŸ‘ŒğŸ‘ŒğŸ‘ŒğŸ‘ŒğŸ‘ŒğŸ‘ŒğŸ‘ŒğŸ‘ŒğŸ‘ŒğŸ‘ŒğŸ‘ŒğŸ‘ŒğŸ‘ŒğŸ‘ŒğŸ‘ŒğŸ‘ŒğŸ‘ŒğŸ‘ŒğŸ‘ŒğŸ‘ŒğŸ‘ŒğŸ‘ŒğŸ‘ŒğŸ‘ŒğŸ‘ŒğŸ‘ŒğŸ‘ŒğŸ’
Gummula satheesh	Jai Jenasena super song brothar
Srihari Janasena	Jai janasena
prasad villa	VOTE FOR JANASENA FOR POLITICAL ACCOUNTABILITY STRONG CIVIL SOCIETY
ramu thuthunuri	Superble song e year best song
RAVVA PAVANKALYAN	Nice song
Srinath KS	super janasena song
mekala umanagendra	Nice song
nagaraja charala	nice song
Srinu Mamidi	great song
Air Roof Ventilator'S	Nice video Brothers nd Sisters
Naresh nani	Super
Rajashekhar Chepuri	Excellent Song Heart Touching Lyrics This is Bhathukamma Song Of the Year 2018
Koti P	ğŸ‘ŒğŸ‘ŒğŸ‘ŒğŸ‘ğŸ‘ğŸ‘ğŸŒ¹
Nalla Ravinder Reddy Nalla	à°ˆ à°¯à±Šà°•à±à°• à°ªà°¾à°Ÿ à°šà°¾à°²à°¾ à°¬à°¾à°—à±à°‚à°¦à°¿ à°œà±ˆ à°œà°¨à°¸à±‡à°¨ à°œà±ˆ à°ªà°µà°¨à± à°…à°¨à±à°¨
Naveen Kumar	Super jai janasena jai telangana
sai Mudhiraj	jai jana sena
k. ravi	super song
Mudavath Shankar	Jai janasena Jai jai telanganaâœŠâœŠ
Seenapelly Harish	Super song Anna jai janasena
manikanta bandaru	Super song jai janasena
SS Creations	jai janasena à°¤à±†à°²à°‚à°—à°¾à°£ à°¸à±‹à°¦à°°à±à°²à°•à± à°œà°¨à°¸à±‡à°¨ à°ªà°¾à°°à±à°Ÿà±€ à°¸à±ˆà°¨à°¿à°•à±à°²à°•à± Happy Bathukamma
saikiran k	Super song
Bharath Vempalli	Jai Jana senaaa
narala narsingyadav	Really super song
Nani Marupaka	Super bro jai JAnasena
saikumar putti	Andariki bathukamma shubhakamshalu
hnybee319	choreography very bad set kaledu bathukamma ani cheppi sankarnthi muggulatho start chesinlu mamulu song pittina bagundedi
Gabbar Singh janasena	Super super Jai janasena
Kanaveni Hanvika	à°¬à°¤à±à°•à°®à±à°® à°¶à±à°­à°¾à°•à°¾à°‚à°•à±à°·à°²à± à°…à°‚à°¦à°°à°¿à°•à°¿
Raj kumar nani	awesome song janasenani
SURESH VERPULA	Super song jana Sena ğŸ‘ğŸ‘ğŸ‘ğŸ‘ŒğŸ‘ŒğŸ‘ŒğŸ‘ğŸ‘ğŸ‘
Balu Kishan	Male voice lekunte bagundu
Banoth Naresh	super song jai power star jai jai janasena
gokari.samatha.glamar super i likit samantha	Super
gudishe abhishanth	Jai pawanisam pspk
Lokaprabhu Hanumanthu	à°µà°¾à°µà± à°…à°¨à±‡ à°›à°¾à°¨à°²à± à°•à°¿ à°•à°°à±†à°•à±à°Ÿà± à°—à°¾ à°¸à°°à°¿à°ªà±‹à°¯à°¿à°‚à°¦à°¿ à°ˆ à°ªà°¾à°Ÿ à°…à°‚à°¤ à°¬à°¾à°—à°¾ à°¡à±ˆà°°à±†à°•à±à°·à°¨à± à°šà±‡à°¶à°¾à°°à± à°…à°²à°¾à°¨à±‡ à°®à±à°¯à±‚à°œà°¿à°•à± à°•à°‚à°ªà±‹à°œà°¿à°‚à°—à± à°¯à°¾à°•à±à°Ÿà°¿à°‚à°—à± à°•à°¾à°¸à±à°Ÿà±à°¯à±‚à°®à±à°¸à± à°à°•à±à°¸à±à°²à±†à°‚à°Ÿà± à°¸à±à°•à±à°°à±€à°¨à± à°ªà±à°²à±‡ à°…à°¨à±à°¨à°¿ à°µà°¿à°§à°¾à°²à°¾ à°šà°¾à°²à°¾ à°¬à°¾à°—à°¾ à°¤à±€à°¶à°¾à°°à± à°¡à±ˆà°°à±†à°•à±à°Ÿà°°à± à°®à°°à°¿à°¯à± à°…à°¦à°°à± à°¡à°¿à°ªà°¾à°°à±à°Ÿà±à°®à±†à°‚à°Ÿà±à°¸à± à°µà°°à±à°•à°¿à°‚à°—à± à°•à±‚à°¡à°¾ à°¬à°¾à°—à±à°‚à°¦à°¿ à°œà±ˆ à°œà°¨à°¸à±‡à°¨
Gurunaidu Pspk	Superb good
Geetha Geetha	Ho wow super sng
DASARI MANI	background Music super Bayya Jai Pawanism ğŸ”¯ Jai Hindh ğŸ‡®ğŸ‡³âœŠğŸ”¥ğŸ’ª
Satyam Savadala	Bathukamma sentiment song Jai janasena thank you
Yesaiah potti	Jai janasena I love pawankalyan bro Jai Telangana
Pawan Pawan Raj Pawan Pawan Raj	ğŸ‘ŒSuperb song ğŸ‘ğŸ‘jai janasenağŸ’ªğŸ’ª
Cnavyya navya	Super
Ramakanth Reddy	superb
Roshan Bore	Song bagundi kani actor ni koncham manchi vallani pedte bagundu
ganasuresh landa	Superb
bandi tirumalaraja	ğŸ‘ŒğŸ‘ŒğŸ‘ŒğŸ‘ŒğŸ‘ŒğŸ˜ğŸ˜ğŸ˜ğŸ˜˜ğŸ˜˜
Raju Sunnam	Jai power star
mani teja	jai Jana Sena super songe
Karpurapu Dhanunjaya Rao	Wow well done brother keep rork this brother thanks for gift to this bathukamma festival
Meda Narendar	Supar
Siva Prasad Reddy Gouru	Jai janasena from kadapa
Gopikrishna Gopikrishna	Nice anna jai pk
Nakka Manoj	à°œà±ˆ à°œà°¨ à°¸à±‡à°¨ à°œà±ˆ à°¹à°¿à°‚à°¦à±
Shreekanth karupakala mudhiraj	Super song
koppishetti kalyan	à°œà±ˆ à°œà°¨à°¸à±‡à°¨
Kamindlai Sandeep	Super song
SATYA TARRA	palle thanam vuttepadinattuundhi anna e pataku meeku dhasoham anna
Megavath Ravi Rathod	à°…à°•à±à°• à°šà±†à°²à±à°²à±†à°³à±à°³ à°…à°‚à°¦à°°à°¿à°•à±€ à°­à°¤à±à°•à°®à°¾ à°¶à±à°­à°¾à°•à°¾à°‚à°•à±à°·à°²à±
Gopi Kumar	Super song bro
Talari Talari pavan kumar	Telangana sodarulaku mana janasena tarupu nunche jai janasena
Bhaskar Dasari	This year best song
Veerababu Jvd	super annaya thank you jai Janasena
GOTTIPARTHI sahradha	Super kirak
Swami Venkata Sathish Gudepu	Beautiful song
K Janakiram	TS song is great
Naveen Bonala	Jai janasena
shiva goud	Super
Sailu Sakali	à°¸à±à°ªà°°à± à°¸à°¾à°—à± à°¤à±†à°²à°‚à°—à°¨ à°ªà±à°°à°œà°²à°•à± à°­à°¤à±à°•à°‚à°®à±à°® à°®à°°à°¿à°¯à± à°¦à°¸à°° à°¶à±à°­à°¾à°•à°¾à°‚à°•à±à°·à°²à±
Rafi Rafi	Super song Jai janasena Jai Hind
satish jan	Super
sandeep BAIREDDY	à°œà±ˆ à°ªà°µà°°à± à°¸à±à°Ÿà°¾à°°à±
katari anil	Nice music jai kalyan Annayya jai jai jenasena
Begari Rahul	Super song Jai pspk
Kumar Thokala	2018 best song
Jagadish Goud	Jai janasena jai pspk
raju bathula	Jai pspk jai janasena
S Rajeshwer S Rajeshwer	Wow Nice Song Bro
Lokanadham Yenni	Really superbb I like it jai jena sena
Suresh Janu	Jai janasena
Kadhar Basha	Super
Saikumar R	jai jana senağŸ‘ŒâœŠâœŠâœŠâœŠâœŠ
Saipatel Sai Krishna	Very very Tq to Avery body becomes okaaa comman Mans tho eee song chesinadhukuu vallaku kuda chance echhinadhukuu Ji janasanaaa
Amarapinni Raju	ğŸ™ğŸ™ğŸ™ğŸ™ğŸ™ğŸ™ğŸ™ğŸ‘ğŸ‘ğŸ‘ğŸ‘
Vidyasagar saragandla	Nice song telangana biggest festival chala baga chupincharu thank you
Thayappa Gattu	Ba
Sailu n	Okkaru kuda sariga bathukamma aade step ledhu
Bairi Mahesh	Jai jana sena party
Thota Laxman	Kirrack undhi
P.Rambabu Rambabu	hiii
Ravindar reddy Ravindar reddy	Wow supr Pk Peru vintene ugipotam Alantidi Nuv song Ni chesavu supr bayya Jai Pspk family
hindustan entertainment	Jai janasena
kantam gottipadatha	Simply super song
Sathish sathish	à°®à°¾ à°ªà°µà°¨à± à°¸à±€à°à°‚ à°…à°µà°¡à°‚ à°–à°¾à°¯à°‚ à°œà±ˆ à°ªà°µà°¨à± à°œà±ˆ à°¬à°¤à±à°•à°®à±à°®
anvesh anvesh	Nice
J JEEVAN	super
sudhakar sudha	dj remx
Naga Pawanisam	Super
Kavali Narsimulu	Jai pspk
Ajay Kumar	So very nice song
Palvancha Naresh	Nice
Upender Lode	http youtu be F86bpwiRD74
Yammala Ashok	Jai Janasena
rajesh turothu	Super song
GREEN TV SHOWS	jai jana sena
RAMESH DASARI	Super song jena sena song jai pawanism
Dharmaraju Mengani	Nice song jai janasena ğŸ‘ŒğŸ‘ŒğŸ‘ŒğŸ‘ŒğŸ‘Œ
Ram Seedarapu	su su su superb
T Krishna	hotsoff to singer ki superb Anna and akkaki and pavan kalyan
Kontham Charan Cherry	Nice song bayya
challa sampath	Chala bagundhi janasena Pawan Kalyan party name pettinandhuku thanq bro great
Mora Hemanth kumar	Jai jenasena
Srinath Chenna	Song chala bagundi Jai janasena âœŠ
mprashanth kumar	super janasenaa
suman dumala	Kirrak osm pokkile jai janasena
Bikshapathi Nani	Jai janasena Happy à°¬à°¤à±à°•à°®à±à°®
cmi info	bathukamma pataki parti jenda endukura babu
Rajesh Mothukuri	Super anna
Rajesh Dheeravath	jai pavar star supper
Theerupari mounika Theerupari Mounika	Very nice
Akulla Narasimhullu	Happy bathukamma festival
Kotesh Songs	Super song
M narsimulu	Super
venki sheran	super songu jai pspk
Biyyala Suresh	Jai janasena e yaer edi supper song
Tadivaka Narendra	Jai Janasena
PERAKALAPATI HARISH	Suprr
Gangadhar Bogam	Excellent song s Anna jai power ğŸŒŸ
pavan siddharth creations	ğŸ‘ğŸ‘ğŸ‘ğŸ‘ğŸ‘Œ
Andra Media	ap t jai cm
Gaddapati Sandeep	voice superb
kamal b	Excellent song
M Swamy	super
Erra Kumaraswamy	super singer vani kishore
Banjara Nayak Hum	Jai Pspk
Laxman Paspal	Super song
Danu Danunjay	Kothaga vundhi bro Jai janasena Janasena bathukamma
K srinivas	EXCELLENT VIDEO JAI PAWAN JAI JANASENA
williams gurajala	Awesome song Anna
Pujari Vasusri	super jai janasena
Shiva K. Shiva	Super nice song Jai janasena
lokesh kumar	Supr supr
Moguluri Sai	Super
*LOVELY* PRANAY	Mind blowing song super Anna song jai janasenaağŸ‘ŒğŸ‘ŒâœŠâœŠâœŠâœŠ
ayyappa gaddam	Jai janasena
Chetti SRAVANKUMAR	Nice
Saikrishna 1997	Spr song
kAMAL kUMAR	Bokkala vundi ee song
Shaik Ameshbabu	Nice song chala peaceful ga undi
Hollywood  Adda Telugu	à°ªà°¾à°Ÿ à°¸à±‚à°ªà°°à± à°—à°¾ à°‰à°‚à°¦à°¿ ğŸ‘ğŸ‘ğŸ‘ğŸ‘ğŸ‘ŒğŸ‘ŒğŸ‘ŒğŸ‘Œ
Venkatesh Alakuntla	JAIJANASENA
Jumbarthi Ashok	Jai Janasena in Telangana
NTV BANJARA	nice super jai janasena
Dedeepya Movies	à°šà°¾à°²à°¾ à°¬à°¾à°—à±à°‚à°¦à°¿ à°šà±‚à°¸à±à°¤à±‚ à°‰à°¨à±à°¨à°‚à°¤à°¸à±‡à°ªà± à°¹à°¾à°¯à°¿à°—à°¾ à°‰à°‚à°¦à°¿ à°¶à±à°­à°¾à°•à°¾à°‚à°•à±à°·à°²à±
Rajkumar K	Artificial
Gandham Suresh	jai pspk
yaseen shaik	à°®à°¨ à°¤à±†à°²à°‚à°—à°¾à°£ à°®à°¨ à°†à°‚à°§à±à°°à°ªà±à°°à°¦à±‡à°¶à± à°œà±ˆ à°œà°¨à°¸à±‡à°¨
A1 FOLKS	Supper
Arjun P	the best song
Raju Ch	à°¸à±‚à°ªà°°à± à°…à°¨à±à°¨
Rachuri Venkatesh	Super sweet song
singarapu krishnamurty	à°¸à°¾à°‚à°—à± à°…à°¦à°¿à°°à°¿à°‚à°¦à°¿ à°œà±ˆ à°œà°¨à°¸à±‡à°¨
Sagar Rajam	Jai Pawan Kalyan
Kistamsetti Gopi	à°œà±ˆ à°œà°¨à°¸à±‡à°¨ à°œà±ˆ à°¬à°¤à±à°•à°®à±à°®
Saikumar Bhonagiri	jai janasena
vakada komaladevi	jai janasena
Mega Power	Thanks for this song
Mudavath Rathan	Jai jana sena pspk
vamsikrishna golla	Good satish reddy garu Jai janasena
pspk PSPJ	power ğŸŒŸ fan tharupuna andhariki bathukamma subakankhalu Jai Power ğŸŒŸ
Virat jaii	Superb ğŸ‘ŒğŸ‘ŒğŸ˜˜thanks for the love â¤ Jaii Janasena â¤ğŸ’ª
Golden star	à°¨à±‡à°¨à± à°†à°‚à°¦à±à°° à°¨à°¿à°œà°‚ à°šà±†à°ªà±à°¤à±à°¨à±à°¨à°¾ à°¤à±†à°²à°‚à°—à°¾à°£ à°ªà±à°°à°œà°²à°¦à°¿ à°•à°²à±à°®à°·à°‚ à°²à±‡à°¨à°¿ à°…à°­à°¿à°®à°¾à°¨à°‚
Jaya Keshav	Supar jai janasena
Ramana Meesala	Nice
Malli Babu	Superb Song Excellent Music Awesome Lyrics ULTIMATE SONG SUPERRRRRRRRRRRRRRRRRRRRRRRRRRRRRRRRRRRRRRRRRRRRRRRRRRRRRRRRRRRRRRRRRRRRRRRRRRRRRRRRRRRRRRRRRRRRRRRRRRRRRRRRRRRRRRRRRRRRRRRRRRRRRRRRRRRRRRRRRRRRRRRRRRRRRRRRRRRRRRRRRRRRRRRRRRRRRRRRRRRRRRRRRRRRRRRRRRRRRRRRRRRRRRRRRRRRRRRRRRRRRRRRRRRRRRRRRRRRRRRRRRRRRRRRRRRRRRRRRRRRRRRRRRRRRRRRRRRRRRRRRRRRRRRRRRRRRRRRRRRRRRRRRRRRRRRRRRRRRRRRRRRRRRRRRRRRRRRRRRRRRRRRRRRRRRRRRRRRRRRRRRRRRRRRRRRRRRRRRRRRRRRRRRRRRRRRRRRRRRRRRRRRRRRRRRRRRRRRRRRRRRRRRRRRRRRRRRRRRRRRRRRRRRRRRRRRRRRRRRRRRRRRRRRRRRRRRRRRRRRRRRRRRRRRRRRRRRRRRRRRRRRRRRRRRRRRRRRRRRRRRRRRRRRRRRRRRRRRRRRRRRRRRRRRRRRRRRRRRRRRRRRRRRRRRRRRRRRRRRRRRRRRRRRRRRRRRRRRRRRRRRRRRRRRRRRRRRRR SONG
Venu Gopal	Jai jaineshea supare song anna
devendar jatoth	Superb song jai Jana sena
Srikanth Sri	pspk pawanisam
Sharath Sharath	so good
RAM PSPK	à°®à°¨ à°¦à±‡à°µà±à°¡à± à°Ÿà±à°µà±€à°Ÿà± à°šà±‡à°¸à°¿à°¨à°‚à°• à°°à°¿à°•à°¾à°°à±à°¡à±à°²à± à°¬à°¦à±à°¦à°²à±ˆ à°ªà±‹à°µà°¾à°²à°¿ à°¯à±‚à°Ÿà±à°¯à±‚à°¬à± à°…à°¯à°¿à°¨ à°Ÿà°¾à°²à±€à°µà±à°¡à± à°†à°¯à°¿à°¨
Ramesh Ramesh	Super
bhaskar bhachi	Super song
guggilla anilkumar	Super song jai janasena
Vallabhu Shyamnaidu	Super
Anjaneyulu Besta	super song
Rakesh mudhiraj Rakesh mudhiraj	Nice song
Raju Salla	jai powerstar jai Pavankalyan sir im big fan of you Pavankalyan
Manigilla Bhaskar	Jai pawarstar
vadithya anil	Superb song
nagamalleshwar rao	Jai power Star pawan kalyan
MOHAN.S. O	Super Anna song
Mahesh M	Nice song
Nagaraju Tammisetti	Jai Janasena
sai varun	Jai Telangana âœŠâœŠâœŠ Spb song
Kanchayya Buddepu	Jai janasena
Ganesh Nayak	Mana samaskruti mana sampradayam Jai pk
Kalla srinu Mudiraj	Super ğŸ‘ŒğŸ‘ŒğŸ‘Œ
saicharan dommeti	Pawan kalyan movie la vundhi handsoff
Mohd Adil	Wow song Nice Song Video Song Super Anna âœŠâœ¡ï¸âœŠPSPKâœŠâœ¡ï¸âœŠ
Balraj Balraj	youth power star pan like osukomdi
Janman Rakesh	jai pkps
Laxman Durka	à°®à°¨à°¸à± à°¹à°¾à°¯à±€à°—à°¾ à°µà±à°‚à°¦à°¿ à°ªà°¾à°Ÿ à°µà°¿à°¨à±à°¨à°‚à°¤à°¸à±‡à°ªà± à°¬à°¤à±à°•à°®à±à°®à°¨à± à°ˆà°°à±‹à°œà± à°šà±‚à°¸à°¾à°¨à± à°¦à°¨à±à°¯à°µà°¾à°¦à°®à±à°²à± à°—à±à°°à±à°µà±à°—à°¾à°°à±
Raja Pallipati	chaala manchi song sir chaala chakkaga teesaru
Sanjeeva Rayudu	Super no word
tharun tharun	ğŸ‘ŒğŸ‘ŒğŸ‘ŒğŸ‘Œ
Srikanth Chine Thali	http youtu be DzTwQNayZbM
Ramesh Naidu	super ji pspk
Nithin Kalyan	Jai power star Pawan Kalyan nice video song super
Kickraj Creations	à°¸à±‚à°ªà°°à± à°¸à°¾à°‚à°—à±
Yadagiri Mirdoddi	Super jai janasena
ratnamohan v	super anna jai jahasana jai pavankalyan
Snehalatha Sarikonda	2018 best bathukamma song congratulation satheesh congratulation Ramnarayana team
Vislavath Santhosh	Jai pk Anna
Balu Kontham	Jana sena bathukamma song super
Mallie Mallesh	Thanks 99tv giving Bathukamm song jai janasena
d.ganesh d.ganesh	à°œà±† à°¤à±†à°²à°‚à°—à°¾à°£ à°œà±† à°œà°¨ à°¸à±‡à°¨
Thalakolla Rakesh	Jai Janasena jai telangana
Chinna Photography	Superb
Lio Yadav	Good song
Bathula Shivakumar	à°…à°¨à±à°¨à°¯à±à°¯ à°•à± à°¤à°®à±à°®à±à°¡à± à°¶à°¿à°µ à°…à°¨à±à°¨ à°¸à°¿à°à°‚ à°•à°¾à°µà°²à°¿ à°†à°¨à±‡ à°…à°‚à°¦à°°à°¿ à°•à±‹à°°à°¿à°• à°œà±ˆ à°œà°¨à°¸à±‡à°¨ 9866511276
Krishna Sattu	à°œà±ˆ à°œà°¨à°¸à±‡à°¨ à°ªà°¾à°Ÿ à°šà°¾à°²à°¾ à°¬à°¾à°—à±à°‚à°¦à°¿
Vijay Kumar Reddy	Keve keka jai bathukamma jai janasena jai pspk
varaprasad bhoomireddy	So beautiful song Happ feeling
Dj Srinu	super anna
amar ash	Edi batukamma song kadu cinima song
Pavan Mallarapu	superrrr
Ass tv	Jai pspk
buyyan rajinikanth	Superb song
Mr Raju	Super song Anna tq for jena sena fan
Salkam Praveen	jai pspk
Bujjishiva Shivabujji	à°¬à°¤à±à°•à°®à±à°® à°¦à±€à°µà±†à°¨à°²à± à°à°²à±à°²à°ªà±à°ªà±à°¡à±‚ à°‡à°°à± à°°à°¾à°·à±à°Ÿà±à°°à°¾à°² à°¤à±†à°²à±à°—à± à°ªà±à°°à°œà°²à°•à± à°‰à°‚à°¡à°¾à°²à°¿
Rao Kasa	Super song bro ğŸ‘
Sampath Adepu	à°®à±à°‚à°¦à±à°—à°¾ à°¨à°¿à°°à±à°®à°¾à°¤ à°•à°¿ à°ªà°¾à°Ÿ à°°à°šà°¯à°¿à°¤ à°•à°¿ à°¦à°°à±à°¶à°•à±à°¡à± à°•à°¿ à°¶à±à°­à°¾à°•à°¾à°‚à°•à±à°·à°²à± à°ªà±à°°à°¤à±€ à°¬à°¤à±à°•à°®à±à°® à°ªà°‚à°¡à±à°— à°•à°¿ à°à°¨à±à°¨à±‹ à°ªà°¾à°Ÿà°²à± à°µà°¸à±à°¤à±à°¨à±à°¨à°¾à°¯à°¿ à°•à±Šà°¨à±à°¨à°¿ à°‰à°¤à±à°¤à°®à°®à±ˆà°¨ à°ªà°¾à°Ÿà°²à°²à±‹ à°‡à°¦à°¿ à°’à°•à°Ÿà°¿ à°®à±€ à°¨à±à°‚à°¡à°¿ à°®à°°à°¿à°¨à±à°¨à°¿ à°ªà°¾à°Ÿà°²à± à°†à°¶à°¿à°¸à±à°¤à±à°¨à±à°¨à°¾à°‚
anil amiredddy	Jai pawanism
p k	20 th time ğŸ˜
prabhakar katakam	superb jai janasena
super Manda	Super
Ramesh a	Good 2024 telangana CM PAVAN 100
hello Chinna	Jai janasena
vikram Kanna	JAI JANASENA JAI TELANGANA
Mallesh Akku	Super ğŸ‘ŒğŸ‘ŒğŸ‘ŒğŸ‘ŒğŸ‘ŒğŸ‘ŒğŸ‘ŒğŸ‘ŒğŸ‘ŒğŸ‘ŒğŸ‘ŒğŸ‘ŒğŸ‘ŒğŸ‘ŒğŸ‘ŒğŸ‘ŒğŸ‘ŒğŸ‘ŒğŸ‘ŒğŸ‘ŒğŸ‘ŒğŸ‘ŒğŸ‘ŒğŸ’˜ğŸ’˜ğŸ’˜ğŸ’˜ğŸ’˜ğŸ’˜ğŸ’˜ğŸ’˜ğŸ’˜ğŸ’˜ğŸ’˜ğŸ’˜ğŸ’˜ğŸ’˜ğŸ’˜ğŸ’˜ğŸ’˜ğŸ’˜ğŸ’˜ğŸ’˜ğŸ’˜ğŸ’˜ğŸ’˜ğŸ’˜ğŸ’˜ğŸ’˜ğŸ’˜ğŸ’˜ğŸ’˜ğŸ’˜ğŸ’˜â­â­â­â­â­â­â­â­â­â­â­ğŸŒ·ğŸŒ·ğŸŒ·ğŸŒ·ğŸŒ·ğŸŒ·ğŸŒ·ğŸŒ·ğŸŒ·ğŸŒ·ğŸŒ·ğŸŒ·ğŸŒ·ğŸŒ·ğŸŒ·ğŸŒ·ğŸŒ·ğŸŒ·ğŸŒ·ğŸ‘
Gedela Eswar	Superb song
Manoj Powerstar	Jai bathukamma
ram dubbaka	Anna nv pspk
Kannuri Naveen	super video
SAPAVATH CHANDUNAIK	2018 awesome song
K.Narendar Narendar	Super song Any body PsPk fan like it
shekhar munukuntla	Jai janasena Jai Warangal
Dasaradha Alr	Jai pawankalyan
gowrikumar dukka	Jai Janasena Jai pallituru
Sathish Katla	chala bagundi song
baburao nelli	Nice song
Siddu Siddartha	Super song jai pspk
Marri Sathish	Sathish
Pavantej Pariki	Jai janasena Superbbbbb
Raju Vemula	power stare supper name Telangana
jana sena pawan kalyan	Jai jana sena
M Rajashekhar	Very nice song jai à°œà°—à°¨à± à°…à°¨à±à°¨ ğŸ™ğŸ™ğŸ™
Chaitanya pathivada	Jai TS Jai AP Jai janasenaaaâœŠâœŠâœŠâœŠâœŠâœŠ
Ndp Sri r	Super ğŸ‘ŒğŸ‘ŒğŸ‘ŒğŸ‘ŒğŸ‘ŒğŸ‘ŒğŸ‘ŒğŸ‘ŒğŸ‘ŒğŸ‘ŒğŸ‘ŒğŸ‘ŒğŸ‘ŒğŸ‘ŒğŸ‘ŒğŸ‘ŒğŸ‘ŒğŸ‘ŒğŸ‘ŒğŸ‘ŒğŸ‘ŒğŸ‘ŒğŸ‘ŒğŸ‘ŒğŸ‘ŒğŸ‘ŒğŸ‘ŒğŸ‘ŒğŸ‘Œ
Raju Banda	Pk super song
Hanumanth Cappuccino	Nice song
RAJASEKHAR ROYAL	EXCELLENT SONG
venkat yadav parvatham	Song super bro jai janasena
santhu dongri	Nice ğŸ‘ŒğŸ‘ŒğŸ‘ŒğŸ‘ŒğŸ‘ŒğŸ‘Œ
prashanth reddy	Janasena Anty nay Andhra Pradesh telangana eachinanduku konni day annamu Tinadam manesa Anna person ki mana acharalu ela telustai
devender bhukya	Super
Ganesh Kondameedi	Jai power star
vamshi dbk	Super song
Jagadeesh Rowtu	Jai Jana sainika
Tekkam Srikanth	This song gift for pawan sir janasena party soldiersğŸ’ªğŸ’ªğŸ’ª
maharshi Mahesh babu	Superb Tq u
Chintaguntla Vinosh	Jai janasena
Bujji Bujji	Jai pspk
VIDYA SAGAR	Batukamma niku padalaku na sirassu vanchi namaskaristunnanu ma anna pavana garini challaga chudandi ma anna CM avvalani deevinchandi andralo maku teliyadu batukamma ante nuvu ammavane arthistunnanu ma anna CM kavalani jai janasena
kata Vinod	Super anna jay pavankalyan
Anilkumar Paladugu Anilkumar	super ga undhi song Jai janasena
Varun siddharth	Jai janasena I am from telangana
Praneeth Baggi	Super song pawankalyan anna
Shyam Kandula	nice
thirupathi bandela	Super song
Narsing Guna	Nice song
Karike Prakash	Thank you janasena
Payam Ramesh	Super song
Rajashekar Nayak	à°œà±ˆ à°œà°¨à°¸à±‡à°¨ à°¸à±‚à°ªà°°à± à°¸à°¾à°‚à°—à± à°…à°¨à±à°¨
NI3 CREATIONS	à°…à°•à±à°• à°šà±†à°²à±à°²à±†à°³à±à°³ à°…à°‚à°¦à°°à°¿à°•à°¿ à°¬à°¤à±à°•à°®à±à°® à°¶à±à°­à°¾à°•à°¾à°‚à°•à±à°·à°²à± ğŸ™ à°ªà±‚à°²à°¤à±‹ğŸŒ¹ğŸŒ» à°­à°—à°µà°‚à°¤à±à°£à±à°£à°¿ à°ªà±‚à°œà°¿à°‚à°šà°¡à°‚ à°ˆ à°ªà±à°°à°ªà°‚à°šà°¨à°¿à°¦à°¿ à°…à°¯à°¿à°¤à±‡ à°† à°ªà±à°²à°¨à±‡ğŸŒ»ğŸ’ğŸŒ¸ à°ªà±‚à°œà°¿à°‚à°šà±‡ à°®à°¨ à°¤à±†à°²à°‚à°—à°¾à°£ à°¸à°‚à°¸à±à°•à±ƒà°¤à°¿ à°¤à±†à°²à°‚à°—à°¾à°£ à°•à±‹à°Ÿà°¿ à°°à°¤à°¨à°¾à°² à°µà°¿à°¨ à°¸à±‚à°ªà°°à± à°¸à°¾à°‚à°—à±ğŸ‘ŒğŸ‘Œà°œà±ˆ à°œà°¨à°¸à±‡à°¨
Vivek Jay	Awesome
Naresh Naresh	Super jai janasena super song
arun prakash	Super yentaina pspk kada
madhu gouds	super Anna
venkat sai krishna	Superbbbbbb
GS creatures	Mainly music superb ğŸ‘ŒğŸ‘ŒğŸ‘ŒğŸ‘ŒğŸ‘Œnice composing âœŠâœŠâœŠjai jana senaâœŠâœŠâœŠ
Sailu Gujjula	That is pawan ism
Prashanth Kadtala	Super song bro
charanyadav charanyadav	Jai janasena
Sateesh Yammani	Super song jai janasena
Sandeep Gangarapu	nice song jai pk
KIRAN PARNAKOLA	Wonderful song chala chala bagundi vintunte manasaku hattukonela undi hatsoff
PK# UMESH DEVARAPU	Super song sathish Anna
thimmaipalli ram	What a song Jai janasena
Kalyan Yadav	Super bro Jai pawanisam jai Jena Sena ğŸ˜—âœŠâœŠğŸ‘
Jeevan Nalla	Super song jai janasena
Chandu Katamoni	ğŸ‘ğŸ‘âœŠâœŠâœŠ
Beerkula Venkatesh	Bathukkamma ante puvvulanuğŸŒ¸ğŸŒ»ğŸŒ·ğŸ€ devathaga koliche pandaga Andhi mana telangana lone jarpukuntam Naa telangana koti rathanalaveena
k Abhi	Super song jai pspk
BANAVATH SAKRU	Jai pk
vamshi vamshi	à°¸à±‚à°ªà°°à±
Begari Naveenkumar	I love
Satish Kumar	Jai Pspk Jai janasena
mallesh maila	bathukamma song lo kuda party feeling promote entra babu
Ravi Rachapally	super janasena bathukamma song
Naresh Valmiki	Jai janasena
Venkat Rv	Very nice song Jai janasena
mahender Banothu	Super
CHAKKA SUNIL KUMAR	Jai power star jai Jana sena
Saidi Reddy	Fantastic
Ande Prashanth	Superb brooo Jai janasena
Sanampuri Santosh	Emundhi e bathukamma patallo
Kollipara Ramu	Excellent song Jai Jana sena jai power star jai pawanism jai hind Beautiful dance Nice production Simply super Jai telagana
naitham samba	Wow super pk rasara e song pk padada
Yohanu Janasena	Jai janasena âœŠ
TRBN ALL VIDEOS	Superb song
Adimulam Sriram	Superrr song ra Hats off to u
vasubabu pvb kopusetti	Share all group
K Revanth	Jai Telangana Jai Janasena Jai Sriram
Suresh Goka	Nice song Jai pawanism Jai janasena Jai Hind
PARAMESH NEERUDU	Super
Kranthi raju	âœŠâœŠâœŠâœŠâœŠâœŠJai power star âœŠâœŠâœŠâœŠâœŠjai janasena ğŸ’ªmy bos song
Naveen Lande	Jai konda
rajkumar kumar	Jai pawanism ğŸ‘ŒğŸ‘ŒğŸ‘ŒğŸ‘Œ
Baasa Ashok	Ma anna twit chesadu ani chusa super song nadi telangane ji janasena
saida naik	Super
PSPK Aruarun	Jai telangana Jai janasena
Malavath Santhosh	Song super Jai Janasena Jai pavanisam Jai Hind
kishan pesara	Super jai à°œà°¨à°¸à±‡à°¨
216 Kreative Interiors	Beautiful lyric
B Mahesh	Super anna
kothagattu prashanth	Superb
kakarla narayanaswamy	Nice coreography
PRAVEEN MYADARI	ğŸ‘ŒğŸ‘ŒğŸ‘ŒğŸ‘ŒğŸ‘ŒğŸ‘ŒğŸ‘ğŸ’ğŸ’ğŸ’ Awesome ğŸ‘
sanjeev g	Super song
KRANTHI KUMAR	Janasenani
tiru china	Bathukamma pillalu andhra telangana prajalu Jai pspk
à°¯à°¾à°¦à°¾à°¦à±à°°à°¿ SLNS	Jai pawanism Janasena Song superb
srikanth laxman vinjam slv	this is the best ğŸ‰ ever song in Telangana bathukamma super voice Deepthi
Harish Thati	thanks for all team for giving a janasena bathukamma song
RAMA devi	Nice song
Subbu SRS	Excellent
Karnakar yadav Yadav	janasena bathumma song superb anna mee song chala bhagundhi
VENKATESH Naik	Super
Sanjeev pavan	This year best bathukamma song
kiran varma	super
Kira Nila	Achhamaina palle panduga
Srikanth VS	Mare it 1M view all power star fan
raju yadav	Jai Telangana veera mana telan gana Telugu Prajaliki Bathukamma sambaraalu subakankshalu from vizag Telugu India Jai Andhra jai Telangana Refered by Pspk jai janasena jai hind
Suresh pawn	Batukamma panduga subhakankshalu to my dear Telangana telugu we are always one but politician divided u Physical we are divided but our mother tongue telugu talli not leave u Germony laa edho oka roju manamu marala ekam avutamani naku nammakam vundi Ala kalavalani aa devudini pradistunna Jai telugu talli Jai janasena
manju pilli	Lyrics Music video Super 2018 the best song I loved it
Kalyani prithvi	nice song
Vijay Vijay	superbbbb song bhaya
LAL LAKAVATH	Love uuu senaaaaâœŠ
Samalla Mahesh	Jai janasena Jai bathukamma
jaipal jai	Super jai jenasena
laxmipathi mudhiraj	Love you Pavan sir
Raju Orupula	ğŸ‘ŒğŸ‘ŒğŸ‘ŒğŸ‘Œ
Srikanth Gudugundla	Superb song
Eshala Rajashekar	Jai power star
Sai Chandhu	jai janasena
NARESH GANDHASIRI	jai janasena jai Hindu
Ashok Ashok	super song sir xlent
Swami nadh Nadh	Wow super nice
Suman Dabbugunta	Jai janasena
Shankar Chikkudu	à°œà±ˆ à°ªà°µà°¨à± à°•à°³à±à°¯à°¾à°£à± à°œà±ˆ à°¤à±†à°²à°‚à°—à°¾à°£
D Rudra	Making super asm voice excellent Jo song powerful redham all song for no1
Pavan Kalyan	Jai Janasena
arukonda arukonda	Superb song
Parashuram Kuruma	Super lyric
IRUGU ANJI	Kirrrrrak bro supero super
pradeep kummara	Jai janasena Jai Hind
Subrahmanyasunil Chamandi	Super song sir jai janasena jai hindâœŠ
Nagaraj Akhi	Superb
Venu Chadamala	Superb song jai janasena
Srikanth Goud	Thanks for the upload I love my india I love my telangana Love you pawan anna
naresh guguloth	Superb song jaiiiiiiiiiiiiiiiiiii Janasena pspk
Polaveni Srinivas	Song bagundhi Thanks Bhai Jai power star
Gramesh Gramesh	Jaiii janasena
Tollywood Music	Bathukamma pandaga andhariki okate Anthe kaani Janasena bathukamma TRS bathukamma congress bathukamma ani vundavu ğŸ¤ğŸ¤ğŸ¤ğŸ¤ğŸ¤
Srinu gaddam	Jai power Star jai Pavan Anna
Manju Sree	I just can t stop laughing ğŸ˜‚
parlapelli Venkatesh	super lyric babai congrats sreenath babai
Sudarshan Sudarshan	Ea year bathukamma song lo ea song superrr jai janasena
Abdul Mujeeb	Super
Leelasai Vaskuri	Jai Pawan kalyan Jai Janasena Jai telugu
Rajender Mattewada	Anna super song 2018best song
ram rams	Dislikes nduku kodatharoo kuda ardam avatla
Devi Prasad	Andaruu ie song ne valla WATSAPP and fb status petandi like it if u watched after our Anna tweet
PAPPALA BHASKARA RAO	ğŸ‘ğŸ‘ğŸ‘ âœŠâœŠâœŠ
KOTHAGOLLA NARSIMHA	Super song
Sunil Erram	Jenasena
Mr. Karthik	No word s ğŸ™ Jai jana SenaâœŠâœŠ
akshay Kumar	From medak zilla sangareddy constituency jai Janasena jai hind
Nagender v	It s nice keep it up team
vamshii innÃ¸cent	pspk
ramarao a	Jai janasena
Ramyasri Bellamkonda	superrrrrrrr
Sruthin Kumar	Next CM of AP Pawan Kalyan ana Hit like ğŸ‘those who belief
U U	Telangana bhasha ni enthagano gouravinche ma daivam nizam nawab pawan kalyan gariki dhanyavadalu katte kala antha varaku pk fan
Prashanth mad	Jai power star Jai janasena Jai telangana Jai hind
Prashanth Narsingh	Nice video sir Jai PawanKalyan
srinivas muniganti	Wonderful song jai power star
Power Star	Nice lyric
Kola Mallesh	super songe
Mamidi Yuvan	Wow this is 2018 no 1 Song Super hit ğŸ™ğŸ™ğŸ™
saikumar j	OSm super Tredington song
Lingaswamy Denkala	Super song jai janasena jai jai janasena
raj c	Super
bharath rathod	Super
Googl RÃ¯der	ğŸ˜˜ğŸ˜˜ğŸ˜˜ğŸ˜˜â™¥ï¸â™¥ï¸â™¥ï¸â™¥ï¸â™¥ï¸
YSR Creations	à°ªà°¾à°Ÿ à°¬à°¾à°—à±à°‚à°¦à°¿
Srinu Komarapuri	Im watching after pk tweet u
Sudheer K	Nice song sateesh garu Jai PK
Earlapally Mahesh	Jai janasena jai power ğŸŒŸ
Shaik shameembasha	Super Jai power ğŸŒŸâœŠâœŠâœŠ
rayikindi suresh	à°‡à°¦à±€ à°•à°¦à°¾ à°¬à°¤à±à°•à°®à±à°® à°ªà°‚à°¡à±à°— à°…à°¦à±à°­à±à°¤à°®à±ˆà°¨ à°ªà°¾à°Ÿ à°§à°¨à±à°¯à°µà°¾à°¦à°¾à°²à± à°Ÿà±€à°‚ à°…à°‚à°¦à°°à°¿à°•à°¿
Veera Veera	Super jai janasena
Udaykumar pk	Super sir Chela bagundhi jai janasena jai Pawan Kalyan annayyya
Zubayer Rahman	I m watching this after PK S TWEET
Naga Naga	Superb Jai janasena
Naveen Mudiraj	Excellent janasena bathukamma song Good
Vinay Sagar Nangunuri	Lyrics ğŸ”¥ ğŸ’•
ravindher mamidipally	chaala bhagundi song
RajniKanth NaaYak	Plz Register Your Votes Vote For Pawan Anna JaiJanaSena âœŠ
Praveenyadav PsPk	Super Anna Jai Janasena
A Bharathkumar	super song jai janasena from telangana
my village pcr	Jai janasena jai power star
srikanth	Jai Janasena Support for a change
Annem Anil	Jai JanaSena from a Maheshbabu FanğŸ’ªâœŠâœŠ
sesha giri	Super Sathish anna
à°°à°®à±‡à°·à± à°‰à°‚à°¡à±à°°à°¾à°œà°µà°°à°ªà±	Pk tweet super
murthy Gvv	à°®à°¾ à°¦à±‡à°µà±à°¡à± à°ªà°µà°°à± à°¸à±à°Ÿà°¾à°°à± à°ªà°µà°¨à± à°•à°³à±à°¯à°¾à°£à± à°¤à°°à±à°ªà±à°¨ à°¤à±†à°²à°‚à°—à°¾à°£ à°ªà±à°°à°œà°²à°…à°‚à°¦à°°à°¿à°•à°¿ à°¬à±à°°à°¤à±à°•à°®à±à°® à°ªà°‚à°¡à°— à°¶à±à°­à°¾à°•à°¾à°‚à°•à±à°·à°²à± à°œà±ˆ à°ªà°µà°¨à°¿à°œà°‚
Ramya Madhavadas	Pk tweeted this We will watch it love it and yes will trend it Power of pawanism
Prashanth Gabbar	superb
Rakesh janasena	Love this song from jagithyal janasena
Sampath VINAY TANGUDU	Nice song
MAHESH LUV54	Jai janasena
Raju Ramanujam	Pk sir twit chesaka oka telangana lone kadu andhra pradesh lo song highlet ayyedi Hat s of pk sir
Kanchapogu Varlu	Nice video
mahesh reddy ravula	Bathukamma thali Jai Telangana Jai janasena
Sandeep Ragam	à°œà±ˆ à°œà°¨ à°¸à±‡à°¨ à°œà±ˆ à°ªà°µà°¨à± à°•à°³à±à°¯à°¾à°£à± à°œà±ˆ à°¹à°¿à°‚à°¦à±
K Ismail	Jai janasena
Ramdas Nayak	Super song
hanumanthu darsi	Jai Pk jai janasena
chand basha	Love from rayalaseema Jai pawanism Jai janasena
mannai technical	Great satish gaaru
Kiranreddy katta	Jai janasena ğŸ”¥â¤ï¸
satishkumar jakkoju	What a song Superb
santhosh vikas t.v updates	U are pk fan
navadeep Kompelly	JAI janasena
super super	Super song
Raj Praveen	Super super super bro one off the best song in year ğŸ’ğŸ’ğŸ’ğŸ’
Siva krishna	Awesome song
sureshp psg	à°œà°¨à°¸à±‡à°¨ à°¸à±ˆà°¨à°¿à°•à±à°² à°•à± à°¬à°¤à±à°•à°®à±à°® à°ªà°‚à°¡à±à°— à°¶à±à°­à°¾à°•à°¾à°‚à°•à±à°·à°²à±ğŸŒ¹ğŸŒ»ğŸŒ¹ğŸ™ğŸ™ğŸ™ğŸ™ğŸ™ğŸ™ğŸ™ğŸ™
charan teja	Super b song Jai janasena âœŠâœŠâœŠ
Vijay Boda	mana Anna power star pawan kalyan chusenaa video andhariki share cheydamm JAI JANASENA
dasari balakrishna	Jai power star
RAGHAVENDAR PODUGU9	For pk
Sadari Gaja	à°œà±ˆ à°œà°¨à°¸à±‡à°¨ à°œà±ˆ à°œà±ˆ pk
Suresh Siri	PK Tweet after watching this song
Shiva Mudhiraj	This year all tv channel song fassak only this song excellent
SRIDHAR T	Jai kalyan sir
Charynaga	Nice i m watching after Powerstar Tweet Jaiii janasena
Bathula Sagar	jai janasena jai Pawankalyan
Jagadish Jagan	Super jai janasena
Srikanth Kusuma	Super
Madhu Karthi	Pk à°šà±†à°ªà±à°ªà°¾à°¡o à°µà°²à±à°² à°šà±‚à°¸à°¿à°¨ à°µà°¾à°³à±à°³à± like à°à°¸à±à°•à±‹à°‚à°¡à±€
sateesh raghumandala	Janasena
abhi abhi	Utter flop song Edo kuda below avg Now varku oka song lo kuda josh ldu
hemanth yadav hemanth	Nice song colour full location very nice
AnandBabu Polampally	à°®à°¸à±à°¤à± à°‰à°‚à°¦à°¿ à°ªà°¾à°Ÿ à°®à°¾ à°—à±à°°à°¾à°®à°‚à°²à±‹ à°¬à°¤à±à°•à°®à±à°® à°ªà°‚à°¡à°— à°°à±‹à°œà± à°ˆ à°ªà°¾à°Ÿ DJ à°•à°¿ à°à°ªà°¿à°¸à±à°¤à°¾à°‚
venu	I came here after PK tweet Very nice song Lyrics music location whatnot everything is perfect Thank you Sateesh
Mahesh mai	Soooooperrr one of the best song of this year e year top 3 lo e song untundiii thanks JANASENA And Wow Media
srinu nallaganthula	Super
Akula Sivaraju	à°¬à°¤à±à°•à°®à±à°® à°ªà°‚à°¡à°— à°¶à±à°­à°¾à°•à°¾à°‚à°•à±à°·à°²à±ğŸ™ğŸ™ğŸ™
charan cherry	pk tweet after watching ğŸ¤—ğŸ¤—
Srinivas Chandanagiri	This year gold song in batukkamma
sai saida	ğŸ˜ğŸ˜
J Upendar	super b
Upendar Jillapally	Jai pawanism jai power star happy bathukamma alla telugu people
à°°à±ˆà°¤à±‡ à°°à°¾à°œà±	à°šà°¾à°²à°¾ à°šà°¾à°²à°¾ à°¬à°¾à°—à±à°‚à°¦à°¿
Kankanala Bhaskarreddy123	super
Srinivas Sss	Super
Ram	I came here after p k tweet Howmany of you did like me
santhosh manda	Jai janasenağŸ‘ŒğŸ‘ŒğŸ‘ŒğŸ‘ŒğŸ‘ŒğŸ‘Œ
naidu murthy	nice song jai pawan
Charan Reddy	supper bayya thanks pk anna meru epudu tg culture ni respect chestaru anni telusu kondari vedavalaku teliyadhu
vasudeva reddy	Anna super Super Anna
Chiranjeevi Kondala	superrrr song jai pk jenasena
vishall kalyan	Jai Jai Pawan Kalyan
Crypto Trend	The Best of this year
Shahid Afroz	Kalyan sir pspk fan hit like
Shekar Akkenapelly	Excellent
satish janasena telugu janasena	Jai pkk
Narabatthoju Anudeep	Nice video palli
SHARATH KUMARREDDY	Pspk
SANDY PAWANISM JAI JANASENA	Jai janasena Jai pspk Jai telangana
Prashanth Nampally	Osm bro
Thirupati rao Pakanati	Jai power star
KÃ£Ã‘Ã±Ã… CreTions	Jai janasena jai Pawan kalyan NYC song Anna good
Pujari Vishnukumar	Superb fantastic nice songğŸ§ğŸ§ğŸµğŸµğŸ”ŠğŸ”‰ğŸ”‰ğŸ¹ğŸ¹ğŸ¼ğŸ·ğŸ¶ğŸ¶ğŸ¸ğŸ»ğŸ»ğŸºğŸº
surendra Reddy	Nice song
7 STAR MS CHERRY	Music super sir exlent song
SRINIVAS PITTALA	Excellent song voice lyric music good choreography photography
Shivadeep reddy	Jai Janasena Jai pawanism Nice cover song of bathukamma nice voice ğŸ˜˜
Jagan K	à°¸à±‚à°ªà°°à± à°…à°‚à°¤à±‡ğŸ‘ŒğŸ‘ŒğŸ‘ŒğŸ‘ŒğŸ‘Œ
PADMA ARTS	Jai Janasena Jai PSPK
prasad kshatriya	Really super jai pk Jai sathish
Boddu Anjaneyulu	Jai telangana jai power star
Anilkumar Pagoti	Nice song
Srinivas Smart	Jai janasena Zindabad Zindabad pawan kalyan Zindabad jai hind
Toni Tonija	Jai janasena jai pspk Jai Telangana
Chaitanya Reddy	Jai pawan Anna jai janasena
Harsha Guntupalli	â¤ï¸â¤ï¸â¤ï¸
Pavan Reddy	Thanks for good song Pk tweet u hit the button
Sravan Kumar	Jai power star Jai Telangana
Gaja Akhil	Super
Sikandar vontella	Excellent
Naveen Nani	Janasena ki aha bathukama thallus ashisulu eppudu untai JaiJanasena
sainath ayireddi	Came after seeing pk tweet
Naresh Jupalli	Superb
nandagiri sathish kumar	à°œà±ˆ à°¤à±†à°²à°‚à°—à°¾à°£ à°œà±ˆ à°œà°¨à°¸à±‡à°¨ à°ªà°¾à°Ÿ à°…à°¦à±à°¬à±à°¤à°‚à°—à°¾ à°‰à°‚à°¦à°¿ à°Ÿà±€à°®à± à°…à°‚à°¦à°°à°¿à°•à°¿ à°ªà°¾à°¦à°¾à°­à°¿à°µà°‚à°¦à°¨à°‚ğŸ™ à°²à°µà± à°¯à±‚ à°¸à°¤à±€à°·à± à°…à°¨à±à°¨ â¤
gunaganti nagaraju	à°œà±ˆ à°œà°¨à°¸à±‡à°¨
NAVEEN KUMAR NEELAM	Super
NAGARAJU Mangi	Nice song
surya nippuleti	Power star tweet chesinaka chudakunda undagalara No way trending no 1 soon ğŸ˜˜
NRI Venkat USA	Terrific presentation good job Wow medium
anil kumar	Awesome song
malli ram	Spr
Vasu Pothuganti	à°¤à±†à°²à°‚à°—à°¾à°£ à°…à°•à±à°• à°šà±‡à°³à±à°³à°²à±à°²à°•à± à°†à°¡à°ªà°¡à±à°šà±à°²à°•à± à°¬à°¤à±à°•à°®à±à°® à°ªà°‚à°¡à±à°— à°¶à±à°­à°¾à°•à°¾à°‚à°•à±à°·à°²à± à°œà±ˆ à°œà°¨à°¸à±‡à°¨
Venky Hero	Annaya Love You For Ever
Bharath Kumar GS	Superb ğŸ‘Œ
magadheera34	Jai janasena ğŸ”¯
Asif rohit	Jai janasena
Rajesh jampa	Super song
Mahita Sureshbabu	jai janasena jai pavanisam
Prasanth Burle	song superb jai janasena
Subbu V	Good work keep it up
suresh kumar	Jai Bathukamma Wishes to all Jai Powerâ˜†
NRL	Director ram Narayan brother congratulation ğŸŒ¹ğŸŒ¹ Anna link pettaru ğŸ‘ trending lo No1 undali âœŠ
à°¹à°¾à°²à±‹ à°—à±à°°à± à°ªà±à°°à±‡à°® à°•à±‹à°¸à°®à±‡	à°ªà°µà°¨à± à°…à°¨à±à°¨ à°šà±‚à°¸à°¾à°¡à± à°®à±€à°°à± à°šà±‚à°¡à°‚à°¡à°¿ à°¸à±‚à°ªà°°à± à°—à°¾ à°‰à°‚à°¦à°¿
MEDA RENUKESWARA RAO	à°¤à±†à°²à°‚à°—à°¾à°£ à°¸à±‹à°¦à°°à±à°²à°•à± à°œà°¨à°¸à±‡à°¨ à°ªà°¾à°°à±à°Ÿà±€ à°¸à±ˆà°¨à°¿à°•à±à°²à°•à± à°¤à±†à°²à°‚à°—à°¾à°£à°¾ à°°à°¾à°·à±à°Ÿà±à°° à°¸à°‚à°¸à±à°•à±ƒà°¤à°¿ à°¸à°‚à°ªà±à°°à°¦à°¾à°¯à°¾à°²à± à°ªà±à°°à°¤à°¿à°¬à°¿à°‚à°¬à°¿à°‚à°šà±‡ à°ªà±à°°à°•à±ƒà°¤à°¿à°¨à°¿ à°ªà±à°°à±‡à°®à°¿à°‚à°šà±‡ à°ªà±‚à°²à°¨à± à°ªà±‚à°œà°¿à°‚à°šà±‡ à°ªà°‚à°¡à±à°— à°¬à°¤à±à°•à°®à±à°® à°ªà°‚à°¡à±à°— à°¶à±à°­à°¾à°•à°¾à°‚à°•à±à°·à°²à± ğŸ’ğŸ’ğŸ’
Durga Prasad	How many of you watching After PK tweet HitğŸ‘
Venkatesh Ch	After pk twit
sudheer yadav	Jai Telangana jai janasena âœŠ
tharun 1432	Jai powerstar
Ashok Vinay	Hats off to Telangana janasena
Appu Sammangi	Jai JANASENA Jai Telangana
kkr kkr	Abba super song jai janasena
Murali Krishna	After Kalyan tweet ğŸ™‹
Gopi PSPK fan	Jai janasena
Satya Deva	Excellent ga undi bro If pspk sir haven t posted about this to watch I would have missed it Very nice
in telugu	Jai power star
KDV Telugu channel	Pawan kalyan annaya tweet so Good song
Siva Kishore panuganti	Awesome song
Paramesh Goud	Jai Pawanisam jai janasenaaaa jai Telangana ğŸ’ªğŸ’ª
Naidu santosh	Me
Santhosh Akaari	à°¸à±‚à°ªà°°à± à°…à°¨à±à°¨â™¥ï¸â™¥ï¸â™¥ï¸â™¥ï¸â™¥ï¸â™¥ï¸â™¥ï¸â™¥ï¸â™¥ï¸â™¥ï¸
Pspk Niru	After ğŸ™Pspk tweetğŸ˜
Md Khaleel Bhai Official	Super
naresh gunda	ğŸ‘ŒğŸ‘ŒğŸ‘Œ
Vishnu Temper	After pk tweetğŸ™‹
TELUGODI POWER	How many like at pspk tweet
GIRI POWER	à°œà±ˆ à°œà°¨à°¸à±‡à°¨
Miriyala Venkatesh	Anybody watching after pk tweet like
Ğ½arÑ•Ğ½a j	How many member watching after pk tweet hit likeâ¤ï¸
Faizulla MD	Happy bathukamma all of you ğŸ˜
Meka Bharath	Festivals ke party promotion ante Ra
Satyendra Kumar	Excellent Video Jai PK
ravi tej	I m watching this after Pawan Kalyan s tweet Jai PSPK Jai Janasena âœŠ
KIRAN	Jai janasena Jai telangana
Naani A	Who came to here after power StarğŸ–¤ tweet hit like ğŸ–¤
SURESH K	So beautiful song thank Q giving a song
Lucky s	Beautiful song Bathukamma subhakankshalu to all my telangana friend from AP
Shekar mummidisetty	Jai janasena
vinay kumar	Power star fan hit here
baireddy nikhilreddy08	à°ªà±à°°à°ªà°‚à°šà°‚à°²à±‹ à°…à°‚à°¤à°Ÿà°¾ à°ªà±‚à°²à°¤à±‹ğŸŒ¸ğŸ’ à°­à°—à°µà°‚à°¤à±à°¡à°¿à°¨à°¿ à°ªà±‚à°œà°¿à°¸à±à°¤à±‡ğŸ™ à°’à°• à°¤à±†à°²à°‚à°—à°¾à°£à°²à±‹ à°®à°¾à°¤à±à°°à°®à±‡ à°ªà±à°²à°¨à±‡ğŸŒ¸ğŸ’ğŸ™ à°ªà±‚à°œà°¿à°‚à°šà±‡ à°¸à°‚à°¸à±à°•à±ƒà°¤à°¿ à°‰à°‚à°¦à°¿ à°…à°¦à±‡ à°®à°¨ à°¬à°¤à±à°•à°®à±à°® à°ªà°‚à°¡à±à°— âœŠ à°¤à±†à°²à°‚à°—à°¾à°£ à°ªà±à°°à°œà°²à± à°…à°‚à°¦à°°à°¿à°•à±€ à°¬à°¤à±à°•à°®à±à°® à°ªà°‚à°¡à±à°— à°¶à±à°­à°¾à°•à°¾à°‚à°•à±à°·à°²à± ğŸ™ Bathukamma Telangana http t co 5t25M73Koj
lakshmipathi vejju	Who came here after pawankalyan tweet
Rakesh Putla	I m here after PK s tweet Any one like me
avinash goud	Jai pavanism Jai telangana Jai hind
Karteek Sharma	Super super
giribabu voorimindi	Excellent song and music super and voice super
Raja Rani	Negative ğŸ‘» comment ki ğŸ–•
upendhar mudhiraj	Thungathurthy velugupalllla
sravan kumar	2 20 From then the song is awesome Fantabulous lyric and music This would have the initial stanza of the song Anyways Great job
Nikitha reddy	Super
RAYUDU FOCUS ON GULF	à°…à°¨à±à°¨ à°—à±Šà°ªà±à°ªà°—à°¾ à°‰à°‚à°¦à°¿ à°ªà°¾à°Ÿ
Manju S	PK gadu wast gadu but song super
santhosh reddy aluguvelli	janasena power
mark mark	Jai janasena
johnny yadav	Nice
Mohammad Nazeer	Super song
Gadicharla Sammaih	I miss you prathima kusuma
Pastam Krishna	Nice song jai pawanism jai janasena jai pavankalyan
Boini Srinivas	Jai janasena
Srinivas macha	This year hielet song Mana janasena bathukamma song congratulation annagaru team member also
Mohan cheerala	SUPER Good AKk
à°°à±ˆà°¤à± à°¬à°¿à°¡à±à°¡	à°¨à±ˆà°¸à± à°¸à°¾à°‚à°—à±
prem 56 yadav	Nice Song Lyrics ğŸ‘ŒğŸ‘Œ
nagaraju gadamalla	NICE SONG
Shashi Kanth	Super Jai power star ğŸŒŸ
Shyam Sundar Dharmarapu	à°µà±†à°²à±à°—à±à°ªà°²à±à°²à°¿ à°‡à°‚à°¤ à°…à°‚à°¦à°‚à°—à°¾ à°‰à°‚à°¦à°¾ à°‡à°¨à±à°¨à°¿ à°¸à°‚à°µà°¤à±à°¸à°°à°¾à°² à°¨à±à°‚à°¡à°¿ à°•à°¨à°¿à°ªà°¿à°¯à±à°¯à°²à±† ğŸ¤—ğŸ¤— à°¸à±‚à°ªà°°à± à°¸à°¾à°‚à°—à±
Parlapelly Venkatesh	Super babai Awesome Lyrics ğŸ‘ğŸ‘ğŸ‘ŒğŸ‘ŒğŸ‘ŒğŸ‘ŒğŸ’ğŸ’ğŸ˜
abid ads	Abid afs ğŸ‘
Ganji Lucky	Very nice song Jai pspk
Purna Chary	Nice anna
Sai kumar PS PK	super Anna ğŸ‘ŒğŸ™â™¥ï¸ Jai janasena ğŸ”¯ Jai Hind ğŸ‡®ğŸ‡³
Boini Naresh kumar	Vanakka unte inka bagundedi Aa placelo padinatlu natinchina akka lipsink kaledu mariyu suite kaledu idi Pataki pedda velithi Migathandantha ok
Sampath Sampath	Nice song
Deepa Chary Guggilla	Nice song
Pagadala PAramesh	Supar velugupally
sai karthik	Nice songğŸ˜
Gudipati Naveen	Super super song
Tech Madhu	à°¸à±‚à°ªà°°à± lyric ğŸ‘ŒğŸ‘ŒğŸ‘ŒğŸ˜“
shiva sai	Super sir
dhaveer karri	NIC
Sai Krishna	nice song
