Shook	Ya Dig
Daddy Cholo	Yer finally someone who doesn â€™ t clickbait
Drake	Armed and Copywrited
Marva Thornton	Good looking my niggağŸ˜â¤ï¸ğŸ˜
Peyton Clark	Who else replayed this song âœŒï¸âœŒï¸ğŸ¤£
N I ha	My g
PATCH	I LOVE YOOOOUUUU
MoG z	New song new bangerğŸ˜ğŸ’¯
James McLean	It s still up ğŸ˜ğŸ˜ğŸ˜ğŸ˜ğŸ˜ğŸ˜ğŸ”¥ğŸ”¥ğŸ”¥ğŸ”¥ğŸ”¥ğŸ”¥ğŸ”¥ğŸ”¥ğŸ”¥
Charlie	Fucking fire
Tuzity.	This is some good shit bro ğŸ‘ğŸ”¥
Abdi Adan	yo thank you the best channel for song that are took down
Gangster Gardener	BruhğŸ”¥ğŸ”¥ğŸ”¥
Christian Butler	straight up fire
itzzz.christina	people are saying juice wrld committed suicide
Tatter Nut	The REAL people be here
TheRealLegend	Downloaded it thank fuck
_super _sauce	Download the song with a mp3 converter easy
cheetah mclean	best juice song 100
_lilmeatslap_ Jr.	I am so glad we dont have to look anymoreâœŠğŸ½âœŠğŸ½
Skies	Finally
ert6313	f word boi this make my pp hard
Da Mesa	trash
TryeBoi 65	Fuck
YMD -	Like for no clickbait
James Lannon	How is this still up lmao
Tezxii	Sub to me if this juice best song
YT I Fearless	producer how much bass do you wa Juice WRLD YES
brian medina	Someone YouTube to mp3 before it get taken down ğŸ¤£
Thanks Ray Ray Beats	Who ever disliked your mom a hoe ğŸ˜­
PrimeFuzion	SEARCH UP â€œ LIL ZAGS â€ ON SPOTIFY TO FIND THIS SONG â€¼ï¸ ğŸ¤«
Sam Cantrell	This is better than the whole album
DampTHECramp !	Search up lil trim armed and dangerous on SoundCloud Ur welcome
Twisted VitalZ0	JUICE WRLD OR XXXTENTACION
fredisdeaddd	this shit flame finally found a good one ğŸ”¥
Alexis	Whats happening to this song I love it so much but it like it got deleted by youtube or some shit can someone explain me
Jonnesy TheDEFUALT	Now we can here this
whau	B
Eben Stutzman	Thank you for not clickbaiting bro
The KTG Life	â€œ Yea momma yo son to famous he on everybody playlist he still armed and dangerous â€ â€¼ï¸ğŸ’¯
kadinTV	I have a original sound send message to my WhatsApp I give for you 5581986001654
its_ doodlebob	You are an actual goat No clickbait at all thx
CHRISTOPHER MOORE	999 fo life
1000 subs without videos and i Ìll upload	You see my name Please help me reach my goal 3
DeJuan YT	Bro Were The Music Video To This Bro THIS SONG LIT ğŸ”¥ğŸ’¯ğŸ˜ğŸ’µğŸ¤‘
Hayden Carroll	I listen to this song all day and no matter how much I play it it never get oldğŸ’¯ğŸ’¯
Gg Ice	You earned a sub
Runaway Springroll	it on apple music and spotify a long a you search it and is by lil zag
Robert Stanley	MATTER IN FACT FUCK THAT SHIT I DONT NEED IT YOU CAN KEEP ITâš¡ï¸ğŸ’ªğŸ¼
Jenithedon ???	Omg i love this song we finally get a more happy song from juice
Josh Elliott	Ur gang
Trashcan Bob	How is this still up BRRRRUIGHHHH
Lyric is cool	â™¥ï¸ğŸ˜˜â™¥ï¸
maxime borgz	Ggg
Ellie Lawton	ğŸ˜ğŸ˜ğŸ˜ğŸ˜ğŸ˜
No_Skin BuildGod	HACKERMAN
Fnotten	ğŸ™
AM FloW	favourite song juice ha put out hope it stay low key though lol
pyruscity	MVP
Spoopy	Who else will be pissed if this vid get taken down
Lion YT	Screen recorded
magnus7484	Is this gon na be released or something
Boethiah Covin	0 00
Brandi Dakin	It s on Spotify too fam
Kid Juno	various artist topic a real one for this
Jack Frazier	Thank u sm
that boi	What the hell is wrong with his label
edward waLKER	Pay up that cash you owe me Bitch I need it Nvm fuck that shit I â€™ m rich You can keep it Hardest line
Luka Rigter	Finally I get to hear the song
Tyler Perea	You ve earned my respect prop to this vro
Lucas	How tf ha this vid stayed up XD
gnarly tek	ğŸ”¥ğŸ”¥
Tropicana Twister	Watch out for those eye cause she s armed and dangerous like bow
Ep swag	Finally
Jacob Pantoja	I â€™ m just glad it â€™ s not the reversed version ğŸ‘ğŸ½ğŸ‘ŒğŸ¾ğŸ˜„ğŸ˜„ğŸ˜„
Statical Apex	IT â€™ S ON SPOTIFY
ezy cezy	Don t look up on sound cloud shit aid
Ayalaãƒ„	this make me happy ãƒ„
Team. Predator	ğŸ‘€ğŸ‘€ğŸ‘€ğŸ‘€ğŸ‘€
Moody Moodzz	FINALLY BRUH since I forgot his name wan na take stuff down
mykel gibson	Is suck when you find a dope song and it get taking down Glad this one s coming in clutch
Lil code	Guys this channel is a bot not a real person
SAIPAN	How is this still up Thank you for putting this out
KJ Souls	That lil dance he did when he wa on the stage in the video wa hardğŸ˜­ğŸ”¥
Kevin bland	Another lit song from juice wrld
Grant Tyndall	Thank you
Guap	1 16 my god
goku limit breaker	it on imusic
Tucker Hendon	Finally I â€™ ve been waiting for this on YouTube
Jswag Pringle	YouTube AGAIN
Shakil ahmed	Finally ever since the music video i have been addicted to this song but they removed it
Dante Turtneck	I know TikTok is cringe but I have the music video and music on my account dmaccagnan thank me later
Cristiano Ronaldo	this song is beast
Infamous _x231	Ya dig
FIFA MAX	good shit man
BaconDog456	much respect
Slxperry!	Surprised it â€™ s still up ğŸ˜­
Lil -AK	Here one of his unreleased song here it â€™ s a snippet http youtu be diMGOi 6D o
Gaming pro	AYY
YT Nasir	Can you guy go get my reaction to 10k view I m next up btwğŸ¤˜ğŸ½ğŸ”¥
Kushh Kyd	Not Clickbait Hmm good job
ak assasin	Who still listening 3 day after the drop Swear I ll never stopğŸ¤Ÿ
ben amv	Finally I found a good one
KiLl YoUR SeLF	YOU ARE THE ğŸ
AnasTheGamer t	This song made me wan na Idk lol Pls Like this
Hadden 313	Why the video get taken down and every other person who posted it
Jaiden Guice	Juice Wrlds best song by farğŸ’¯
Blazyy ãƒƒ	yung god bro
Joey Montoya	WHAT IN TARNATION
Arsenal Gaming	Shoot him down yeah Wit a fitty round
Dwayne Mallet	Fire
XXX BENETATION	Lil Zagz
xClear	holy fuck this is so illegal he literally took his full audio and listed it a his song so you can buy this on itunes and listen on spotify and shit and HE get the money sus shit but thanks XD
ItsExcel	How â€™ d it not get taken down
Sean Mack	god song
Trenton Marshall	It â€™ s on iTunes Look up guido do santos Thank me later
Eesh Hoops	U the goat
Noble Romell	Juice never disappoint u
robert rector	Bro thank you no click bait Thank you bro
TSG_Flickz	Omg you just saved me
Dopeboidre Gang	Iron on me thts a tony stark yeah
Datboivon Debates	Juice deserves Grammys
fortnite pro	I swear to god I will like this comment You swear
Rubin D Holman	ğŸ”¥
1k subs with no videos	This man never fails me
Angel 1210	Hurry up watch this before it get taken down I wonder why they took it down
Cyber 7	Y doe it keep getting taken down
Monkygearthefortnitegoat	The only one that didn t clickbait
subzero_NS1	Why not on Spotify yet
joshua.	free replay button 0 00
Dylan mcCloskey	Actual flame ğŸ”¥
Jaden Swooden	Shit still up damn
Pau Muang	This song is just sped up from the original one but aight close enough G
Joalta V.	IM IN TOWN PARTY â€™ S GOING DOWN ğŸ¤ŸğŸ¾
Lazlo	I hate listening to leak against what the artist want But this song is so damn addicting
King Bob55	Why he take it down Sooooooo fire man juiceWRLDğŸ”¥ğŸ”¥ğŸ”¥ğŸ”¥
Closing Time	Music video on my channel download it before it get taken down
Kai Rz	how is this still up XD
tarek mctabi	999
TheBaconNuke	Yall Don t Understand How Many Good Ass Punchlines Is In This SongğŸ˜­ğŸ˜­ğŸ˜‚
Gotham 1	Screen record this
Drea Williams	IM SO HAPPY YA DIGğŸ¤˜ğŸ¼âœ¨ğŸ”¥
King Tut	http youtu be MjSiEGBs2bE this video ha the video and song of armed and dangerous
Scarlqrd BANGS	ay fire
cAsH GaMINg	i am only listening ti this
Spongebob	Why did the original song get taken down anyway ğŸ¤”
jase-the_god	Finnaly
Legendary Ballers	Facts
dagger gaming	Is this legit Cause whether it is or not THIS SHIT FIRE ğŸ”¥ğŸ”¥ğŸ”¥ğŸ”¥ğŸ”¥ğŸ”¥ğŸ”¥ğŸ”¥
WerDasLiestIstEinHurensohn	I uploaded it to but no one care whyyy
Agustin Alvarez	Can someone upload this to SoundCloud
Jack Lamka	Is this on SoundCloud
Christian Yohannes	gun make him flash adobe HEAT
yaw youngin #2	This video is not available \
Kipster	Why did Cole Bennett delete the video
Eveni zamora	good song and great line it fire
JustRallax	I don â€™ t think it â€™ s a person they post hundred of time every day
Nynx	3 day later and still here ğŸ˜¤ğŸ˜ˆ hopefully it stay that way
Galen Roca	rip the old video
mahid assiciation	Is this his new song
Cuderz	I â€™ m adding a ğŸ™ğŸ» for every like because he didn â€™ t Clickbait btw first like wa my own like ğŸ™ğŸ»
TokePurp	Don â€™ t monetize this bro That â€™ s scummy
Logan Hogs	Finally
Krish	1 35
Isabella Jacobo	thank you so much many people make it so high pitch lol
82 savage	Yah dig
Chino Honcho	ğŸ”¥ğŸ”¥ğŸ”¥ğŸ”¥ğŸ”¥ğŸ”¥ğŸ”¥
Ugly The kid	Yuh dig ğŸ¤§ğŸ¤¤
Panda boy	Thanks
Yul Kwon	Thank u
Same JUUV	I got the m m â€™ s
Kyr0 xl	YES I GOT TO SCREEN RECORD IT BEFORE IT GOT TAKING DOWN AY AY
Niet Barkie	Can someone record it So you can reupload it if it wil taken down
Connor Brown	download it just in case it get taken down
C4NN0T	I love u
Sayon Ramanan	I have uploaded this song on my channel check it out
Ğ’Ğ»Ğ°Ğ´Ğ¸Ğ¼Ğ¸Ñ€ Ğ¿ÑƒÑˆĞºĞ¸Ğ½	Listening to this since it wa copywrited
jairo Valencia	You â€™ re the goat for this ğŸ–¤
Bertha Snerling	I passed 6 grade today
tybeeop Buttsniff	Spam ğŸ”¥ğŸ”¥ğŸ”¥
Myah Moen	Idk how you got this but I truly thank you for sharing it with u
Raymond B	Good look to you i got alot of respect
jose gomez	strait as
Johnny Huynh	Tyty
Venom_Ninja lol	Yay the song is back
vScxrz	If it get taken down I have it uploaded on my channel
ghost _	Thank you so fkn much for not clickbaiting â¤ï¸
Slim Shady	Who s lil zag
Franklin D Roosevelt	How doe this not get taken down I mean I love it But the original wa deleted sooooo
sG Bob	People thanking this nigga for not clickbaiting but i â€™ m pretty sure this channel wa automatically generated by YouTube which make no sense cause this song should not be up Check description lol it wa auto generated
Era Nation	Fuck that bitch
EagerVip25	999 shit
George Purdon	OMG NOT CLICKBAIT SO HAPPY â˜ºğŸ˜ŠğŸ˜€ğŸ˜ğŸ˜‚
Paul Martinez	ğŸ”¥ğŸ”¥ğŸ”¥
TuneVault	You â€™ re a god
hahanice	Tried to upload a lyric to this song got striked before I managed to publish it how did you do it boi
SkyPlayezzz	Massive respect to this man no clickbait I wish I could give u a thousand dollar in person for the non clickbait
Jason Finik	I screen recorded it if this go down I â€™ m uploading it
henk tv	Why did the original video wa deleted
Fatal Zerkzz	Gun dem downğŸ–¤
Michael Smith	I m in town lookin for this sound finally I found hope they don t take it down
Graz snopp Ã¤r liten	thank fucking good i became addicted to this song first time i heard it and they took it down
GetLostMusic	this song is already on youtube by juice wrld this clown whore is clearly not juice so what the fuck it clickbait flagged for copying
Emmanuel valdez	Why tf would YouTube remove such a good song SMH
Michael B	Finna be one of juice wrlds biggest hit
Uchiha's Son	Can t download it ğŸ˜¥
Schuyler Cassidy	Y â€™ all download my medium and copy this link and paste it into ytmp3 com on my medium and download it
legowampas479	Guys you can download this on Apple Music Look up Armed and Dangerous by Guido Dos Santos Its Juice WRLD s version just under a different name
Nohlin Kheuasouvanh	luv u
GADY CRUZ	ğŸ“‚Documents â””ğŸ“Music â””ğŸ“Juice WRLD â””ğŸ“ Bad Songs â””âš ï¸ This folder is empty
VeNoM Ghost04	This will not be taken down because juice wrld label only removed the music video
Yung Arctic	Make him flash adobe That is probably one of the hardest bar i have ever heard
Epic Gameing 4 Life	this song is hard asf i listen to this on the way to school
Anthony Brown	Look at my bank account
Preston Patterson	Finally dropped fr thank godğŸ”¥
Illuminati	1 25x speed ğŸ˜‰ sound more uplifting and Jolly
Donnie Bell	Ayyyy come on interscope why you do my man like that it wa gon na blow upğŸ’°ğŸ’°ğŸ’°
Jay The Sauce God	Fellas it s been up for two day I think we found the one ğŸ‘Œ
Kyle Carter	Thanks for no click bait fam
Tyler Mizeski	This song made me gay
Tommy Fontaine	Juice WRLD Armed Dangerous http soundcloud com gordontmonty juice wrld armed dangerous official
Jordan May	appreciate you on god
___DeXoRzz ___	You know this song is good when literally everyone you know wa mad that it got removed multiple time ğŸ˜‚ Idk why this song is so popular but I honestly fucking love it
ugly god_demario	Enjoy because this is probably going to get taking down once again
JaRF	Those ad libs in the beginning tho
No Homo Bros	it â€™ s on apple music btw
Lemon Slinky	Thank you
Marcus Bentley	Yes you didn t Clickbait LEGENDğŸ‘
nabil ali	thank u
Noah Harris	finnaly work on school computer cuz
Side Kick	Thx I love this song I rly needed to listen to this
Where meh lamp	FINALLY
David Aboasu	Who else is addicted to this song
shroomzie	FUCK A LABEL
velocity 0689	He could â€™ ve saved his album with this song
Amir coronation king	I have it on my channel to
typical ziggy	please dont take down this one
L LJ	Happy juice ğŸ˜ŠğŸ˜Š wish x wa here to see him happy tho ğŸ˜”
Sovann Dominguez	I ve had this song downloaded
Spencer Sagan	Yass
Opinder Virdi	At last this song so lit They need to officially re release this asap
WaNTeD_KekoatheGod	thank u shit ive been waiting for them to re realese this but the haven t
ãƒ„NoahFN	Download whille u can Gs
Music 4 You	But he still armed and dangerous he ll still pop at strangerğŸ™ğŸ’¤ğŸ’¯
Reggie Productions	Yeeee
Sergio Cuevas	This on replay
HaydenHafley75	THANK YOUUUUUU
Daniel Hernandez	Screen record before it gone
Golden punK 99	Juice Is gon na be a real fuckinig legend in the future bruh â˜ğŸ”¥ğŸ”¥ğŸ”¥ğŸ”¥
Itz Hoefty	This beat so ğŸ”¥ğŸ”¥ğŸ”¥ and this song so ğŸ”¥ğŸ”¥ğŸ”¥ğŸ”¥ğŸ§ğŸ”ŠğŸ”ŠğŸ”Š
Khrayz Smith	This song could have got so many view it would have blowed up but interscope messed that up
Aiden Byrd	oml thank you
walton rogers	That s a moly part That s a Tony Stark Juice WRLD
Brandon Barton	Just prof that juice WRLD should do a solo album
Retro Productions	we can all agree he â€™ s goateed for having the real songğŸ˜­ğŸ™ğŸ¾
Jay Jay	If you read this can you make a 1 hour version please
Wwh King	Time to screen record ğŸ¤¦ğŸ½â€â™‚ï¸
TacticalLlama18	Call my momma and tell her i made it
Paddog	fire
VITO ROBLES	Lyrics
joan silver	Who else hopeing it doesnt get takeing down
YoBoyBradley woah	Trace Kyle is a homo and lick dick
Leonel Cortes	Thank you for the songğŸ‘ŒğŸ‘ŒğŸ‘
College Dropout	Great Now free Da Video Cole
vii	bless whoever postedğŸ¸ğŸ”¥
Marvin Cannon	Umm how is this still up
mechgt5	So many people think this is gon na get taken down Tf Proof no one can read these day
Mason Murphy	You a real one
Royal Gaming	Way better than the new album with future god future turned all those song trash
Abdul Razak	Thank you so much
Justin Chesnowitz	This is on Apple Music
The cOmmunity	Tasty billy is 0 year old like and see how old he get
Twitch / lightlixn	Subbing to everyone who like and sub
word ?	word i have been looking for this
Martin Staxx	Hit after hit this wave doesn t stop http soundcloud com martin staxx martin staxx shooting starsprodbyblackmayo
Kenny Wild	GUYS ITS ALSO ON SPOTIFY UNDER THE NAME LIL ZAGS you â€™ re welcome ğŸ˜
KingGiso	Just reminding everyone to download this so we keep this gem of a song ğŸ’™ğŸ’™ğŸ’™
B3AU_B3AU	smart boi
Isaiah Graham	here before 300k
HASHTAG#GAMER	anyone listening to this song n repeat before youtube take it down
Darrin Whitmore	finally found it again
Lil Supreme	Hope it doesn t get taken down
The Video Critic	Here before it get copyrighted
theREALdeel 30	I screen recorded everything just in case if they take it down
zinedine escandon	LyricsğŸ”¥ Intro Gun em down Bih yeah With a 50 Brr bih brr Gun em down Oh my God huh Ya dig uh hoo 999 shit ayy hoo Chorus When I m in town Yeah uh party s goin down You dig It s goin down hoo Shoot em down Bow with a 50 round You dig A 50 round hoo ayy Run the town What ballin hard you outta bound You dig Swish ayy So much money damn it I forget to count Cash cash cash you dig Hoo Ayy look at my bank account You dig Hoo look at the cash amount Hoo ooh you dig I get the cash I m out Yeah hoo I do the dash I m out You dig Yeah hoo ooh Look at my bank account You dig Ooh look at the cash amount You dig Skrt uh I get the cash I m out Look uh I just be cashin out You dig Skrr Verse 1 Walk in that bitch and I m faded uh I fuck that bitch when I m faded I got the M M s Millions called my mom told her I made it Yeah mama your son too famous Yeah he on everybody playlist But he s still armed and dangerous he ll pop at a stranger Sippin lean clichÃ© I still do it anyway Red or purple in the cup which one shall I pick today Ayy ayy Sippin hard gun on me no need for bodyguard Aim at your body part yeah take off your body part yeah I m swingin when I m off the ecstasy Uh that s a Molly park yeah Iron on me hoo hoo that s a Tony Stark yeah Pourin four in a twenty yeah I m soda pop yeah I m O C three gram wood full of OG Huh BMBM dick like Moby Uh gon make him flash Adobe Uh Pay up that cash you owe me yeah huh Bitch I need it Matter fact fuck that shit I m rich you can keep it Yeah Bitch woo damn yeah damn Rich nigga over here They over here huh yeah Broke nigga over there They over there uh hoo uh Why is you over here Why Go over there Go over uh go over hoo go over there what Yeah yeah yeah yeah Chorus When I m in town Yeah uh party s goin down You dig It s goin down hoo Shoot em down Bow with a 50 round You dig A 50 round hoo ayy Run the town What ballin hard you outta bound You dig Swish ayy So much money damn it I forget to count Cash cash cash you dig Hoo Ayy look at my bank account You dig Hoo look at the cash amount Hoo ooh you dig I get the cash I m out Yeah hoo I do the dash I m out You dig Yeah hoo ooh Look at my bank account You dig Ooh look at the cash amount You dig Skrt uh I get the cash I m out Look uh I just be cashin out You dig Skrr
Hernie Alonso	Finally THANK YOUUUUU
Blitz Mcpeè‡ªæ®º	FINALLY
[EXG] DIBBLE	The real G
Gurinder Dhatt	So this coming back this really good
lil pump fan for life gucci	Why did it get taken down from juice wrld
hi	When I m in town Yeah party s goin down You dig It s goin down Shoot em down Bow with a 50 round You dig A 50 round Run the town What ballin hard you outta bound You dig Swish So much money damn it I forget to count You dig Cash cash cash Ayy look at my bank account You dig look at the cash amount You dig I get the cash I m out You dig Yeah I do the dash I m out You dig Yeah Look at my bank account You dig look at the cash amount You dig I get the cash I m out Look I just be cashin out You dig Skrr Verse 1 Walk in that bitch and I m faded uh I fuck that bitch when I m faded I got the M M s Millions called my mom told her I made it Yeah mama your son too famous yeah he on everybody playlist But he s still armed and dangerous he ll pop at a stranger Sippin lean clichÃ© I still do it anyway Red or purple in the cup which one should I pick today Ayy ayy Sippin hard gun on me no need for bodyguard Aim at your body part yeah take off your body part yeah I m swingin when I m off the ecstasy that s a Molly park yeah Iron on me hoo hoo that s a Tony Stark yeah Pourin four in a twenty yeah I m soda pop yeah I m O C three gram wood full of OG Give BM dick like Moby uh gon na make him flash Adobe uh Pay up that cash you owe me yeah huh Bitch I need it Matter fact fuck that shit I m rich you can keep it Yeah Bitch woo yeah damn Rich nigga over here They over here yeah Broke nigga over there They over there Why is you over here Why Go over there Go over go over go over there Yeah yeah yeah yeah
Branden Ortiz	Got the music video screen recorded
Fate Cypher	it on spotify
Bryan Cunningham	Why ha the song been taken down anyway
ALL HAIL Hitler.	ğŸ”¥ğŸ”¥ğŸ”¥ğŸ”¥
Payton Purnell	Why wa the original taken down
Maso Soup	Thank you for having it on Spotify juice never seems to want to release the song I like lol
Daddy Dave	ğŸ”¥ğŸ”¥ğŸ”¥ğŸ”¥ğŸ”¥ğŸ”¥ğŸ”¥
Parker Jurecek	Your son to famous he on every one playlist FAX
MiDniGhT_CaRnaGE	YOU JUST SAVED US Where Cole Bennett at
Elia Hernandez	Why would his be taken down
NEW WAVE ARTIST	Someone send it to my email dm me on ig lilforeign
FishIsLit	Why doe it keep getting deleted
Yo mama Give me subs	Gun em down Bih yeah With a 50 Brr bih brr Gun em down Oh my God huh Ya dig uh hoo 999 shit ayy hoo Chorus When I m in town Yeah uh party s goin down You dig It s goin down hoo Shoot em down Bow with a 50 round You dig A 50 round hoo ayy Run the town What ballin hard you outta bound You dig Swish ayy So much money damn it I forget to count Cash cash cash you dig Hoo Ayy look at my bank account You dig Hoo look at the cash amount Hoo ooh you dig I get the cash I m out Yeah hoo I do the dash I m out You dig Yeah hoo ooh Look at my bank account You dig Ooh look at the cash amount You dig Skrt uh I get the cash I m out Look uh I just be cashin out You dig Skrr Verse 1 Walk in that bitch and I m faded uh I fuck that bitch when I m faded I got the M M s Millions called my mom told her I made it Yeah mama your son too famous Yeah he on everybody playlist But he s still armed and dangerous he ll pop at a stranger Sippin lean clichÃ© I still do it anyway Red or purple in the cup which one shall I pick today Ayy ayy Sippin hard gun on me no need for bodyguard Aim at your body part yeah take off your body part yeah I m swingin when I m off the ecstasy Uh that s a Molly park yeah Iron on me hoo hoo that s a Tony Stark yeah Pourin four in a twenty yeah I m soda pop yeah I m O C three gram wood full of OG Huh BMBM dick like Moby Uh gon make him flash Adobe Uh Pay up that cash you owe me yeah huh Bitch I need it Matter fact fuck that shit I m rich you can keep it Yeah Bitch woo damn yeah damn Rich nigga over here They over here huh yeah Broke nigga over there They over there uh hoo uh Why is you over here Why Go over there Go over uh go over hoo go over there what Yeah yeah yeah yeah Chorus When I m in town Yeah uh party s goin down You dig It s goin down hoo Shoot em down Bow with a 50 round You dig A 50 round hoo ayy Run the town What ballin hard you outta bound You dig Swish ayy So much money damn it I forget to count Cash cash cash you dig Hoo Ayy look at my bank account You dig Hoo look at the cash amount Hoo ooh you dig I get the cash I m out Yeah hoo I do the dash I m out You dig Yeah hoo ooh Look at my bank account You dig Ooh look at the cash amount You dig Skrt uh I get the cash I m out Look uh I just be cashin out You dig Skrr
Brundie7	ğŸ“‚Documents â””ğŸ“Music â””ğŸ“Juice WRLD â””ğŸ“ Bad Songs â””âš ï¸ This folder is empty
Gamingwithjay	The song is on Spinrilla just in case this get deleted
Big Bo	ITS ON SPOTIFY
Yesenia Gonzalez	FINALLY NOT A CLICKBAITER hope you get a lot of sub god bless you
Theelectro Bros	Bruh I love you
Alvaro Serrano	Lyrics Gun em down Bih yeah With a 50 Brr bih brr Gun em down Oh my God huh Ya dig uh hoo 999 shit ayy hoo Chorus When I m in town Yeah uh party s goin down You dig It s goin down hoo Shoot em down Bow with a 50 round You dig A 50 round hoo ayy Run the town What ballin hard you outta bound You dig Swish ayy So much money damn it I forget to count Cash cash cash you dig Hoo Ayy look at my bank account You dig Hoo look at the cash amount Hoo ooh you dig I get the cash I m out Yeah hoo I do the dash I m out You dig Yeah hoo ooh Look at my bank account You dig Ooh look at the cash amount You dig Skrt uh I get the cash I m out Look uh I just be cashin out You dig Skrr Verse 1 Walk in that bitch and I m faded uh I fuck that bitch when I m faded I got the M M s Millions called my mom told her I made it Yeah mama your son too famous Yeah he on everybody playlist But he s still armed and dangerous he ll pop at a stranger Sippin lean clichÃ© I still do it anyway Red or purple in the cup which one shall I pick today Ayy ayy Sippin hard gun on me no need for bodyguard Aim at your body part yeah take off your body part yeah I m swingin when I m off the ecstasy Uh that s a Molly park yeah Iron on me hoo hoo that s a Tony Stark yeah Pourin four in a twenty yeah I m soda pop yeah I m O C three gram wood full of OG Huh BMBM dick like Moby Uh gon make him flash Adobe Uh Pay up that cash you owe me yeah huh Bitch I need it Matter fact fuck that shit I m rich you can keep it Yeah Bitch woo damn yeah damn Rich nigga over here They over here huh yeah Broke nigga over there They over there uh hoo uh Why is you over here Why Go over there Go over uh go over hoo go over there what Yeah yeah yeah yeah Chorus When I m in town Yeah uh party s goin down You dig It s goin down hoo Shoot em down Bow with a 50 round You dig A 50 round hoo ayy Run the town What ballin hard you outta bound You dig Swish ayy So much money damn it I forget to count Cash cash cash you dig Hoo Ayy look at my bank account You dig Hoo look at the cash amount Hoo ooh you dig I get the cash I m out Yeah hoo I do the dash I m out You dig Yeah hoo ooh Look at my bank account You dig Ooh look at the cash amount You dig Skrt uh I get the cash I m out Look uh I just be cashin out You dig Skrr
N00bert	Anyone know when juice is gon na get this sorted out with his label and upload it again
Yamekazi	I have the full song and video downloaded i just get copyright striked everytime i upload
Cole Huddleston	ğŸ”¥finally Issa whole mission to findğŸ”¥ğŸ˜‚
Lil Sweatshirt	Why did it get taken down in the first place
Stellamay Oster	Every one download this
SO_ TOXIC	Juice wrld is da goat
Man Over Board	http soundcloud com user 932342861 juice wrld armed and dangerous
Joe Clark 1	Why is you over here Go over there
Andre Guillen	Who else wish he would release a lyric video
Hector Leanos	Thanks for Posting This is his â€œ I made it â€ Fun type of song â¤ï¸ğŸ˜ˆğŸ¤ŸğŸ½
_--	Favorite juice song
Trey5 x Draco	Intro Gun em down Bih yeah With a 50 Brr bih brr Gun em down Oh my God huh Ya dig uh hoo 999 shit ayy hoo Chorus When I m in town Yeah uh party s goin down You dig It s goin down hoo Shoot em down Bow with a 50 round You dig A 50 round hoo ayy Run the town What ballin hard you outta bound You dig Swish ayy So much money damn it I forget to count Cash cash cash you dig Hoo Ayy look at my bank account You dig Hoo look at the cash amount Hoo ooh you dig I get the cash I m out Yeah hoo I do the dash I m out You dig Yeah hoo ooh Look at my bank account You dig Ooh look at the cash amount You dig Skrt uh I get the cash I m out Look uh I just be cashin out You dig Skrr Verse 1 Walk in that bitch and I m faded uh I fuck that bitch when I m faded I got the M M s Millions called my mom told her I made it Yeah mama your son too famous Yeah he on everybody playlist But he s still armed and dangerous he ll pop at a stranger Sippin lean clichÃ© I still do it anyway Red or purple in the cup which one shall I pick today Ayy ayy Sippin hard gun on me no need for bodyguard Aim at your body part yeah take off your body part yeah I m swingin when I m off the ecstasy Uh that s a Molly park yeah Iron on me hoo hoo that s a Tony Stark yeah Pourin four in a twenty yeah I m soda pop yeah I m O C three gram wood full of OG Huh BMBM dick like Moby Uh gon make him flash Adobe Uh Pay up that cash you owe me yeah huh Bitch I need it Matter fact fuck that shit I m rich you can keep it Yeah Bitch woo damn yeah damn Rich nigga over here They over here huh yeah Broke nigga over there They over there uh hoo uh Why is you over here Why Go over there Go over uh go over hoo go over there what Yeah yeah yeah yeah Chorus When I m in town Yeah uh party s goin down You dig It s goin down hoo Shoot em down Bow with a 50 round You dig A 50 round hoo ayy Run the town What ballin hard you outta bound You dig Swish ayy So much money damn it I forget to count Cash cash cash you dig Hoo Ayy look at my bank account You dig Hoo look at the cash amount Hoo ooh you dig I get the cash I m out Yeah hoo I do the dash I m out You dig Yeah hoo ooh Look at my bank account You dig Ooh look at the cash amount You dig Skrt uh I get the cash I m out Look uh I just be cashin out You dig Skrr
Emilio Trevino	It â€™ s on I tune
TXG Productions	Thank you for not clickbaiting and why can â€™ t I fucking find it on SoundCloud
Assassin_official	I hope this stay oml
kittenman Max	Finally a real one
NVO Pearch	i fucked my dog to this
RobinX â€¢	Intro Gun em down Bih yeah With a 50 Brr bih brr Gun em down Oh my God huh Ya dig uh hoo 999 shit ayy hoo Chorus When I m in town Yeah uh party s goin down You dig It s goin down hoo Shoot em down Bow with a 50 round You dig A 50 round hoo ayy Run the town What ballin hard you outta bound You dig Swish ayy So much money damn it I forget to count Cash cash cash you dig Hoo Ayy look at my bank account You dig Hoo look at the cash amount Hoo ooh you dig I get the cash I m out Yeah hoo I do the dash I m out You dig Yeah hoo ooh Look at my bank account You dig Ooh look at the cash amount You dig Skrt uh I get the cash I m out Look uh I just be cashin out You dig Skrr Verse 1 Walk in that bitch and I m faded uh I fuck that bitch when I m faded I got the M M s Millions called my mom told her I made it Yeah mama your son too famous Yeah he on everybody playlist But he s still armed and dangerous he ll pop at a stranger Sippin lean clichÃ© I still do it anyway Red or purple in the cup which one shall I pick today Ayy ayy Sippin hard gun on me no need for bodyguard Aim at your body part yeah take off your body part yeah I m swingin when I m off the ecstasy Uh that s a Molly park yeah Iron on me hoo hoo that s a Tony Stark yeah Pourin four in a twenty yeah I m soda pop yeah I m O C three gram wood full of OG Huh BMBM dick like Moby Uh gon make him flash Adobe Uh Pay up that cash you owe me yeah huh Bitch I need it Matter fact fuck that shit I m rich you can keep it Yeah Bitch woo damn yeah damn Rich nigga over here They over here huh yeah Broke nigga over there They over there uh hoo uh Why is you over here Why Go over there Go over uh go over hoo go over there what Yeah yeah yeah yeah
CAREY HENRY	Fire
Isaias Ortiz	We screen recorded it lol
Restart Once	Why tf doe this keep getting taken down
TRIBAL LEADER	sippin henny clichÃ© i still do it anyway
MR BADOON ANIMAL	Yo you a legend
sidney Winter	Yo im here b4 this hit radio
xExTract_Beastx	Why would juice take down a fire song that would get him so much money and downloads ğŸ¤¦ğŸ½â€â™‚ï¸
YT Young_klutchh	I m pretty lucky to see that there were at 999 comment ğŸ˜‚999FOREVERğŸ–¤ğŸ’”ğŸ–¤â€¼ï¸
ItsMeM1ke	I wa the one who ended 999 comment sorry guy
llÅ¤BÃ‘Å˜llÃ½Ã¸Ä·Ã¤ÅºÃ¸	Download while you can
Jer'Run Goolsby	Thank you
Avery Durham	ğŸğŸ comment if you agree
David Weinstein	1 000th
Aurelia Crumby	okay is this one staying for good
Catch Playz	Thank you for not clickbaiting
Keaton Parish	Everyone that ha Apple Music type in â€œ ep â€ it â€™ s in the album
AtomicNate	Screen record before it â€™ s taken downğŸ’¯ğŸ’¯
playb0ysam	Ya dig
lil ramen	At least this 1 doesn t tell u to download a virus
RazorX	For all the people that are here Here â€™ s a tip Screen record this so when it get deleted you always have your own version
Kung Jin	Recorded
LIT ANI	this is liiiiiit
Richard Delgado	It s on lil zag in Spotify
alexsander Zuger	Thx bro I will sub if you sub to my other channel that I just started worstfortnite player and yes their is a space
itz cloakzy	Why they took this song down is so fire
AyeKarim	Yo this nigga making money through streaming from Juice s content this shit is on Spotify under his artist name Lil Zags ğŸ¤¬
Irving Vlogz	Intro Gun em down Bih yeah With a 50 Brr bih brr Gun em down Oh my God huh Ya dig uh hoo 999 shit ayy hoo Chorus When I m in town Yeah uh party s goin down You dig It s goin down hoo Shoot em down Bow with a 50 round You dig A 50 round hoo ayy Run the town What ballin hard you outta bound You dig Swish ayy So much money damn it I forget to count Cash cash cash you dig Hoo Ayy look at my bank account You dig Hoo look at the cash amount Hoo ooh you dig I get the cash I m out Yeah hoo I do the dash I m out You dig Yeah hoo ooh Look at my bank account You dig Ooh look at the cash amount You dig Skrt uh I get the cash I m out Look uh I just be cashin out You dig Skrr Verse 1 Walk in that bitch and I m faded uh I fuck that bitch when I m faded I got the M M s Millions called my mom told her I made it Yeah mama your son too famous Yeah he on everybody playlist But he s still armed and dangerous he ll pop at a stranger Sippin lean clichÃ© I still do it anyway Red or purple in the cup which one shall I pick today Ayy ayy Sippin hard gun on me no need for bodyguard Aim at your body part yeah take off your body part yeah I m swingin when I m off the ecstasy Uh that s a Molly park yeah Iron on me hoo hoo that s a Tony Stark yeah Pourin four in a twenty yeah I m soda pop yeah I m O C three gram wood full of OG Huh BMBM dick like Moby Uh gon make him flash Adobe Uh Pay up that cash you owe me yeah huh Bitch I need it Matter fact fuck that shit I m rich you can keep it Yeah Bitch woo damn yeah damn Rich nigga over here They over here huh yeah Broke nigga over there They over there uh hoo uh Why is you over here Why Go over there Go over uh go over hoo go over there what Yeah yeah yeah yeah Chorus When I m in town Yeah uh party s goin down You dig It s goin down hoo Shoot em down Bow with a 50 round You dig A 50 round hoo ayy Run the town What ballin hard you outta bound You dig Swish ayy So much money damn it I forget to count Cash cash cash you dig Hoo Ayy look at my bank account You dig Hoo look at the cash amount Hoo ooh you dig I get the cash I m out Yeah hoo I do the dash I m out You dig Yeah hoo ooh Look at my bank account You dig Ooh look at the cash amount You dig Skrt uh I get the cash I m out Look uh I just be cashin out You dig Skrr
U Suck	I have this song if you want hmu
CustomTk	Why wa the first taken down This is fire
crazy life problems	Litt asf
OCPEBBLE	Download while u can boy
FAZE NOZEY	GUN EM DOWN
Wyatt Smith	Good shit
Isaac Quiroga	http drive google com file d 1vLwyx6KNc GmicUG1WgnOh7gEsRyUwmF view For the music video
Roy_ 87572	Y TF is everyone watching this y all know Cole Bennet posted the actual song right Btw I just clicked on it to leave this comment so don t gim me that bullshit bout why am I watching this
Expect AzPeCt	thank you needed this banger
marco	Finnaly someone that ha the original song respect 2 u
Ryan Trimble	This song need to be a soundtrack for 2k or at least put it on SoundCloud Like if agree
gagandeep hira	Does anyone know if thry are going to reupload the orginal music video
Daron Wright	Ok yuh yeah ğŸ”¥ğŸ”¥ğŸ”¥
Kuran Kunchala	Thanks for not clickbaiting
You Are Mean	It â€™ s on Apple Music guy
Slom Doom	DONT TAKE DOWN PLEASASE
Kyle Koz	Better than anything on wrld on drug
6ix Hundo	Can i use this in a fortnite video under fair use
Daccari Brandon	EVERYBODY WHO NEEDS IT SCREEN RECORD ITğŸ˜‚â€¼ï¸â€¼ï¸â€¼ï¸
Glizmo Flash	Why the first one get taken down
True_Madness 21	Thank god
KZ Gaming	i have the full video hmu on instagram vnpl or hmu on snap keeldit
PuLzE Savage	Everyone sub to him ğŸ™ğŸ™ğŸ‘ŒğŸ‘ŒğŸ¤˜ğŸ¤˜
Arrowhead	http youtu be Z2Kd214K ek music video here
InFuriousGamer	Xxxtentacion is Alive I have video prove on my page NO CLICKBAIT
Kid phaze	Juice wrld need to drop armed and dangerous sad and naruto asap These are all unreleased song
Joshua McGee	Thanks bro real shit appreciate it been looking for this for hellas
Ivan Morales	Someone screenplay this ğŸ”¥ ğŸ˜­ğŸ˜­
Its Enviouz	Finally
X Cage	The music video is on ytube pk
Dark Wolf	Who else listened when lyrical lemonade accidentally released this
Xoxic XÌ´ÍˆÍ—Í˜	GO TO MP3 JUICES ONLINE AND SAVE TO DROPBOX BOIS
Splash BROZ	I CALLED CHIEF AND THIS IS IT
ItsTropic_	Dm me on ig for the music video with audio brazytrim
Marco Turturro	You a good youtuber bru
big knotty	soundcloudd why plz put this back up
Cristian Builds	Thanks ğŸ™
Alexander Matos	Good look
Jacob Kleppin	hope this doesn t get taken down for copyritght
TAB & DOM	http youtu be WAHJ yLWW7M
Adam Karzai	screen record this shit if it is taken down
Nathan P	Why did he delete it
Norm Beats	gun on me no need for bodyguard
ObliviousNinja	Thank u bro I been waiting on dis
ETHAN arceo	ya dig
NesiPlayz6 9	Omg this beat is soooooo good seems like one of rich the kid beat
theOG memes	Finally a real one man ğŸ˜‚ literally everyone sub to him right now
BLADE123	I have the download for the song on my channel it in the description
THUNDERVLOGSYT WESTBROOK	Hes literally the only person i seen on youtube that hasnt clickbate the song after the video wa deleted
Christian Ramirez	Search up lil Zags on spotify and there it is Your welcome
Ro'D Cajuste	It so hard to look for a video I wa so madğŸ˜ ğŸ˜ ğŸ˜ ğŸ˜¡ğŸ˜¡ğŸ˜¡ğŸ¤¬ğŸ¤¬ğŸ¤¬ğŸ¤¬
Adrian Carreon	Why doe it keep getting taken down
Augustus Sinclair	Can someone tell me why this get taken down
MPX7129ER	I hope it stay up ğŸ”¥ğŸ”¥
Ezral Passley	Aye
Kyree Mcelrath	Yo someone screen record this for me and send it to me on ig before it get taken down lilsavage329
Gavin Rushing	I love you ğŸ˜‚ğŸ‘Œ no homo thoğŸ˜‚ğŸ‘Œ
Tone_Glizzy	this dropped
TOG_ Guevara	Thank you
Hidden Lotus	It â€™ s not the exact same or so it just feel like it But this is the closest we have so it â€™ s amazing Good stuff dude
Epic Games	Where â€™ s the harmony at the ya dig part ğŸ˜­ğŸ”¥ 0 34 ect
brian fitzpatrick	It â€™ s the real one
Wolfyxking	Hearing from here cause it got taken down ğŸ”¥ğŸ”¥ğŸ”¥ğŸ”¥
LLCool Gabe	No clickbaittt I â€™ m surprised fire tho thx I just screen record if it get you know thx I subed
Collin Fanning	Look up â€œ let go ep â€ on Apple Music and you will find it
J.M.A	Everyone screenrecord
Jj Ff	I subbed
Dylan Mccloskey	this is it chief
Enrique Chavez	If u want on Spotify search Lil Zags
paradigm	It â€™ s on iTunes not on his account but on a guy named guido do santos
Fortnite GOAT	YEESSSS
artiC_SaltS 07	for once not click bait your the best edited full respect ğŸ‘ğŸ‘
JbLit69X Fortnite	First real one thxğŸ’—
JaayFinesse	Who else seen the original video
KERVINXD	this leaked shit my boy FBI
Diego Fp	You get my respect hommie for not clickbaitng
Puggyosaurus -	Everyone be prepared and screen record before it get taken down again
Randomchannel 123	I FUCK THAT BITCH WHEN I M FADED
luke21nuke 5	Thanks I ve been waiting for this
Orlando Martinez	You are the definition of ğŸ
Bands__	Screen record it everyone
Dylan Turner	This is One of My Favorite Song Plz Don t Take Down
Officialmiguel	Love this
ArmedBale 30	Can someone write the lyric
Reece Turner	He finally did a hard song without saying drug x50 Congratulations juice world
Cole Tawney	Everyone screen record it
Yung Salmon	Ayy the music video is on my channel with the audio
KingIzHere	This is illegal bruh ğŸ¤¦ğŸ½â€â™‚ï¸ğŸ˜‚
Dominic Figueroa	999
Stalls	LMAO LETS GOOOOOO FUCK YOU UMG
JackyIsHere	Lil Zags ha even put it on spotify this nigga the goat
vRaz Lynx	I m happy
Clark 770	Thanks for not clickbaiting
GoDzZ Yo	Its on Cole Bennett s Twitter
Idrink Hennessy	The music video is on his twitter btw y â€™ all
Carson Jonah	Download it before it get taken down
AkaGlide	Why doe this beat remind me of another song it â€™ s on the tip of my tongue
TYJAWAN STABLER	Thanks for not being a no life clickbaiter finally it â€™ s back on YouTube
gus carfagno	been waiting for someone to drop it again
Tazz	This shit is stupid hard
VFX _Valiant	Ya dig
Wiz Kalifa	Aye thanks bro
KÌ·eÌ·vÌ·iÌ·nÌ·	ğŸ”¥
Lucas Osborne	Why did juice take this down in the first place
The Man	thank you fuck so much clickbait finna mp3 download
Jlambs 25	Download this shit right now
Cion Roux	Put it on SoundCloud or Spotify
I Ed	Who waited for it to come backğŸ˜
Merasmus	God bless
Aril Mauguit	Thanks
YC RJBAD	When the label only want sad music I swear
Daxx Corneiro	How did u get it I mean thank u a lot but how ur a legend
Phoebe Stober	This is my fav song
Rxf_bxds	how did this not get down mine did when i posted it
Jon Richards	ğŸ“ Documents ğŸ“ Music ğŸ“ Juice WRLD ğŸ“ Good song âš ï¸ Warning This file contains lot of character
M0dZ	I got copyright strike for uploading the music vid but the music vid isn â€™ t in YouTube WTF
hii Momoa	Why wa it taken down any way
Nullify	I missed this song
Redmond t	better downloade now
skirt skirt	Best song yet
lak fas	What happened to this song It got taken off cole Bennett spotify and soundcloud
jose mendoza	Surprised it hasn â€™ t been taken down yet
Legend Gamer	Thank you ğŸ‘ğŸ¾â¤ï¸
Chemiss Parker	He s Flowing Like Young Thug On This One Beat Sound Similar To Young Thug s Instrumentals Too Still A Good Song Tho
Jose Mendez	What happened to the original video
MaggioreDrake	Why is this song so hard to get Someone please explain
The AUX Cord	Download while you can guy
Cock Monkey	Guys if this get taken down then there â€™ s one on pornhub
Lucid Memer	Ya dig
trenton wooster	Hmu on Instagram yung bull 412 if you want the real song and music video ğŸ’¯ğŸ™ŒğŸ”¥
Scary shi 12	I got the music video one boy just look on my channel
FaZe Acronix	yooooo
Lauren R	How do u find this on soundcloud
chasegaming	Thx for this I â€™ m screen recording this rn
Vladimir Lenin	Why did they take the original even get taken down
SageEpic evan	I â€™ m so happy this is up I â€™ m ganna take off my body part
heKtic kaden	i have the full video and audio on my channel check it out
crustyspace9	i got an ad of donald trump talking about building a wall
Fat NiggerFj	Like for best upcoming rapper ğŸ”¥mad tune
Sebastian Mirek	Y â€™ all don â€™ t need to screen record it lmao it â€™ s YouTube generated it not gon na get taken down kid
Nas	Just noticed this is the song name is a moive
xcscully cinema	Litty titty
Jonathan ramirez	Uzis lost brother
Laced Up	Your a legendğŸ¤Ÿ
Jarsin09RC	FLAMES
Monique Upchurch	Finally but wtf happened to tge video
LIAM ROEH	if you could put this on sound cloud i would love that please
Pom Pom	The video wa liiit where it go
Two brothers	I just subbed thank you keep doing this stuff please â€œ gun on me no need for bodyguard â€ Love this sooooo hyyppped you a â€œ rich nigga â€
Cesar _Salad96	Thnk you ğŸ™
Noel Rodriguez	This song make my cock hard
Gerardo Garcia	I going the actual video Not click bait http youtu be qH6LBX11SGQ
Ricardo Ritz	Lmao I posted mine they took it down within 1 min
Terry Floyd	Wish I can watch the video
Blakz	Who here before this get takin down too
Jaevion Conley	good look fagot finally got a good 1
Lil Zoomy	Keep uploading this fire as song bro
Chase Judkins	best beat
Adam Abdi	one day without it taken down LETS GOO
Hunter Olson	About time bro I have been waiting since this song released
Mysterious Taco	give me one reason why it would get taken down dumbass
Andrew22	Screen recorded boyyyy ahahhaaha
Darren Meeker	literally tried ever single way to listen to this song wa stuck in my head all juice wrld doe is put banger out
ProdBy 1600hunnidsisRage	Im posting the full version music video on my channel with the original audio be sure to check it out
12a3 Aleksandar	Thank you
TPS Sean	ğŸ¤ªğŸ¤ªâ˜ğŸ½
LIL MEOW MEOW	Hey go see my new vid of Juice wrld Lyrics on my channel
Alec Burgess	Huge respect bro
teh Tact	Yah diiig
Lorenzo Aken	Damn this the longest it been up ğŸ¶
ImTheLegend 27	Who is better Juice wrld like Lil xan comment
Logan Carpenter	I Love You For This â¤
OroLime Lemon	the Original wa re uploaded then tooken down again yet this one is still standing proud
xd chomp	Thx m8 ğŸ’¯ğŸ‘
ThisIsNotTheJohnnyTron	it s also on spotify look up lil zag
Brandon Gomez	This is going to get so many veiws
HIBRIDO SLENDZ Rich Slendz	Finally
Team 8hunnid	Yeah momma yo son to famous he on everybody playlist but he still armed and dangerous he ll pop at a stranger that hoe wa ğŸ”¥ğŸ”¥
ImTOoNzzz	Download it
Unleashed	damn 17k view in one day mine been up for 3 day and only 1k view
your mom	Wow they haven t took it down yet
Kryizo The Gamer	they just down evary armed and dangerous down but this won THANK YOU SO MUCH
AustinBulls 21	Downloaded this just incase lmao
Ihityouoffline	SLAPPPPPPSSSSS YAAA DIGGGGGG
Marvin Colquitt jr.	who tf is lil zagsğŸ˜‚ğŸ˜‚ğŸ˜‚ğŸ˜‚
Hunter Standridge	why did the song get taken down
Geno TLS	Anyone know why it got tooken down
Cameron Collier	So happy rn
ttv.Zanyy	Schooll shooter anthem
Austin Black	aaaayyyyyyy
Xx _ bOsS _ xX	This video diserves like a mil view already
Tom Koperski	Can we get this comment to 1k like before the vid get taken down
MeSo Sama	Anybody know why they deleting them
MrKaare	anyone know hy the original video wa taken down
Three T	If you look up lil zag on Apple Music you can download it
Fakka gang	Thank you soo muchh bro
Harrison Cliffin	Anyone else saved this to their playlist on soundcloud when it wa legit listed by juice but to taken down now but you can still listen to it
Joey Cervantes	Where wa this on the album juice
its.kelkom 95	You re a hero
Alfonso Reyes	Finally I wa looking every where for this song I hope they don â€™ t take it down
Elijah Roden	I hope this doesn â€™ t get taken down
YouTube-fruitee	Damn keep this video up we need this song
Alex Escudero	Gun em down Bih yeah With a 50 Brr bih brr Gun em down Oh my God huh Ya dig uh hoo 999 shit ayy hoo Chorus When I m in town Yeah uh party s goin down You dig It s goin down hoo Shoot em down Bow with a 50 round You dig A 50 round hoo ayy Run the town What ballin hard you outta bound You dig Swish ayy So much money damn it I forget to count Cash cash cash you dig Hoo Ayy look at my bank account You dig Hoo look at the cash amount Hoo ooh you dig I get the cash I m out Yeah hoo I do the dash I m out You dig Yeah hoo ooh Look at my bank account You dig Ooh look at the cash amount You dig Skrt uh I get the cash I m out Look uh I just be cashin out You dig Skrr Verse 1 Walk in that bitch and I m faded uh I fuck that bitch when I m faded I got the M M s Millions called my mom told her I made it Yeah mama your son too famous Yeah he on everybody playlist But he s still armed and dangerous he ll pop at a stranger Sippin lean clichÃ© I still do it anyway Red or purple in the cup which one shall I pick today Ayy ayy Sippin hard gun on me no need for bodyguard Aim at your body part yeah take off your body part yeah I m swingin when I m off the ecstasy Uh that s a Molly park yeah Iron on me hoo hoo that s a Tony Stark yeah Pourin four in a twenty yeah I m soda pop yeah I m O C three gram wood full of OG Huh BMBM dick like Moby Uh gon make him flash Adobe Uh Pay up that cash you owe me yeah huh Bitch I need it Matter fact fuck that shit I m rich you can keep it Yeah Bitch woo damn yeah damn Rich nigga over here They over here huh yeah Broke nigga over there They over there uh hoo uh Why is you over here Why Go over there Go over uh go over hoo go over there what Yeah yeah yeah yeah
Tamara Ford	Love this song and it go hard
Mike Mcteigue	Shoutout to the GOAT for having this up without clicking a description
GorgeouslyReal T.V.	Finally Thank you Mad I can t find the video anymore
ITZYEEBOI 639	ITS ON SPOTIFY If you guy lookin for it just look up lil Zags You will find it
Sabrina Miller	hope they dont delete it
Jhon Symon Panilagao	Lmaooo in soundcloud there be hella artist clickbaiting just to get them play man
THE BOSS KILLER	Everybody save it
Austin Brendtke	Finally
oTravis	Hope this shit don â€™ t get taken down
Itz Lunrzz	Do you think this will be copyrighted if I put it on one of my YouTube video
lilbopeep Brand new bitch	Fuck juice world label for taking this shit down this shit is fire ğŸ”¥ asf
Teatimeboxer	This the best sounding audio version ğŸ’¯
Spotify	I been downloaded the real version lmao
Jared Muro	Thank you so much I wa looking for the song
Howard The Alien	I think youtube ha given up with the copyright
Marvin Buckner	You â€™ re the biggest legend of 2018ğŸ‘ğŸ”¥
2 Subscriber in 27 days	If you have iPhone SCREEN RECORDâ—ï¸BEFORE IT GETS REMOVED Ps NOT MY COMMENT IM JUST TRYING TO SPREAD THE WORD
SoggyDoggy	I have the video downloaded
Savannah Marie	Hope they don â€™ t take this down first of all why did they take it down
Chris Martinez	ğŸ”¥ğŸ”¥ğŸ”¥
Zachary Schmeckpeper	Thanks i finally found it i even sucscribed because u have it
default dan	Thanks
jeremiah yee	
Dr2k 401	Thank u
Jennifer Westwolf	It s goodğŸ˜‹
Rave_ ConZy	thanks for not clickbaiting i â€™ ve been clickbaited from this song
Prime Bryce	If u have screeen record screen record this before it get copyrighted
Daily2k&More	If you have Apple Music search up Let go ep and you can find armed and dangerous
Mario Martinez	Put it on SoundCloud
Rz-Nation	THANK YOU SO MUCH
Simon J Ellingson	I like boy
Verrol Adams	I subed cause u Da G O A T
Riley m Simpson	999
aVaCaDo 99	Fire ğŸ”¥
sammy watts	ğŸ“‚Documents â””ğŸ“Music â””ğŸ“Juice WRLD â””ğŸ“ Bad Songs â””âš ï¸ This folder is empty
RICO SUAVE	Imma download this shitt thank god
CC Football	http download1905 mediafire com t4c41qoc4akg 6xf8bj5vxp4xabq Juice WRLD Armed 26 Dangerous 28Dir Cole Bennett 29 281 29 28online audio converter com 29 mp3
Block Rusta	next thing u know taken down
Cody Suss	I made sure to screen record this shit this time
Aspect Gaming	Ya dig
terrell Clark	bro thx so much I went through some account looking for this song mad respect to u ğŸ’ªğŸ¾ğŸ’ªğŸ¾ğŸ‘ŠğŸ¾ğŸ‘ŒğŸ¾ğŸ‘ğŸ¾ğŸ‘ğŸ¾
White Boy Ev	2018
frozen potato	If this get taken down just look it up on pornhub ğŸ˜‚ğŸ˜‚
Retired Roblox Player	Everybody Download it just in case
Orlando Santana	copy right plz say no
Laughing CatCookie	Plz don t get copyrighted crossing finger rn
Smokepurpp 1	This man deserve 10 nuggies for no click bait
Oofer Gang	Make him flash adobe One of his best lyric
DoorsAreNice	special place in heaven for this guy
iF Kqpes	Love this song
Ric'z	Everyone go on Google and search MP3 juice and search the actual song on it and then you can download it to your music no need to screen record it
Mr Cheap	bet down in a hour
Bandit31	Just screen record Incase it get taken down
LateNight Pastafari	Finally Hope it stay up ğŸ”¥
David Muniz	I like how everyone think this is going to be taken down No it s not this guy channel song dont get taken down
Chantal Cardin	I love u
I AM Beatz	Don t take it down
Kene Arah	THANK YOU SO MUCH
Noah Marean	How long before it get taken down
DxQx	Add me on discord for the full song with music video i downloaded it before it wa taken down ZÑ”ÑÏƒĞ¢Ï‰Ïƒ 0002
King Vlone	ğŸ”¥ğŸ”¥ğŸ”¥
Ousmane Diallo	Why doe it get taken off everytime
jermaine tv	Thank you ğŸ™ğŸ¾ğŸ¤§ğŸ–¤ğŸ–¤ğŸ–¤
ItzPug Fortnite	make sure to record it people
LeoTree	They needa just drop this already label dumb asf
It'syasavage21 Xxxtentaction	You are my savior
Limous 2	someone can tell me why the official music ha removed on youtube and other plataforms
Nicole Gibson	U the goat
gameofthrones12 d	My god this is good
MC MLee	What â€™ s a molly park
Sean Sevcik	Screen record it guy just in case it get takin fown
Diego HernÃ¡ndez Resendiz	i need this on spotify
Riot Feared	Screen record before it gone
FOCUSEDDOPENESS	This is why this nigga should have never signed now we got ta deal with this label shit They not finna let u get shit for free I need this shit it too hard
Jessie Snyder	Im so happy i been looking for this for a while now thank you for posting it
Arthur Solis	I have the music video
ANM_Simba_The_King Leader	Yessss
the FIERCE Duo	â€œ IM IN TOWN PARTY GOIN DOWN YA DIGG â€ ğŸ”¥
Badinc 247	You got so much respect for me
tj the boss God	Thank you no clickbaitng I am going to sub
sarah ediss	YASSSSS
Jsitez	Lmao finally
Kaylen_The_God	Why did they take it off of YouTube colebennet juicewrld
RG Frantiqs	Shoot em down
StepwisE	Paste it to flvto com
Adam Oualidi	ur raw
Jet Glides	Am I The Only That Screen Recorded This ğŸ˜‚
Supreme LoKz	Leaked head as
Mansahib	Here before it get taken down
Goku777 Leeet	Why did they take it down
Deane B	Never been a happy that I found this
Borinquen Gaming	It â€™ s on Apple Music look up Let go EP by Guidos Dos Santos It â€™ s 0 99 you â€™ re welcome
Xpecit !	Thank youğŸ˜‚
wyattisterrible	ğŸ‘THANKğŸ‘YOUğŸ‘VERYğŸ‘MUCHğŸ‘
C Shxfty	I m just trying to give advice but screen record this before this song get taken down
z3 gamekiller	YA DIG
Eazy Dubby	YESSSSSSSSS
no name	How dis get dislike I spent all day looking for this song thank you
Charles	This shit slap
Dj Tate	Please don â€™ t get taken dont
Joshua Garcia	This is the best version
Realarkgrinder Only	Hell yeah i been looking for this thanks
Matt L	Like if this is best juice song
Nastelo	ğŸš¹I ğŸš¹E A T ğŸš¹ C H A L K ğŸš¹ğŸš¹ O N ğŸš¹ M YğŸš¹ C H A N N E LğŸš¹ in case u were wondering
DANK SPAGHETTI	Ya Digggggg
Hoppingandhopping Lololol	It go hard af and they got the real audio unlike other people they don t even have the audio
NO	It ha been hell for u for the past 3 day trying to get this song We had to go thru click baiting lyric to downloading the sond which led to me getting a 27 virus But now we are safe ğŸ™Œ
Lety Rico	This Could Be The Songâ¤ï¸ğŸ¤ğŸ”¥
Peter Griffon	Finally it â€™ s out again
the savage537	Gun on me no need for boty gard
Christian Schmidt	it good at 1 25
Cara Coursey GM 2022	Thank you so much Various Artists Topic This song wa blocked and I could not find the actual song until now you have no idea how much you just made my day
Wavy Nay	Might start sceen recoding now
Shelovestafi	You should make the thumbnail grey so YouTube think it already got deleted
Akira Torres-Inami	Thx
Aephox GT	Bruh add this to spotify asap
IZAYA JAUREGUI	Thank you for not clickbaiting You are amazing for this You got a new subscriber for that
Donda Nana	Downloaded
Steeven Moise	Thank you so much it on deezer guy ğŸ’¯
Trollz Gaming	My replay button is bouta stop working
Vegans_are_stupid	Why are they taking this song down
Extra Lite	Thank you both I needed this song
CityTeam Ro	Hope it don t get taken downğŸ˜­
Christian Ruocco	ğŸ™ thank you
Red Spartan	it didnt get taken down
Gunsmoke102 -	Here before 35kğŸ–¤
Adrian Taylor	Hurry up and do what y â€™ all need to do before they take it back down
Itz Lui	Too bad it â€™ s probably gon na get taken downğŸ˜¢
rich mango yt	Hurry up and listen to it before it taken down
Bloodeux	You know I m putting this on loop for ATLEAST 5 hour while I play bo4ğŸ˜
Tony Noble	My theme songğŸ’ª
Nihoul Victor	Guys I save the original MP3 File when Cole leak the song if someone is looking for it send me a message on Instagram vnihoul77
Triller Dinero	Keep it a secret YOUTUBE SHALL NOT TAKE IT DOWN
Jericho Haddadin	Wtf is ain t down yet
Solargaming7	Thanks for not clickbaitingâ€¼ï¸â€¼ï¸â€¼ï¸
Camden Gallentine	Aaaaaaaaaa armed and dangerous aaa
soy saucy	Y they take it down
Baw bee hill	Cole Bennett be like
Omarion Weathers	Help ne
X Fan	How this still up
Annett Sudarma	Thank you so much
FeatZ	Thank you â¤
Gamingwith MQ	Now I can t dele my recording of it
Ascended_Gamer	YESSSS
Shakespeare Ostin	Thank you dude
Nathan Espinoza	Everyone screen record before it get taken down
Itz Gagan	Why interscope take this down this shit LIT ğŸ˜©ğŸ™ğŸ½
Evidence Films	These channel topic are Auto generated by YouTube i think this isn t the first time i see one of these Is written also in description btw
Savage.goon Gordo	Thanks g 9ğŸ–¤9ğŸ–¤9 clubbbbb
Stuart Whiteman	Respect bro
Peace B	Who tf Lil Zags Lol
Shinobi Visualsé¬¼	Why did Cole Bennett delete the music video
Modern Vine	FINALLY THANK YOU LIKE IF YOUVE BEEN WAITIN ğŸ¤™ğŸ»
Hiaa Hiaa	THIS GOT TA BE REPOSTED ON SOUNDCOLUD
Samuel Navoy	Thank the god finally the song without a stupid link
WRgaming :]	TRiiggGGerrred
Ju TV	Sub
Daniel Joseph Detillo	Honestly MAD RESPECT FOR NOT BEING CLICKBAIT NOT ALL HEROES WEAR CAPES MY GUY
â€¢ Ludix â€¢	What happened to the original music video
xKorze	Damn Finally found it again
brandon silva	Thank you thank you so much I wa pissed when they did that to his song that wa bull this a beast song
Eddie Warren	U the goat
Chritian Young	Finnally real audio thx so much Like if u like juice wrld
Nash_ossas OSSAS	watch it get taken off within an hour
Riley Coulton	Thanks sm man fr
isaiahZ murray	Thank god ğŸ‘ğŸ¾ğŸ‘ğŸ¾ğŸ‘ğŸ»
FaZe_Rexzz _	â¤â¤
schweinemarmelade	thanks broâ¤ï¸
Marco  Robbiati	I do the dash im out
DK5	Am I the only one glad that this song isn â€™ t sounding like chipmunk ğŸ˜‚
The Council Lads #ITSCOMINGHOME	Wait why wa the song taken down
MR2K3000	ğŸ™
Zac Lewis	Respect ğŸ’¯
Darrian Playz	Ayyyyy you beat the system
Lunaris Hyperion	Did they remove the original video
xx topz xx	This man is a straight legend ğŸ™
Xan Jackson	Thx bro
Monkey ninja77	You â€™ re a god thank you
The Nerd Squad	Finally NO clickbait Thanks
Citron	You sir are a top cunt
Coltin H	Downloaded to Dropbox ty
kbaden	Downloaded mp3 cuz i know this is gon na be taken down lol thanks for not clickbaiting
Creep Snags 2K	I have video add on instagram to se prettyboi jon
Kelly Upchurch	Thankyou so much bruhğŸ˜©ğŸ˜©ğŸ˜‚
Mr. Sandman	THANK YOU
You â€¢ Wish	EVERYONE IF YOU CAN DOWNLOAD THIS VIDEO OR SCREEN RECORD IT JUST IN CASE IT GETS TAKEN DOWN IF YOU SCREEN RECORD IT OR DOWNLOAD IT YOU CAN LISTEN TO IT EVEN WHEN ITS TAKEN DOWN PLEASE TAKE YOUR TIME AND MY ADVICE TO YOUR ADVANTAGE TO BE ABLE TO LISTEN TO THE SONG WHENEVER YOU WANT
ayeeitsveronika	This better not be taken downğŸ’¯ğŸ”¥
Daniel Fewkes	Yay for no clickbate
ICED Galaxy	Love u dude
ThatRicanKid	Please I really hope they don â€™ t take this down I â€™ ve been trying to find this song all over social medium thanks for posting thisğŸ’¯ğŸ”¥
Andrew Luciano	Thanks
shutcayfish782	finally we have some one that is not fake
SauceGodZay	ğŸƒğŸ¾â€â™‚ï¸ğŸ’¨ğŸ’¨ğŸ’¨ me a soon a I screen record this knowing it â€™ s gon na get taken down ZOOM
Typhfuun	Legend
Erik Koza	Why did juice take down the song
Raheem Brooks	OMG I LOVE YOU FOR EVER NOW YOU JUST GOT A NEW SUB
ComplexBlackness	THANK YOU
Asxp Wizz	Plz put dis on SoundCloud
HaZe shock	Post it on sound cloud
Alex Levett	AYEEEEEEEEE YOU THE REAL OG
Carson Friedrich	Your a god for re uploading Juice world ha to upload this song or something like it
dakocass481 FEM	You is the GOAT
Dem B	Is this on spotify
JDotHoncho	THANK YOU
Jay Brown	Thank u this song ğŸ”¥
hillbilly jim	god bless you sir
Sacrxfices	Finally bro thank you
lil jt	these topic channel are like some type of computer channel
SPD Trippy	Fuck yes hope the label doesnt take it down
Jesse Contreras	Thasss ma boiii
Evan Legate	YOUR THE BEST BROOOOOO
Lil kog	Thanks
ohKrypticcc	Its gon na suck when it get taken down good thing i found a web site that had it for free ğŸ˜¬
Jaquan Gamez	Salute you u bro At least ur not them cLiCkBaIt BaStArDs
Trippled Oreos	Thx
Asth	Thank You
Nicholas Mirisola	Bro prop to you for putting this out there
_sea.cow	HMU IN MY DM â€™ S ON INSTAGRAM sea cow I HAVE ARMED DANGEROUS FULL SONG
Sean Gaskins	finally not a clickbaiter you deserve a billion sub
Yung plague	When you let her down WRLD
Andrew Littlefield	Bruh this shit FYE
blood reaper	Hi h gf hdhehjejdhdjhdjkrkdjdjje bro love the song so good
Rev Clan	Look at my bank account Look at the cash amount I get the cash im out I do the dash im out
theman3652	YALL ISS ON APPLE MUSIC TOO UNDER THE ARTIST GUIDO DOS SANTOS
D.J. TYROONE69	SCREEN RECORD NIGGAS
zzVOLUMEZ	Much love bro thanks for the song
feterika vlogerz	Deez Nutz
WRAGEMUSIC	http soundcloud com smg record wrage know me now
glitcherPROXx	Banger for sure ğŸ’¯ğŸ’¯
David	This thing go so hard they have to keep taking it down ğŸ˜‚
Melissa Moore Washinghton	Thank god for this not being clickbait
Nebula	thank you
Geo Spark	finally you are a life saver
Omar Pineda	Thank you ğŸ–¤
Lee Bun	You dig
gratata :/	He still armed and dangerous ğŸ’¥ğŸ’¥ğŸ’¨ğŸ’¨ğŸ’¨ğŸ–¤999
TOPEVERYTYNG	you the shit bro
impassionate	how do y â€™ all not notice it not real it say ya did like 8 time more than it did and the actual song
Boone Campbell	legend im screen recording it rn
Bandit Gorilla	FINALLY
Alex Canas	U a true nigga homie
CZI PROD NEXT	Ey I save the original MP3 file when Cole Bennett publish the song If someone is looking for it send me a message on Messenger Victor Nihoul
Liam Mack	Thx for the actual song
Aryaan The skater	No clickbait thank you
llKINGTRE GOAT	999 shit
jj conant	ty
dollar tree baddies	I screen recorded it so I could listen and share it thanks so much
FloZionz	Get your downloads in bois before it get taken down ğŸ˜…
teeb	â¤ï¸
reaxic	Thank you
Shawn Lane	Thanks for posting this u cool my nig
LilNinja YT	Pulg
Tay	pray this shit down get taken down again
Johnny warren kid perfect	Thank u so much
Ivan Rivera	ğŸ”¥ğŸ”¥ğŸ”¥
Isaiah 10977	Is this the full song
RaiiD Hydro	http vimeo com 295981799
swagifox	YA DIG
DrippyMason	http zondiva com watch YNUUugiAur59zf3 FULL SONG IT CANT GET TAKEN DOWN
Mahz King	Fuck yeah bro ğŸğŸğŸ”¥ğŸ”¥ğŸ”¥
Zack Johnson	Thanks for not clickbaiting ğŸ‘ I have massive respect for you ğŸ’¯ ğŸ˜‰
Laxus DSFT	Tbh hope they don â€™ t take this don â€™ t cuz this is one of the best juice wrlds song by far
tooth paste	God bless ur soul
Micah Charles	Screen record it
Gainer Clips	31
Brandon Guzman	DELETED
YungFl3x3r	ğŸ’¯â—ï¸ğŸ’ªğŸ¾
Orion	LOVE YOU
galaxy gamer	Save it to your playlist
Bmoney	We â€™ re can I find this song at
Apex Midgett	When is the real one coming out
Wasted Flame	IF YIU HAVE APPLE SCREEN RECORD QUICK BEFORE IT GETS TAKEN DOWN
Novannon	Doing God s work out here
Reescakes	Pray it doesn t get taken down
James Lucker	No one mention this shit on god if it get taken down again been tryna find this song for day the shit stuck in my head
Baedan Kandola	CLUTCH
angelica garnica	this shit hard I just hate having to look for a good one
Bknuts	yes
Sav Eclipse	Anyone know what happened and why these keep getting taken down and why the song got deleted
God Of Pain	Ballin hard you outta bound
Dominic Butler	Hi
