Yerin my Sun Youtube my sunshine	Every second are perfectğŸ˜ğŸ˜ğŸ˜
MultifanDan	This boi knows how to use his hair
kpop love	thatâ€™s my son right there
Sharper Mind	Love your work, style and your evolution. KEEP GOING ON, HANG ON, we support you and trust in you !
Mind Prapaporn	ğŸ’—ğŸ’—ğŸ’—ğŸ’—ğŸ’—ğŸ’—ğŸ’—ğŸ’—ğŸ’—ğŸ’—ğŸ¶
Mayela Gilbuela	great dancer amazing singer Mesmerizing Visual Uwu king Aegyo machine One and Only Kim Jungwoo(Junguwu)
Thuá»³ Trang	This hairstyle and color really fit him â¤ï¸ ë„ˆë¬´ ë©‹ìˆìŠµë‹ˆë‹¤ ì •ìš°ë‹˜ ğŸ‘
Everyone Is So Weird Today	Am I wrong or he lipsync the "dinero, peso, yen, yo quiero, I want it"??   aLSO I LOVE YOU SO MUCH, HONEY ğŸ˜­âœŠğŸ’—
Anna Caesaria	Oh our precious Jungwoo..
Michelle Latina	Ã‰l realmente baila muy bien, OMG, esto es mucho para mis ojos, se ve muy sexy, a veces siento que me encanta verlo bailar.... :)
Maggie Perry	BOI STEALING ALL MY UWUS
Wyz Zsanhel S. Bayo-ang	My boyğŸ˜‚ğŸ˜ğŸ˜
gabi ocampos	His fluffy hair though brings me back from death
Blinkie Popie	Jungwoo isnt UWU anymore:(
ì—”ì‹œí‹° í•­ìƒìœˆìœˆí•´	ê·¸ëƒ¥ í• ë§ì´ ì—†ë‹¤.ê¹€ì •ìš°ì‚¬ë‘í•´ ì§„ì§œ.
blink in your area BUT MULTIFANDOM	Jungwoo in 127? How can?
Irene Wormald	ğŸ’•ğŸ’•ğŸ’•
HotNamjoon 99	I think he's perfect âœ” and he dance skill is power too (broken English) ğŸ˜‚
taehyungs hand on jungkooks waist	YES JUNGWOO HONEY YESSSSSSSSSSSS
Humaira Rahman	This my first time seeing him dancing cause I always see him being all cute and when I saw this vid I was like .... HOLD UP!! So ur telling they where the same person ?!
enryuuu kaizaen	He's so lanky omg
Neinne NK	2:33 jungwoo breaking out of character
Saruhiko Ayame	Jungwoo tienes mucho talento bebe estarÃ© apoyÃ¡ndote siempre
quá»³nh nhÆ° bÃ¹i	JungWoo is good!
Valeria Batista Rojas	My baby ğŸ˜¢ğŸ‘ğŸ’š you're so talented, capable and beautiful!! I'm crying, I'm so proud of you! You're doing amazing in this cb, your debut with 127, and here we can see how hard you work you deserve the whole world, ily! ğŸ’šğŸ’š
Wiktoria Åš.	OMG *MY MAN IS HERE TO KILL ME* I REPEAT *K I L L  M E* â¤â¤â¤ğŸ˜
DENNISE ANDREA CRISPIN GREGORIO	Alguien sabe como se llama la aplicaciÃ³n par enfoque de un integrante como ejemplo jungwoo y no en todo el video?
K0 K0	THOSE STARES OH DEAR HOLY COW
Marsha Q	Damn...you killed this performance!! I am loving how you dance...very confident & sexy!!!!! You already have an amazing voice...you are killing it fam!!
parkchanyurl	the fact that someone could even call him a weak dancer has me wanting to pop them upside their head,, try again because eRRoR
Sassy Wonho	Okay Jungwoo I SEE YOU ğŸ˜ğŸ˜
jaehyuns milk	no one is allowed to call jungwoos dancing bad or weak after this
Kittiwara Kitiwan	I was like OMG why he got that beautiful
Juwoos	ğŸ’›ğŸ’›ğŸ’›
R Rodrigues	enterrada
Sofia lol	A classy hoe
Widya _	ğŸ˜ğŸ˜ğŸ˜ğŸ˜µ
SAFIRA FIRA	uwuuuu
kpopmultifan	Anyone also notice how bouncy his hair is?!
i ship lisa to all blackpink members	Cam somebody make 2:30 - 2:33 a  gif? I need it for research.
Reva Hasna Nur Faza	1:24 JUNGUWUUUU
azza A	You did well ğŸ§¡â˜¹ï¸
balqismark	junguwu? this is junguwoah!
Srishti Maitra	yes baby work it!!!!!!
Jimin Lord of the Jams	As a dancer myself I see that Jungwoo works hard to come to where he's at right now with his dance. His movement is inherently tight but he executes motions with precision. I don't see a huge amount of "swag" as everything is so tense. I do admire the train ethic of SM entertainment tho. His style is interesting too. I don't think he is where he is at because of talent though. Gotta admire him still
Dana Hugel	THIS WAS SO GOOD BRUH THE BEST IHMYFOS JUNGWOWOSO
karla seasonie orbit	JUNGWOO KING!!
Kim RÃ©ka	My UWU heart is die
Mindy Minho	Our uwu boy is so different when he's performing ğŸ˜­ğŸ˜­ğŸ˜­
Diana Zharkynbek kyzy	Jungwoo is super handsome and super talented
í•¨í•„ê·œ	ì •ìš°ì•¼ ì—´ì‹¬íˆ í•´ì„œ ë„ˆë¬´ ë³´ê¸°ì¢‹ë‹¤ã… ã… ã…  ë‹¤ë“¤ ì—”ì‹œí‹° íŒŒì„¸ìš”
A K A R I A	We love a cutie
Haha Hope	Cute orange ğŸŠ
NCT TRASH	junguwu sliding his fingers through his hair is my life
moon child	I can't stop uwu-ing over him even though he's serious but damn his movess are great !!
Hera Kharisma Suandi	Jungwoo jungwoo jungwoo
Princess. E	Junguwu has left the chat
love nct	HE IS A BABY AHHHHH
ë©œKara	I donâ€™t know how some â€œNCTzensâ€ say that he canâ€™t dance. MFG Â¿donâ€™t you see? Â¿Are you blind?  Cause Jungwoo has a lot of talent. He is so fluid. I think every dancer has his own style, and I think Jungwoo style is AMAZING. (ignoring the fact that he is very adorable)  Iâ€™m proud of my baby boy. He was so nervious in his debut and nowğŸ’•
Santi Rosmaria	jungwoo ğŸ˜˜ğŸ˜
My Mochi	*UWU*
_í˜¸ë¼ë¼ë¼	ì •ìš° ì´ë²ˆì— ë„ˆë¬´ì˜ìƒê¸°ê±´ì•„ë‹ˆëƒ..ì–´ë”” ê³ ì¹œì¤„ì•Œì•˜ìë‚˜...ê°œì˜ìƒê²¨ì¡‹ì–´
xingsweakness	BAD SQUISHY BAD SQUISHY
Hao Hao	Jungwoo is honestly an amazing dancer but he is SO underrated. I think itâ€™s the same situation as Renjun, both of them have really good dance skills but they donâ€™t have the recognition they deserve cause they are known for their vocal habilities, that are incredible too.  JUNGWOO YOU ARE DOING GREAT SWEETIE
Reina de Guzman	heâ€™s improved so much iâ€™m sobbing
JB Earl Tan	0:57
Imani Rachal	Why does jungwoo look and give off the same vibes as taemin from shinee
Exol Nctzen Reveluv SMSTAN	HOI DI AKO NAGSASAWANG PANOORIN SI JUNGWOO JUSQ MAHAL NA MAHAL Q TO
akeyt elo	ILY JUNGUWU
Divetri Riyadi	2:34 Taemin joins NCT now
denisse chuco	He is really a good dancer <3
Daniela DTM	UwU â™¥â™¥â™¥â™¥so cute â™¥â™¥â™¥
jungwoo skAret	Junguwu
Alison Anthony	2:35 Jungwoo's inner Taemin just came out
Rechil Abenir	He really looks like taemin ğŸ˜ğŸ˜
mariana.	he has _the stuff_
Asem Azat	â¤â¤â¤â¤â¤
II ZALIM II	ğŸ˜»ğŸ˜»ğŸ˜»ğŸ˜»
shaavehlovely Clarke	I'm trying to find ten
ì •ìš°ì˜ ì „ìš©í†µì¥	ì§„ì§œ ì •ìš°ë¥¼ ì•Œì•„ì„œ ì„¸ìƒ ë‹¤í–‰ì´ë‹¤.  ì •ìš°ì•¼ ì´ì œ ê³„ì¢Œë²ˆí˜¸ ë¶€ë¥´ê¸°ë§Œ í•˜ë©´ ë¼.
oxehans oxehans	SO happy he was added to the 127 lineup, he is such a talented boy!!!
Gem	Jungwoo more like JungWOW
EXO L	So NCT 127 have Triple J too
Rose Yoo	Put him beside Jaehyun he will still looked posh ğŸ’‹
yoonmins	SM YOU KNOW WHAT I WANTED THANK YOU.
devinah malu	DAAAAYYYYANNG hes an amazing dancer yooo!!! Not only he a vocal king but a dancing king too! ğŸ”¥ğŸ”¥ğŸ˜
Bad boy Reveluv	so hott
K-Pop INDIA	*Jungwoo is life goals HE CAN LITERALLY DO ANYTHING from being super cute to being super sexy* Edit: At 2:34 he looks like a freaking god
Temple Bennett-Robinson	when ur this close to ulting jungwoo
belu tamara montoya cadillo	I love it
Primadonna Girl	Love you my sweet sunshine
Berliana Budi Putri	Sasssyyy
Jay Taduyo	I can honestly see why he's been added to the group. He's so freaking TALENTED! ğŸ”¥
Jud1	doesnt jungwoo look like ariana grande ? 3:36
love myself love yourself	How many times did they dance? Try comparing HAECHAN in his focus n in Jungwoo focus. It's different
virtual character	Is jungwu rose's blackpink male ver??? I love the way his hair moveeeeee~
sis wyd? im watching nct videos go away	*"Rudewoo is so underrated"* *Intensifies*
Abeera khan	JUNGWOO is cute my god they are all so talented wallah! ğŸ”¥ğŸ”¥ğŸ”¥ #nct4life
BABABA BABABANA	à¹„à¸¡à¹ˆà¹ƒà¸Šà¹ˆà¸¢à¸±à¸¢à¸™à¹‰à¸­à¸™à¸­à¸µà¸à¸•à¹ˆà¸­à¹„à¸›ã… ã…¡ã… 
-intricake	1:55 SIR ARE THOSE _GANG SIGNS_
Ju Dy	let's be real he's so hot, like the way he dances !!!
insta musiclover69	Are they gon make 15 more of these?
fauzia azka	Sponsord by coca cola
r e	2.34 sexy ğŸ˜³ğŸ˜
Jungtea Bts	I love u jungwoo
Mishaaa Ongsshii	Hair color â¤
crusty toes	jungwoo oppar pls eat my ass
yulinda senisa	Great baby you've worked hard and you deserve anything in the future. I love youğŸ’™
du light	Junguwu
Ø§Ù…Ø¬Ø§Ø¯	SWEET POTATO ğŸ  â™¥ï¸â™¥ï¸
Ba by	ë¯¸ì³ë”°
ë°œë‹¦ê°œ	ì •ìš°ì•¼ 2:00 ë‚´ê°€ ê°íˆ 2:24 ì´ ì˜ìƒì„ 2:33 ë¬´ë£Œë£Œ ë´ë„ 2:55 ë˜ëŠ” ê±¸ê¹Œ
hellevators	"IT WAS SO EASY"
Oli Via	my little heart
Shellynda 123678	Thanks SM for making my life complete with this video!
Harriet Joy Grava	Uri bb Jungwoo!!!!!!!!!!! You're beyond perfect!!!!! ğŸ˜ğŸ˜ğŸ˜ğŸ˜ğŸ˜ğŸ˜ğŸ˜ğŸ˜ğŸ˜ğŸ˜ğŸ˜ğŸ˜ğŸ˜ğŸ˜ğŸ˜ğŸ˜ğŸ˜ğŸ˜ğŸ˜ğŸ˜ğŸ˜ğŸ˜ğŸ˜ğŸ˜ğŸ˜ğŸ˜ğŸ˜ğŸ˜ğŸ˜ğŸ˜
Brindis Ahgase	HELL YEAH JUNGWOO BBY UR KILLING IT
BTS iKON SVT	That ending tho!
Tamir Onon	jungwoo is nctâ€™s taemin
Kryzel Liza Vaay	mom, I'll marry this man,, (even in my dreams) sizzling dance skills,,, even good at singing and visuals? waw...
Tae bae	*JUNGWOOOOOOOOOO*
Sela Alison	Hopping up my bias list faster than a plane takes off.
ë°•ì„±ì§€ì´ì´ì´	T-thatâ€™s my baby b-boy ğŸ’–ğŸ’ğŸ’•ğŸ’ğŸ’“âœ¨ğŸ’•ğŸ’–ğŸ’ğŸ’âœ¨ğŸ’«ğŸ’ğŸ’
Shania Rosslyn	Is it weird that i'm in love with his body/how his body moves?  He's such an amazing dancer and no one talks about it??? I really hope jungwoo gets more recognition cause he's really talented!
gae nctstan	2:26 over here we get a glance of Taeyongs booty
Chloe Benton	JUNGUWUUUU
Sweetcel Centino	Jungwoo love youuuâ¤ï¸ğŸ˜»ğŸ’•ğŸ’•ğŸ’•
ddd	2:33 hotttttt
cuddlymoontaeil	why tf is he so hot
Heyitslori	Ever since i discovered jungwoo's upper and lower body are literally divided 50/50 I get so distracted bij his dancing I can't unsee it
Prdsdef.taeil	â€œJungwoo is the best of all 3 worlds.. he can sing, dance, and is handsomeâ€ - Doyoung aka me also
wheaty yeety	brUh mY bAby s n A p p ed
harrylieber	jungwoo is a walking uwu
ë¶€ì—‰ì´ì„±ì—´	ë¹„ìœ¨ ëŒ€ë°•
The Overlord Bear's Den	2:33 When uwu transforms into OWO
BLACKINK BTS	à¸™à¹ˆà¸²à¸£à¸±à¸
iqmal zamri	2:33 that is so taemin! He will shine someday....
Sema Nur	damn boi okay i see u ğŸ¤¡
markâ€™s seagull eyebrows	*cries in tangerine*
Lea Nicolasora	He looks so soft but he is a damn good dancer and singer!! <3
seul0gi soft	jungwoo's face reminds me of this japanese actor. they really do alike
SPREAD LOVE N LOVE NCT	Wait so the solo shots are not from the same dance practice??? Now it makes sense.....
Maia Devina	JUNGWOO YOURE SUPPOSED TO BE ALL CUTE CUTIE NOT SEXY
aliya s	DANCER JUNGWOO
MONEYMXKER	2:34 FUCK IT HONEY! GIVE IT TO â€˜EM
Rizky Puteri	My babe
Cindy Adjei	Jungwoo snapped and there's no going back
Kris Taylor	@ Jungwoo, why are you loud hot? I'm not used to this, pls relax thank you ğŸ™ˆ
Vaisravana Prajnadhira Ahimsa	hoodies and trainers are 99999999 times hotter on him tf
Isabel Poot	i dropped all my Ã²wÃ³s
Zena Cheong	JUNGUWU!!!!!!!!!
Ryanne Montero	junguwu who? I only know JUNGWOO skarut *-*
jaehyun's milk	Boy, what shamppo are you using?
Hail Storm	Jungwoo is the love of my life ğŸ§¡
Chaitrali Patne	Not only Jungwoo dances but his hair too dances
oof paci	as a jungwoo i can say that i approve.
ìµœí•˜ì›	2:33 2:33 2:33ğŸ™ŠğŸ™ŠğŸ‘ğŸ‘
Damien Maia	OMG! Sucha a dancer! And there's no need to make me hold my breath with that glare... But thank you
Jasef Valenzuela	2:33 POSE DIVAAAAğŸ”¥ğŸ”¥ğŸ”¥ğŸ”¥
intaellectual	he got them smooth moves
Rujeeiice -/\-	jungwoo ;---;
xuximytuxi UwU	1:11 did the cameraman lose himğŸ˜‚
Richa Srivastava	Istg I need Junwoo's shampoo.. his hair. So FLUFFY. â¤ï¸
Ciara Forever	Goodness.. So hard to choose a bias of nct everyone's so amazing, handsome and talented
dream tofu	2:33-2:36 YESSS  jungwoo i love you so much you are amazing
Too multifandom to pick a name :/	not to be tHAT PERSON but ;;;; poor boy he has no butt ğŸ˜”
Christina 2222	SO GOOOD!
sad ikhim	Sheet I think I'm crying from all the support my baby has gained in this comment section ğŸ˜¢ğŸ˜
Martha Mite Mite	ğŸ˜˜ğŸ˜˜
Mila Morrison	Ainâ€™t no one tell me that this guy isnâ€™t underrated!! Shit I was shooketh when he started
alex sawkins	King.
Ezra Novia	0:57 wow i thought i saw sehun
Twice and Once	EÅŸofman Jungwoo'ya bÃ¼yÃ¼k gelmiÅŸ. KÄ±Ã§Ä±ndan dÃ¼ÅŸÃ¼yor. SM Ã§ocuklarÄ±mÄ±za iyi bakğŸ˜â¤
Elif Guanlin	Oh my god...
i am the cypher to your taehyung	JUNGWOO UR SUCH AN AMAZING DANCER
Marta R.	I'm so proud of him x3 he's doing great but that was to be expected with how talented he is :')
lil_ aries_	Jungwoo is amazing and idk why he isn't aPPRECIATED FOR HIS AMAZING DANCING SKILLS LIKE 24/7 But that's ok that's not what I wanted to say...HE LOOK LIKE TAEMIN WHEN HE DID THAT THING AT 2:34 BUT THEN HE LOOK LIKE HIMSELF AND THEN IT'S SO HOT IDK WHAT TO DO-
Nctâ€™s chased dream	OMG JUNGUWU BEING BADASS I FEEL BETRAYED (but he slaysğŸ˜”ğŸ¤ğŸ»)
Aleyna Ahgase	Jungwoo you are so fucking great, ly
Honey Moon	OMG, JUNGWOOğŸŒšâ¤
Stacey Kim	God, his figure is so manly WHY DIDNâ€™T I NOTICE IT BEFORE
Neha Bellaqua	I am dead after watching this!!!! Jungwoooooooooo ğŸ’•ğŸ’•ğŸ’•ğŸ’•
baek has chan	yEEESSS
Nmiju K	à¸™à¹‰à¸­à¸™à¹€à¸ªà¸¢à¸œà¸¡à¹„à¸›à¸à¸µà¹ˆà¸£à¸­à¸šà¹à¸¥à¹‰à¸§à¸ªà¸´à¸šà¸„à¸°à¹à¸™à¸™ğŸ¤£
wonhoish	HES SO CUTE I CANT DEAL
Sunflower â€¢	i love him so much ğŸ’œğŸ’œ
Wulandari Dita setiawan	Jungwoo look like Taemin ğŸ˜
feel it	AAAAAAAAAAAAAAA AAAAA AAADPUXKHSKDIGDLHDGSSGSGJX AAAAAA HIW COULD YOU-
I am: Solange	he dances so gracefully yet so hard it amazing to see, i'm whipped.
Fira Zafira	Seksoy :(
Iris B.B.	Thanks for your hard work, cutie â¤ï¸â¤ï¸â¤ï¸
Pitchaya Arampra	ğŸŠğŸ’“
Rania B	2:32 you're welcome
Eggs on Na Jaemin	1:25 is he really our uwu kingğŸ˜¶
vocal god moon taeil	Let's get those 100k views for our baby boy ğŸ’–ğŸ’–
Angelina S	I LUV U JUNGUWU â¤
lovely rodriguez	2:34 damn.
bopbop	0:02 I'TS JUST A BEGINNING and those little dumbs are already trying to kill us with their cuteness I CAN'T
Jay_ Stans.talent	Heâ€™s just the cutest thing. His hair is soo fluffy. Youâ€™re doing great sweetie.ğŸ’•ğŸ‘
grass call me	Johnny slaying in junguwus cam I ain't complaining
LuCaS BiASeD yeOrEobUn!!	He isn't uwu anymore he is Ã¹wÃº
nelson 333 -	he looks at the cam at the end T_T ğŸ’
Ethereal Taehyung	i don't know how people can dislike this video. He is a freaking angel, I'm so glad he joined nct 127
Devushka Darcy	JUNGUWU IS UNDERRATED. HIS MOVES ARE OUT OF THIS WORLD. PAY ATTENTION!!!!!!
hazel laze	2:34 *BOI CHILL*
Ayato Kirishima	Why do I see Taemin?
Xiuminâ€™s Back	okay...i was crying by 0:03... uwu boy stop.. ;;;
angel suho	#TheComebackinExochaneeI
Lala E	hello?????
skareut here	i just... have nothin to say... hes too perfect XKBXAJGXUWGSUAVDUWGSUVXKSB
mybraincurrentlyloggedoff	Jungwoo in the beginning..... Lol the most irregular member indeed ğŸ˜‚ğŸ˜‚ğŸ˜‚
ë‹¤ë‹ˆì—˜ë¼	SM is feeding us well
Ally Davies	whenever jungwoo looks at the camera my soul transcends from this plane of existence
hey nanallies	Fluffy hair jung uwuğŸ˜~~~~~
Sora Tsel	Those dancing skills got me crying
ë¼ë¼ë‹ˆ	2:33 BEAUTIFULLLL
exo-l_stay_nctzen_ikonics Vicmudo	where's the uwu jungwoo???who's this sexy guy ğŸ˜....doing great jungwoo
rie medillo	JUNGWOOOO!!!! YOU'RE DOING GREAT!!!! KEEP UP THE GOOD WORK OMYGHAAAD
Erica Lagsa	i wonder how many times they filmed for these focus videos because at the first part, jungwoo made a call sign for yuta but on yuta's first part he was by himself
This gull is on fiyah	me: okay iâ€™ll only look at my biasâ€™ focus to keep my bias list intact me: fails
heyhaechan	junguwu? idk her
vince rodriguez	2:33 jungwoo so gayyğŸ¤£
Tan Neo	*junguwu is gone, truly.*
Yefiza Nahri Agustia	What taeil doings that?hahaha so cuteeğŸ˜‚â¤
Jung yoon Oh	JUNGWOO WE LOVE YOU
JungUwU-ish	When i first saw junguwu performing boss on stage, i thot his position was main dancer and main vocalist, cuz mahn he sounds and dance so f**cking beautifulll!!ğŸ˜ğŸ˜â¤â¤
LosAngellisseu	hair flipping.......good vocal........orange hair........great dancer........Jimin????
EXO VELVET	OKAY WHAT THE ACTUAL HELL MR KIM JUNGWOAH
fitri wahyuni	OMG. Love you so much KIM JUNGWOO ğŸ˜˜ğŸ˜˜ğŸ˜˜ğŸ˜˜ğŸ˜˜ğŸ˜˜
JUNGWOO ismyangel	Snooopppyyyyy is the dance King Exceptitt
C Z N C R T	Hi GuysğŸ˜Š (if you have time after this) watch the other members' focus vids as well. We stan NCT as a group as well as our ults/biases ğŸ™‡â€â™€ï¸ğŸŒ± (our boys get sad when they noticed the gaps of the views ğŸ˜­) if you have time please check out other focus vidsğŸ’š
Aigerim Satybaldinova	That stare at the cam in the end......i'm dead
R K	Dance too well
ì•„ë¯¸ë…¸ë·”	2:33 thank me later
kellmy	Jungwoo ğŸ’—ğŸ’—ğŸ’—ğŸ’—ğŸ’—ğŸ’—ğŸ’—ğŸ’—ğŸ’—ğŸ’—ğŸ’—ğŸ’—ğŸ’—ğŸ’—ğŸ’—ğŸ’—ğŸ’—ğŸ’—ğŸ’—
lay 0.0	ğŸ˜ğŸ˜ğŸ˜ğŸ˜ğŸ˜ğŸ˜ğŸ˜ğŸ˜ğŸ˜ğŸ˜ğŸ˜ğŸ˜ğŸ˜ğŸ˜ğŸ˜ğŸ˜ğŸ˜ğŸ˜ğŸ˜ğŸ˜ğŸ˜ğŸ˜ğŸ˜ğŸ˜ğŸ˜ğŸ˜ğŸ˜ğŸ˜ğŸ˜ğŸ˜ğŸ˜ğŸ˜ğŸ˜ğŸ˜ğŸ˜ğŸ˜ğŸ˜ğŸ˜ğŸ˜ğŸ˜ğŸ˜ğŸ˜ğŸ˜ğŸ˜ğŸ˜ğŸ˜
NCT127/U/DREAM ??	2:33-2:37 I thought it was Taemin for a second thereğŸ˜‚ğŸ˜‚
Jimin's Chimmy	what shampoo he use??
Eva MLH	2:33 TAEMIN?!?! ğŸ˜±ğŸ˜±ğŸ˜±
Riyah-ë¦¬ì•¼	THIS MANS DANCING SKILLS ARE FUCKING NEXT LEVEL AND TOO MUCH SO CHILL OUT U PUMPKIN
vale tete	Is it just me but Iâ€™ve seen all their focuses and they all do something different Iâ€™m wondering how many time they had to dance
choco lattes	1:25 wHAT ARE YOU DOIN' SWEETIE?
Skarut Junguwu	Woah that dancing skillz! Take note mah friends, he is a freaking VOCAL!
Sulis Tya	Kim Jungwoo ğŸ’“ğŸ’“ğŸ’“
Bts infires me to not be an unhealthy fattie	Heâ€™s such a good ass dancer like those fucking jointsğŸ‘ğŸ»and i LOVE the deep stares he shoots at the camera heâ€™s just so mesmerizing I love jungwoo
jimin's bratz doll lips is mhsgddjskkkla	ur not junguwu anymore u r jungwoah
A Besa	My favorite orange haired person
Jungwoo NCT	Oh my god my bias jungwooğŸ˜ğŸ˜ Great dancer Great vocalist VisualğŸ˜
Joy Suarez	Baby Iloveyouuuuu
Lucas lee	Junguwu â¤
Abril Rivas	I will watch this everyday
Lupita EXO-L prros!	1:10 se le perdiÃ³ :v
lamonbebe x	Jungwoo's dancing skill is no joke uhm why is this underrated?? He's awesome! SKEORUT!
Jung shook	Wowwwwww beautiful uwuwuwuwuw
santi agustina	im so happy u join this unit chukkae ğŸ’š
tayaballama	*babbbbbyyyyyyyyyy*
Lupita Avila	La persona mÃ¡s linda y bella del mundo mundial â¤ğŸ’—ğŸ’“ğŸ˜˜
Dal2Dal chu	My shy boy.. ğŸ’•ğŸ˜
Hai Hai	3 seconds in the video and he is already being precious by making that phone sign and putting it up to Yuta's ear. I need to be stopped......
Elle	I'm watching the individual fancams to try and learn members and all I can saw is WOAH. Isn't he one of the newer members? Performing like this?? Respect.
gay rose	why is he so long
Amnesiac 17	the uwu king is missing, I REPEAT THE UWU KING IS MISSING WE HAVE SEXY KING JUNGWOO INSTEAD
Oh My Park !	Jungwoo no se puede ver mÃ¡s perfecto con ese color de cabello!
nicole ;sm	3:37 he lookin (into my soul) fine damn
JadenLawson	2:33 he was so freakin extrağŸ˜‚ğŸ˜‚ğŸ˜‚ but honestly is such a great dancer
Eyebrowstj - Multifandom4Life	For him to be as beautiful as he is,  he got ugly with it at the 2:52 to 3:07 mark!   Love that part so much!
nabilas mahbubah	JUNGWOO I LOVE YOUğŸŒ±ğŸ’š . OH, AND YOUR DANCE IS AWESOME. LOVE IT!ğŸ’š
Doon Doon	leGS
Ps World Push	My rookie boy in nct127 ğŸ˜
CdoubleG to you	MY PRECIOUS UWUâ¤
Anandhita siregar	Gans bngt dahğŸ’“ğŸ’“ğŸ’“ğŸ’—
L	god
sant marceu	i love you uwuuuuuğŸ’šğŸ’šğŸ’š
Ros	Mark smile haha Jungwoo so evident  1:57
KpopCpopUtaites multifandom	Remember when we had no information on Jungwoo so we thought he was just a visual. Then we heard his voice Then we saw his dance We stan a multitalented king
Chim scv00	My dumb ass thought jungwoo can't pull off a manly concept bc he is an uwu but he is so HOTğŸ”¥ and I got a different feel by watching him dance.. I can't describe it but differently ; kinda manly in many wayss
æ‰¿	LEGEND OUTDANCED EVERY SINGLE DANCER OUT THERE IN THE WORLD
Paola Wu	I'm living for Jungwoo these days
Ruby RedLuvies	1:58 Mark is me when I see Junguwu ~
shookii be shooketh	WHOEVER SAYS JUNGWOO IS A WEAK DANCER LEMME PUNCH AND SLICE YOUR THROAT
sadie!!	THE CAMERA ALMOST LOST JUNGWOO
ë¸”ë§í¬hoho	2:33 T t t t t taemin?!?!?!?
Betty Johnson	Alright soooo jungwoo is my official bias now ğŸ¤§ğŸ’–
Oh man holyshit	JungUWU
Cecy Aquino	Y'all can hear me sobbing in the corner because Jungwoo is the dancing king! ğŸ˜­ğŸ’•
Angie B	To anyone who said Jungwoo didn't belong in Nct 127 should consider watching our mans work hard in this comeback
yulianaaar	UwuuuğŸ˜ğŸ˜ğŸ˜
barbie the doll	My fave member
HopeQuenSave LQ	JunguWu who? i only know JungSexy!
Andi Subscribe	1:19 to 1:26 - I am blessed
i wanna-blefight all da h8ers	*uwus have left the building*
tyjanae Williams	Lol the camera man lost jungwoo for a sec. ğŸ˜‚ğŸ˜‚ğŸ˜‚
Happy Project	New and better than gold jungwoo. Having you is a blessing! Doing well!
DreamingAlexe	Junguwu is nowhere to be found here damn
kelly santos	eu te amooooooo â¤ğŸ˜©
Mango II	2:33 uwu dance move by taemin xdd lol
One&Only	2:59 get it boii
ARMYStayMonbebeUniverse CaratArohaNCTzenIKONic	WHY MUST HE BE SO RUDE!?
Wiana	1:24 UWUWUWUWUW
Sun Yeinie	JUNGUWU IS SO PERFECT ğŸ’•ğŸ’•ğŸ’•ğŸ’•ğŸ’•
BOra JD	Cute ğŸ™‰
sweetmxn	2:34 taemin wyd
rebelle	jungwoo, just take my heart honey
Felix's Freckles	Jungwoo went from being uwu to owo   Not complaining tho ;)
even if yuta isnt ur bias u know he is	those stares *oH dAddY*   edit: 2:33 ehem who do u think u are i have asthma here what did i do to deserve this   ok but in all seriousness   APPRECIATETHISHONEYBUNHEISSUPERTALENTEDILOVETHISMANSOMUCHANDUSHOULDTOO
Ala	Talented Jungwoo, We love you <3
keoni _	Even though Jungwoo is a soft boi, his dance style is so punctual and sharp! There's not a single part where he's slacking off, I can tell that he strives for perfection in every detail of the choreo which is amazing. ğŸ˜ğŸ˜ And for a long time I thought no one could rock orange hair like Doyoung but Jungwoo has changed my judgement ğŸ˜ğŸ˜
Ellie Smallman	eVERY TIME HE BRUSHES HIS HAIR BACK MY HEART BURSTS
pasta slut	that stare at the end tho
Camelia Requena	HE IS ART OMG I LOVE HIM
Judith Umana	JUNGWOO SNAPPED HONESTLY HE IS SUCH AN AMAZING DANCER AND IM GLAD HE WAS ADDED TO NCT 127
Etsuyo Takahana	MY KING, MY BIAS, MY LOVE
park gigi	Jw ğŸ¤©
Shorty Give Me Whip-Whiplash	Nice body jungHOLY!
Jinyoung Kim	He is so underratedğŸ˜­ğŸ˜­
CHOGIWA what's the situation?	2:35 TAEMIN??!!
5HINee Forever	ğŸ‘â¤
Min Loves	HIS STARES ARE KILLING ME
Monbebean	JUNG-UWU
Mika Miyuki	uuuuuuuuuwwwwwwwwwuuuuuuuuuuuu senti el poder
Sunshine Hobbie	OMG ğŸ˜±ğŸ˜
Victoria Angeline YÃ©pez ProaÃ±o	Zeus you are so awesome, so proud of you honne.ğŸ’šğŸ’šğŸ˜ğŸ˜
Hyunjins Jimin Jams	Jungwoo and Yuta in the beginning ğŸ˜” so cute Iâ€™m soft
kiana king	I ABSOLUTELY LOVE JUNGWOO MY HEARTTTTTTT
DO Exo	ğŸ˜ğŸ˜ğŸ˜ğŸ‘ğŸ¼â™¥ï¸
Lucas Costa	Baby
Demi Thai	I never expected that jungwoo would be the tenth member of nct 127 but he's doing so well, jungwoo if you read this remember that I always love youâ¤ï¸
guilty of sleeping in	his stare and his strong moves bitch iM SHOOK
/:	2:30 WOW WOW WOW
Black Pink	OMGOOOOOOOD ,Ğ¯ Ğ‘Ğ›Ğ¯Ğ¢Ğ¬ Ğ›Ğ®Ğ‘Ğ›Ğ® Ğ¢Ğ•Ğ‘Ğ¯ ĞŸĞ˜Ğ—Ğ”Ğ•Ğ¦,ĞŸĞ Ğ•Ğ¡Ğ¢Ğ Ğ•Ğ›Ğ˜Ğ¢Ğ• ĞœĞ•ĞĞ¯,Ğ§Ğ¢ĞĞ‘ Ğ­Ğ¢ĞĞ¢ ĞĞĞ“Ğ•Ğ› Ğ—ĞĞ‘Ğ ĞĞ› ĞœĞ•ĞĞ¯ Ğ¡ Ğ¡ĞĞ‘ĞĞ™,Ğ‘Ğ›Ğ›Ğ›Ğ¯Ğ¯Ğ¯Ğ¯Ğ¢Ğ¬â¤ï¸â¤ï¸â¤ï¸â¤ï¸â¤ï¸â¤ï¸â¤ï¸â¤ï¸â¤ï¸â¤ï¸â¤ï¸â¤ï¸
Katherine Rivas	The Camera got lost bc of Taeyong's ass
Carlisiah Davis	Jungwoo has an sharp and smooth dance and very prowerful dance I be really angry when people why he is the weakest dancer but we also don't want him to be alawys in the back and plez give him some lines we all love jungwoo and the rest of nct
Ella Senior	he sNAPPED
arsvirgo	his dancing is so good omg
natashaboozer	#ProudOfNCT ğŸ’šğŸ’šğŸ’šğŸ’š
Antonella Rattini	HE'S SO UNDERRATED MY PRECIOUS BOY HE DANCES SO DAMN WELL AND IT'S SO SATISFYING TO WATCH HIS FANCAMS SKSKSBDJS
addict with a harpoÃ¸n	He has such a nice body line
jungsnoop	we all came for 0:57
Jin's Sans	1. Did you notice his Coca-Cola jacket? ğŸ˜‚  2. How come he just transformed from CUTE to CUTE 30% and HOT 70%?? ğŸ˜¯ğŸ˜¯ 3. I can't stop loving Jungwooooooooo â¤â¤â¤â¤
Way Is my religion	ğŸ’š
Maykenna Goering	so powerful!
Ari cs	Uyyy esa miradita al final 7u7
jackpot jimin	*a skinny legend*
InÃªs Guerreiro	UWU mode: off
bkn hae	â¤â¤â¤â¤ love him
jaeminudes	I'M CRYING,I LOVE U JUNGWOO ğŸ’šğŸ’šğŸ’šğŸ’šğŸ’šğŸ’š
Alex	My life is meaningful now.
Britt B	idk how he is the same age as me... jungwoo UR DOING AMAZING
Mapxa axpam	People who disliked don't know what uwuu is
ì†ì—°ë‹¨ë²™í„´ì€	This is exactly why I can never have a bias in NCT or NCT127 or NCT dream or NCT2018. IM ALWAYS GETTING BIAS WRECKED I need help ğŸ˜©
Isabel Maria Cruz Heras	He now Ã™wÃš
ĞĞ¸ĞºĞ¾Ğ»Ğ°Ğ¹ ĞĞ¸ĞºĞ¸Ñ‚Ğ¸Ğ½	Ğ“Ñ€Ğ°Ñ†Ğ¸Ñ, ÑĞµĞºÑ Ğ¸ Ğ½ĞµĞ²Ğ¸Ğ½Ğ½Ğ¾Ğµ Ğ¾Ñ‡Ğ°Ñ€Ğ¾Ğ²Ğ°Ğ½Ğ¸Ğµ. Ğ¢Ğ¾Ğ»ÑŒĞºĞ¾ Ğ§Ğ¾Ğ½Ñƒ Ğ¼Ğ¾Ğ¶ĞµÑ‚ Ğ²ÑÑ‘ ÑÑ‚Ğ¾ Ğ·Ğ°Ğ¼Ğ¸ĞºÑĞ¾Ğ²Ğ°Ñ‚ÑŒ..
\\ lÃ©a //	jungwoo just made me his b*tch and i said thanks.
Rainbow Melody	WHO MADE MY BABY SNAP LIKE THIS???   seriously tho, idk why I havenâ€™t realized how good of a dancer he is until this comeback
ALMOONS	OK, EXPLAIN ME HOW THE UWU's GUY CAN BE HIM!!!??? YAAAAAAA JUNGWOOOOOOOO, ESTÃS PRECIOSO MI AMOR BELLO, DÃNDOLA COMO SIEMPRE, TE AMOOOOOOOOO | 02:32 - 02:40 : the best PARTTTTTT |
F. Trk	Ø¬Ù…Ø§Ø§Ø§Ø§Ø§Ù„ÙˆÙˆ ğŸ˜»ğŸ’•âœ¨
Chimester LichtToo	Of course heâ€™s good at dancing. Heâ€™s the son of taemin
zuzi	HE THE MAIN DANCAAAA
Consu_ Stark	MY BABYYYYY I LOVE HIM SO MUCHğŸ’šâ¤ğŸ’šâ¤
Stefania vc	OMG HE'S SO CUTE. I'M CRYING ;; â¤ï¸
Jaehyun Dimple's	0:32 coco cola?
IsabelaKwami 45	YOU'RE AMAZING LOVE
Maja O	Why are you being all hot and dancing all hot youâ€™re supposed to be cute and stuff
Veni Angelova	real life: JungUWU dance practice: JungWOW
Mortis Thorne	This kid is dangerous honestly
Massi110497	1:55 UwU jajaja la cara de Mark al ver la expresiÃ³n de Jungwoo me matÃ³ ğŸ˜, me gusta mucho como baila Jungwoo tiene algo especial ğŸ˜„
we go up	Wishlist: uwu's SHAMPOOOOO
Ã‰lÃ©onore_ Junia	His duality between on-stage and off-stage is almost more real than Taeyong's. He takes the dance so seriously. Respect ğŸ’š
Lee_Seulì†¡ì´ìŠ¬	Jungwoo with all the sass and skill! He's such a great dancer!!
s s i c h e n g	junguwu? i only know jungwOaH.
Biased for Vocalists	My other half Zeus.
Park Chanyeol	Anak baruğŸ˜
Ğ¶ĞµĞ½Ğ° Ğ¿Ğ°Ğº Ñ‡Ğ°Ğ½Ñ‘Ğ»Ñ	i love you junwoo
Dan Humans	EtÃ©reo he inalcanzableğŸ–¤
Ğ˜Ñ€Ğ¸Ğ½Ğ° Ğ¨ĞºĞ¸Ğ¿	Wow almost uwuless in this video, but he's good dancer
Aeris'Heart	Casi me dio un ataque al final
T Jasmin	Fav dancer and member whaddup baby u doing so well love â™¡
Kyla Durie	ok but you didnâ€™t have to look into the camera like that at the end.   Taeil had me ğŸ’€ at 1:18
ni Chae	ì •ìš°ì•¼ ã… ã… ã…  ì¶¤ ì§„ì§œ ì§„ì§œ ì§„ì§œ ì§„ì§œ ì§„ì§œ ì§„ì§œ ì§„ì§œ ì§„ì§œ ì§„ì§œ ì§„ì§œ ì˜ ì¶° ã… ã… ã… ã… ã… ã…  ì§±ì´ì•¼
TY Track's Shizennie	I'm really happy you joined 127. Thank you for completing 127 and for making the team stronger.  Fighting haeyadwae! ğŸ˜˜
Iridescent Shimmer	The way he dances is enchantingğŸ’˜ He executes the moves cleanly and accurately with controlled power. He puts energy into movements where it needs to be, how rightful of the nickname (almighty) *Zeus* ğŸ˜Œ
Marcus Lee	Wooah.. his visuals with his orange-coloured hair.. sexy moves and some Taemin vibes... PERFECT ğŸ‘Œ
VeronicaWildOnes	2:34 Can i frame this? he's so slim and ethereal, he looks like aphrodite's son. Yet he's so powerful and such a great dancer! I love how his fluffy hair enlights every head turn... he's so beautiful
Christina Do	2:32 omyghaddddd Jungwoo
yixings	THIS IS THE UWU NATION
Zay moon	HE JUST KILL ME IN 2:33! I'M DEAD KIM JUNGWOO! I'M LITERALLY DEAD!
HOSEOK YUTA	Heâ€™s so pretty
seventeen teen teen	Jungwoo did soooo good this comeback he left me bald
Jenna Miller	TAEMIN WOULD BE PROUD OF HIS SON <3
Koool DIY	*the eye contacts are killing me!!!* ğŸ˜
Kendra Knowles	I love how he dances sharp and smooth at the same time and has a masculine and feminine feel ğŸ‘ğŸ˜ğŸ’œğŸ˜˜ P.S. since his trip to America, he's become more sexy to me but still pretty/beautiful/cute... the duality
L F	This is called being fabulous
Natalie	WHAT THE FUCK HE LOOKS SO GOOD
NeÃ¸ gÃ¸t My back	I can now die peacefully
Marcia Zulfikar	OMG PRAISE HIS FACIAL EXPRESSION! he improved a lot ma im a proud mom...
Ianna Tyus	did he have to stare into the camera like that???  *WAS THAT A REQUIREMENT???*  *WHO ASKED TO BE ATTACKED LIKE THIS???*
a mais jungwoo utted	Woo eu te amo tanto :c ğŸ’ğŸ’â£ï¸ğŸ’â£ï¸ğŸ’ğŸ’â£ï¸ğŸ’ğŸ’•ğŸ’—ğŸ’•ğŸ’—ğŸ’ğŸ’“ğŸ’ muito mesmo, de todas as formas e sentidos. ParabÃ©ns por se esforÃ§ar, se alimente e descanse ok?! Eu te amo
MylKyun 11	Meu bias e meu filho ğŸ’• FIGHTING JUNGWOO \O/ ğŸ’•ğŸ’•ğŸ’•
Biyuesi GÃ¼renÃ§	Omg pretty JungUWU
Gigi Unni	YES . GO OFF BABYYYYY
TK -	FUCK THIS MAN IS SO AMAZINGLY TALENTED LIKE WOW KING OF DANCING, WHY ARE PEOPLE SLEEPING ON HIS DANCING IM SO KUNFUSED UGH
ega permana	uwu sekaleh
Rebeca Melgar	No uwu left, they ran out
JapanRain	I think I'm gay now
ì‹œìš°ë¯¼ì—‘ì†Œ	1:25 JUNGWOAH
tuokie	I feel attacked at 2:34
Exoplasmic Reticulum	2:34 I swear I saw Taemin
Desnina WP	HE LOOKS LIKE TAEMIN AVSHSJSJSKSKSKSKMS MY UWU JUMPED OUT FOR JUNGWOOWUğŸ’ªğŸ’ªğŸ˜¤ğŸ˜¤ğŸ˜–ğŸ’ğŸ’ğŸ’—ğŸ’•ğŸ’“â¤ï¸â£ï¸
Ella Zingmark	2:34-2:38 he's really is DAT bitch
xuan haha	Jungwoo seriously lacks nothing
Nan Nan	Jungwoo you did  wellâ¤
Kat De Alejandro	MORÃ.............JUNGUWUUUUUUUğŸ’šğŸ’šğŸ’šğŸ’š
Jisung Pwark	2:33 - 2:38 where did Junguwu go?!
dearDREAM	HOW CAN HE BE SO SOFT YET FIERCE AT THE SAME TIME AAAAAAA
Veronika Ernapujiati	MY UWUUUUUUUU
nastyaneyy	fuck.
Anel Chittaphon 18	babyâ™¥
Xing Xing	ğŸ’šğŸ’š
Sky and Tea	B EA U TI F UL ğŸ’šğŸ’™ Sass king.
kpop goddess	2:33-2:37 So hot!!
maddy bru	FINALLLLYYYYY
anyong LTF	áµáµ‚áµ á´ºá´¬áµ€á´µá´¼á´º
indah paramitha	i knew it knew it!!!! when i first saw him he has own charismağŸ˜ maybe the other think he's cute n like a baby but i know that he has charisma like 'he's hot man'ğŸ”¥,omg i'm right lol
Gabrielle Uffren	Thank u for this
dharpie	The hardworking uwu ğŸ’–
K-pop Peach ._.	daaaaaaaaaaaaaaaaaaaaaaaauuuuuuuuuummmmmmmmnnnnnnnn
TheSarah0510	man that ending stare. he has such a powerful walk.
Yoselyn Branchi	Since the first tiem saw him dance, I said "Jungwoo is a GREAT dancer" but so underrated...   For me is one of the best dancers of NCT, he needs more recognition... He is a very talented boy let's give him a Lot of Love to our UwU King..... Jungwoo Fighting!!
Jess	Jungwoo is such an amazing dancer, i can't take my eyes off him
seasonnie	Yavrum iyi kapat belini alÄ±rsÄ±n soÄŸuÄŸu kaparsÄ±n ÅŸifayÄ± valla
Ella Mary	0:28 *This is how you die everyone*
Sofea Clearwater	#DOJUNG #YOUNGWOO COUPLES !
verÃ³nica loves nct	IT WAS EASY
Gisel Kim	Is excelent dancer
Werido Potatoe	2:34 to 2:37       Jungwoo ğŸ˜­ğŸ˜­ğŸ˜­ğŸ˜­ğŸ˜­ğŸ˜­  you guys are just so great i really cant take this  *IM ACTUALLY DYING OVER HERE*
Vale Kang	Mi bebÃ© preciosoğŸ˜ğŸ’ğŸ˜
challaxlol	0:00 - 0:05 â€œchief called and he said this is itâ€
dani !	yes, we stan a long-legged legend! my baby is so talented oh my god who taught him how to move like that
hanamaruposa	wow he really broke that forth wall at the end there huh
Thipen Sotty	That's my babyyy!!!
Nyx	They are all amazing. Don't underestimate any one of them.
eveppeveppevepp	handsome, tall, long legs, great dance, great vocal, and Uwu. hello God can he more perfect than this?!
Gel25	A very sassy jungwoo at 2:35 (junguwu has left the chat)
NUR JAMILATUL	He looks so sexy
PanWink IS REAL	Su pasividad me mata ğŸ˜‚ğŸ˜ğŸ’–
palpatpal	How perfect he is.. youâ€™re so amazing JUNGWOO ã… ã…  nothing you canâ€™t do.. vocal dance visual cuteness charisma HEâ€™S ABSOLUTELY SO PERFECT âœ¨ GORGEOUS
ë§ì¿ ì „	he may be soft outside but all I can see here is a hardworking jungwoo. I stan this man ğŸ’šğŸ’š
Leire Trujillo	ğŸ˜ğŸ˜ğŸ˜
K1T	JUNGUWU IS SUCH A GOOD DANCER ğŸ˜­ğŸ˜­ğŸ§¡ğŸ§¡
Jhelzsie Santiago	LISTEN JUNGWOO LISTEN STOP
mermy gillis	Woah.
ratna ernawati sumira	He is really talented omg i love him so much:(
Exo Logy	2:34-2:36 I see Lee Taemin
fusi.dy127	2:33 ğŸ¤¡
jk sain	great dancerğŸŒ¸
K Geron	JUNGUWU NO MORE
Dani Correa	WHOMST CONSIDERS HIM THE WEAKEST DANCER??!?! THAT'S SO CRAZY! JUNGWOO IS ONE OF NCT'S BEST DANCERS AND THAT'S IT
Remy Angeline	2:31 you're sexy and you know it ğŸ˜
ê¹€ì •ìš°	ì‚¬ë‘í•œë‹¤ê³  ì§„ì§œ,,,
Ericka Cart	2:33 at this point i just ran out of wigs AFSJSFSKSH eXCUSE ME SIR!?!?!
í•‘ í•‘	ì¤‘ê°„ì— ìê¾¸ ë†“ì¹˜ì‹œë„¤ã…ã…;;
Hayoung Kim	Jungwoo ahhhhhhhhhhhhhhh
Flawless Jhope	I swear SM is trying to kill me
Park Hoyeniel	He has an aura. Good job jungwoo!!!!
livingforheechul'stearsforhisnonexistentchest	*WHAT THE HELL WHO TOLD HIM TO STARE AT THE CAMERA IN THE END LIKE THAT!!! I DIDN'T EXPECT THAT AND NOW IM MELTING!!*
BETXSO BTSEXO	Is it just me but I feel like Jungwoo has grown, he is so tall
ee_jae dkh	SM you're really killing all NCTzensğŸ˜
Dontletjungwoogotoamerica Cuzheissohotwhenhedance	Did you see that?!! *Itâ€™s LEGEND*
Belle McGee	At 2:37 he doesn't even look human.
ê¹€ì˜ë‹ˆ	ìµœê³ ìµœê³  ã…œã…œã…œã…œã…œã… ã… ã… ã… ã… ã…  ğŸ’›ğŸ’›ğŸ’›ğŸ’›ğŸ’›ğŸ’›ğŸ’›ğŸ’›ğŸ’›ğŸ’›
MY FREAKY DEAKY TAEYONG	JUNGUWU ISN'T JUNGUWU ANYMORE
Vanessa Teixeira	Meu biass Sai da frenteee
Shella Deviana	ZEUS!!!!!!
Angelia Pradnyani	Please full dance practice(not in focused).......
Violet F	he is actually soooo handsome and when he's dancing, he looks sooo manly. urghhh my hearttteeuuu
Mila karmila	ğŸ–¤ğŸ–¤ğŸ–¤
jungwoo's raincoat	i don't want to take anything away from the other members because i love them all, but i hope we can have another comeback like touch/boss so that jungwoo can get to shine a bit more and not be pushed aside/ to the back behind other members. i know people might say its he's "tall" but that's no excuse, he's a really fluid dancer with good expression. actually i don't like this choreo at all, a lot of members don't get a central part it's annoying but ah sigh-- let's support nct!
onna no secret uta	2:35 - 2:38.. what are you doing Taeminnie ğŸ˜‚  anyways, Jungwoo def a looker! even brother call him pretty
iO M	swag!!
Ä˜XÃ˜_Å TÃ˜GÃ‹THÃŠR FÃ˜RÄ˜VÃŠR	#TheComehackinExochannel
seulgi xxx	error 404: uwu not found
Bangtan's Star	I love him so much my heart hurts
Ananda Putri Absari	2:33 WORK IT ZEUS!!!!
Fanny Surbakti	His propotion screams hetero
strongPower thankYou	HIS GLARE  AT THE END KILLED ME
á„’ á„‰ á„’greethreee	ìš°ë¦¬ í•­ìƒ ë„¤ ê³ì— ìˆì„ê²Œìš”!
soft 4 kpop	WE STAN A DANCE KIIIING
spillthetae ._.	mom I love him
zehra moh.	ğŸ’“ğŸ’—ğŸ’˜ğŸ’ğŸ’•ğŸ’–
isse	Iâ€™M SO PROUD OF U JUNGWOO FOREVER STANNING
Anna Ramos	Jungwoo dances gracefully, his moves are on point. He has the soft/shy type of personality but he's different when his performing.
Jungwoo Snoopy	Art
I stan Legends , BTS	I love him and Doyoung so much ğŸ˜­â¤ï¸
ice ice baby	jungwoo, you're doing amazing ily uwu
cjaerose	the POWER he holds istg
Jeal Vidal	2:34 YAS FEEL IT KWEEN!
obviously mayen	THE WAY HE JUST STARED AT THE CAMERA AT THE END MABSKAJAJSJSJSJDHDJ
Joan Do	HE THE KING OF HAIR FLIPS. YALLLLLL JUNGUWU
Tae Kookie	He dances so perfectlyğŸ‘ŒğŸ‘Œ...& his hair flip..O god..he is handsomeğŸ˜ğŸ˜ğŸ˜
Kaulika Aqilah	Error: uwu not found
Jennifer Kumala	Please dont stare at my soul T^T
mizpah samantha	He is the silent type or shy type but the way he dance he slay,  nail it or tell it he can kill you with his move he is like a feather so soft smooth but deadly....
Sonx__BTS ARMY	2:34 ğŸ”¥ğŸ‘…
a pÃ«rsÃ¸n `	It was so easy for him to slide into my bias list
Ellie Sargent	JungwoooOoOoOoooo
ChanyeolsUpperLip	1:25 heâ€™s so cute omg Edit: peep Taeil also being extra cute 1:55 MOM I LOVE HIM
ahhh WAE	Stanning jungwoo is baby boy culture
Fardia	My baby Jungwoo really needs to be appreciated by everyone even more! I'm so happy and grateful that he joined NCT 127... He has worked hard and has been amazing all along... I always thought Jungwoo was only this cutie and uwu machine (which he still is) but he is truly the full package (amazing vocals, dance skills and visual)... I've noticed repeatedly in dance practices and live performances that Jungwoo has this unique duality to him... His stage persona is different from his real self... On stage, he has this really captivating charisma and strong stage presence ( despite being known as the member with most uwu) and he can be rude whenever he wants! Love you Jungwoo! You did amazing! Don't listen to the haters!
Jiwon's wink	Um hRll No Sweetie ur not uwu jungwooooooo
Kezia Jocelyne	JungwoahğŸ˜ğŸ˜
xxjinn	So much duality ,,,my jungwoooi
Antonia-Ruxandra Folea	JUNGUWU WHO?
Yurri	Yas our QUEER did that
sunny vheong	His HAIR ALDNEOFHSLD
fat kun	HE WENT OFF
yeol chenn	Good jow bby
ìœ™ìš°ìŠ¤	ì •ìš°ëŠ” ì¶¤ì˜ ë””í…Œì¼ì„ ì •ë§ ì˜ ì‚´ë ¤ì„œ ì¶˜ë‹¤ ã… ã…  ë¹„ìœ¨ì´ ì¢‹ì•„ì„œ ì¶¤ ì¶œë•Œ ë” ë‹ë³´ì—¬ ğŸ’š ğŸ’š ğŸ’š
DaSe	0:31 yeaaah Coca Colaaa
Julia WÃ³jcik	He's the best! Just look at him... his skills, his voice and appearance... I bet he has a great personality too. I just love him so much, he's my bias nr 1, please appreciate my man Jungwoo <3
Jayla Smith	I love him so muchğŸ˜­ğŸ˜­ğŸ˜­ I think I can officially say that Jungwoo is my bias! He is so precious!!!
Fransiska Aprilia	â¤â¤â¤â¤ğŸ˜­ğŸ˜­ğŸ˜­ğŸ˜ğŸ˜ğŸ˜ğŸ”¥ğŸ”¥ğŸ”¥ğŸ”¥
felifayn	he went from cute to hot to cute to hot to cute to hot wow
Rachel Anakotta	iâ€™m so happy because uri jungwoo become more confident ğŸ¤§ğŸ’•
Koru Chapemos	ğŸ˜±ğŸ˜±ğŸ˜ğŸ˜ğŸ˜ğŸ˜ğŸ˜
clviÃ©n	SHOW EM YOUR ANOTHER SIDE, KIM JUNGWOO
nad A	Sm plz give uri jungwoo hair shampoo commercials ğŸ˜‚ğŸ˜‚ğŸ‘Œ
Sergio Hansen	When Jungwoo is dancing I suddenly forget that he's The cutest smol bean in the world. He's so cool...
Li Subliminals	IM NOT OKAY.
Zhazira Kuanyshbekova	Ğ§ĞµÑ€Ñ‚ Ğ¾Ğ½ Ñ‚Ğ°Ğº Ñ…Ğ¾Ñ€Ğ¾Ñˆ ğŸ’”
Sangre Rodriguez	ğŸ‘ğŸ‘ğŸ‘ğŸ‘ğŸ‘ğŸ‘ğŸ‘ğŸ‘ğŸ‘ğŸ‘ğŸ‘ğŸ‘ğŸ‘ğŸ‘ğŸ‘ğŸ‘
Aname here	JUNGWWWWWWTFF YOU  SLAYED IT!!!!
Na?UwU It'sOkayManIDon'tCareManOhYouAreNa	ì •ìš°ëŠ” ë§ëëŠ”ë°ë„ ì¶¤ë™ì‘ì´ ì •í™•í•˜ê³  í˜ì´ ë„˜ì¹¨. ë°•ë ¥ì´ğŸ˜¢
Il Baek di Hyun	He has such long legsğŸ˜±
Sthie Cas	Baby
Disconn3ction	Jeuz killing it
dianelf	1:18 Taeil sexy ğŸ˜‰
milkychenle \	*sweetie does big moves*
Sehun's Butt Is My Life	What I love with Jungwoo's dance is it's really clean and detailed. â¤
Kmusic Fan	IT WAS SO EASY
CJ	His shirt is always up lmao
soshi stars	*1:54** Jungwoo did the peace sign to the camera and Mark started laughing ğŸ˜‚*
æ±æ–¹ã‚¿ã‚¯ã‚¯ãƒ³	ã†ã‚‹ã•ã„é»™ã‚Œ
Enjah Smith	WOW BECAUSE I REALLY YEETED MY PHONE ACROSS THE ROOM !!!!
Mingyuâ€™s Listhp	IN THE BEGINNING CHIEF SAID IT WASNT IT TO YUTA IM WEAKKKKğŸ’€ğŸ’€ğŸ’€
k h	how can jungwoo be overlooked when he made his debut not even a year ago? and tbh, along with lucas, his popularity sky rocketed when he made his debut. i don't really see what's underrated about him ://  I LOVE YOU JUNGWOO ğŸ’Ÿ
priscilla renthlei	The BODY
eat me	as expected from our uwu...
ìµœì •ì•„	ê¹€ì •ìš°.. ì§„ì§œ ì‚¬ë‘í•´..
Iman Eldin	honestly, where can i buy jungwoo's shampoo product ?
Marina LÃ³pez	Omg you're doing so good!! ğŸ‘â¤
Gravity Mix	his duality!! please appreciate his talents
Zack	JUNGWOO I LUV U
Amethyst14	That fluffyyy hairrr ğŸ˜ğŸ˜ğŸ˜ğŸ’“ i wanna touch themm ğŸ˜ğŸ˜
i me	ã‚¸ãƒ§ãƒ³ã‚¦æ’®ã£ã¨ã‚‹ã‚«ãƒ¡ãƒ©ã•ã‚“ä¸‹æ‰‹ã˜ã‚ƒãªã„ï¼Ÿã‚¸ãƒ§ãƒ³ã‚¦ã¨ãƒ•ã‚¡ãƒ³ãŒå¯å“€æƒ³ã‚„ğŸ˜
Anis Afeeqa	Did mark get ignored again 1:57 poor you sweetie ğŸ™ƒ
ruby malfoy	yES JUNGWOO SHOW THEM YOUR TALENT
Allie _	Srsly tbh his dancing skills are soooo underrated
nct is my m00d	2:34 *junguwu left the chats*  Oh and your welcome :)
Î¹Ï‰Î¬Î½Î½Î±	babyy
ohnimevol	Damn jungwoo @ 2:33!! Jungwoo is so so talented! He definitely has it all. Visual, Vocals and Dance. Easily of my fav dancers in nct
felicia sudario	THIS UWU ALWAYS SURPRISE ME YAAAS GET IT JUNGUWU âœ¨  ALSO WHAT SHAMPOO DOES HE USE
thahirah alee	i love u but taeyong i seriously distracting me sometimes...... u DOING GREAT THO SWEETIE(S)
Angelica Do	legend
Julianne Legaspi	1:25 OK THAT WAS HOT
kiyowos baaney	guys are you all like me?   10 members = 10 times watching this practice dance ğŸ˜‚  imma glad they're all have 10members only, i can't watch 8members more lol ğŸ˜‚
hoodedcroissant	omg how does jungwoo look SO GOOD I WAS NOT READY
Aissyah Novita	Perfect! My bear jungwoo â¤ï¸ğŸ’š i love youuuu
Elenoise Alice	JUNGUWU (ã…‡ã……ã…‡â€)
Ariana Milan	2:35 oh hello Taemin
EXO and EXO-L only	Prince Jungwoo â™¥
Mariska Putri Adelia	Yaasss my uwu
Karma Armia	ALL THE EYE CONTACT WITH THE CAMERA
jaemin naa	_that boyyy slay babe_
Bunga Rakhmatia	I thought he is kind of soft, but damn.. He is a beast
ten's piercings	*uwu has left the chat*
ë™åŠ©á„’á„‰á„’	JungwoooooOOOOOOOğŸ˜†ğŸ™ŒğŸ»ğŸ’šğŸ’šğŸ’šğŸ’šğŸ’šğŸ’šğŸ’šğŸ’šğŸ’šğŸ’šğŸ’šğŸ’šğŸ’šğŸ’šğŸ’š
urnÃ¸phÃ¼n	Okay but can we please talk about how INCREDIBLE uwuâ€™s dancing is? Iâ€™ve noticed it since the BOSS dp, his legs are so flipping long and they contribute to how sharp his moves are.   Also heâ€™s still cute no matter what he does. I love being a Jungwoo stan
UyÃªn Trá»‹nh	Awww Our baby is so perfect ğŸ˜†ğŸ˜­ğŸ’ Zeus ah, I always support to you..And dont forget to take care of health, I love you so much ğŸ’•ğŸ˜Š~
Liza Kingg	uwu is not as uwu anymore
monday blues	ugh he is so powerful ğŸ”¥ he can have all my owos
Other than Once.	Remember doyoung said jungwoo is good at everything. yass his dancng are soo great
pantonelay	1:11 LMAO THE CAMERA LOST HIM
fluffy jisung	WHERE DID MY JUNGUWU GOğŸ˜­
Ji_raSol	0:03 KKKKKKKKKKKKKKKKKK uwu
izyldm123	honestlyâ€‹ i thinks ive now fully served to jungwoo like damnnn boyyyy
Alzani Ulfa	Korean versi?
nidhi	FCK IT UP JUNGWOOETH FCK IT UP
Palpasha Karki	dO YOU SEE THAT DIVA STARE HOLY SHEIT
Winnie NCT	brb going to play 2:33 on a loop
takuya's mole and xiumin's ah hoo	my very first bias in nct he is such a good dancer and looks so good omg i cannot
7ì´ë‚˜ì¼ì¬í•´ì¸ì²œì§€ë§ 	2:41 Jungwoo nun kamerasÄ± olmasina ragmen Neden gÃ¶zÃ¼m hep *HAECHAN* da Ã‡Ã¼nkÃ¼ biasÄ±m ğŸ˜‚ğŸ˜‚ğŸ’šğŸ’š
Tacko	Black king
Kim Kim	Visual, vocal, nháº£y Ä‘á»u hoÃ n háº£o. Jungwoo Ã , em Ä‘ang lÃ m ráº¥t ráº¥t tá»‘t, hÃ£y luÃ´n tá»± tin, luyá»‡n táº­p chÄƒm chá»‰ vÃ  giá»¯ gÃ¬n sá»©c khoáº» nhÃ©. â¤ï¸ Fighting!!!!!!ğŸ‘ğŸ‘
lazy day	dance king ğŸ‘‘
jade	2:34 TAEMIN IS THAT YOU
KpopPrincess 4419	i died
Clara NCTzen	I'm soooo proud of youuuu uwuğŸ˜ğŸ’œ
Ellie Drew	2:32 He really snapped there didn't he
khoirun nisa	My husband jungwooo:-):-):-):-):-):-):-):-):-):-)
ìˆ¨ì´ì˜ì•ˆì£½ë‚˜ë´	ì™€ ì •ìš°ì•¼ ì§„ì§œ ë¯¸ì³¤ë‹¤ ê·¸ëƒ¥ ì™€ ì¶¤ ë„ˆë¬´ ì˜ì¶”ê³  ì˜ìƒê¸°ê³  ì •ë§ ì§±ë¨¹ì–´ ì •ìš°ì•¼!!!!!!!!!
2000. n	ğŸ’šğŸ’šğŸ’š
Rarana Almeida	JUNGWOO BABY <3
Meë„ì˜	3:37 I love youuu ğŸ’šğŸ’šğŸ’šğŸ’šğŸ’š
pjhfam	KIM JUNGWOO IT'S YOUR FAULT THAT I'M DEAD SOON!
SOPHIA IS2ESB.	ëŒ€ë°• ë©‹ìˆì–´í•˜ê³  ë³´ê³ ìˆëŠ”ë° ê°‘ìê¸° ë“±ì— ì½”ì¹´ì½œë¼ã…‹ã…‹ã…‹ã…‹ã…‹ã…‹ã…‹ã…‹ã…‹ã…‹ã…‹ ì—­ì‹œ ìš°ë¦¬ë“¤ì˜ ë˜ë¼ì´ì œìš°ìŠ¤ã…‹ã…‹ã…‹ã…‹ã…‹
Golden Rose	wow
Gaia Montero	He put too much power whenever this part comes 2:50. He really loose it! Go Jungwoo!
Lea Esquilla	ğŸ’šğŸ’šğŸ’šğŸ’šğŸ’šğŸ’šğŸ’šğŸ’š
Annfi	A main dancer, he hits every beat with elegance and power, he also creates pretty lines with his body. One of my favorites!
Minimalist Lifeu	Junguwu such a talented flower boyğŸ˜˜ğŸ˜˜ğŸ˜˜
Hisper Golden	From KING UWU to KING OF SHAKING HAIR DANCER
renjun 23	Omg...
darchelle	OKAY sweetiesğŸ’›
Pannita Kwangnok	ì •ìš°ì˜¤ë¹  ã… ã… ã… ã…  ì˜¤ë¹ ì˜ì¶¤ ì§„ì§œ ë„ˆë¬´ã… ã… ã… ã…  ì§„ì§œ ì§±ì—ìš” ã… ã… ã… ã… ã… ã… 
Mery Exo	@Junguwu's hair ..stop making me feel so soft like that im dying ğŸ˜­ğŸ˜
Marnay Oxford	I NEED to see Jungwoo do a cover of Taemins â€˜moveâ€™ for medicinal purposes
ë¦°ì • í˜•	*FRESH LIKES COCA COLA*
Bangsik 999555	uwu
Cao Khanh Linh	Very proud of Jungwoo â¤ combo vocal visual dance and rap is perfect!
Fake Samurai	_yesss Jungwoo_ fuck'em upğŸ’¥ğŸ‘‘
princess art	OH MY JUNGWOO ğŸ˜ğŸ˜ğŸ˜ you make me feel ğŸ˜ğŸ˜ğŸ˜ğŸ˜
rina	Jungwoo looks like a different person when he's performing, he's just too sexy and charismatic that I can't see the cutie Jungwoo ğŸ˜ğŸ˜ğŸ˜
kyungsslv	ğŸ˜šğŸ’—
Amira Tasnim	BITCH 2:32
Hyunjins dimple	Jungwoo is really a great dancer ğŸ’¯
Supichaya Daprasong	Mommy so pround of you,Junguwu
í–‰ì¸	HE IS SOO TALL IN BABYFACE OMG
yaesthetic	even ur tiny actions makes me weaK :))))))))))
yoongomango	this video just made my whole week, heck it made my whole fucking year.
Liyana Rabah	NO BISH NO 1:08
#SHINee #SHAWOLS	He is not JungUWU anymore, he is JungWOW
Ron Devereaux	FROM JUNGUWU TO JUNGWHOA! ğŸ˜±ğŸ‘ğŸ‘
KoKo BaeK	Heâ€™s not softie when he dances uwu
Aura	galak
Paloma Laforteza	It's only been a few months since boss and he's already gotten even stronger and cleaner as a dancer ğŸ˜ğŸ”¥
kuek ping	Jung Woo you are the bestâ¤ï¸
Jaehyuwu xx	2:33 dat was fab
NCT FIGHTING!	My baby uwu is really unpredictable. His soft and uwu look donâ€™t apply when heâ€™s on stage. Keep up the good work, Jungwoo and the other members! NCT FIGHTING!
Summer wsh	Tummy flashes give me life, and the fact that his hair always looks ridiculous just adds to it
ë¬¸ê¸°ìœ¤ê¸°	I'm sorry but this is not the uwu Jungwoo
Ø¶Ø­Ù‰ Ù‡Ù„Ø§Ù„ Douha Hilal	Hello JUNGWOOâ¤ï¸ Wow Yes God Nice Beautiful Amazing Excellent Very I loved this Already more than wonderfulğŸ˜‡ğŸ˜ğŸ¤©ğŸ‘ğŸ‘ŒğŸ‘ğŸ’¯ You are heroes without discussion, your voices and your dance are actually more than wonderful in every sense of the wordğŸ’•ğŸğŸ˜‡ ğŸ’šWE ARABS LOVE YOU NCT 127ğŸ’š
Charis Labostro	regular really changed Junguwu
Misa Amane	So powerful, great jungwoo
``	MAIN DANCER AND LEAD VOCALIST JUNGWOO LETS GOOOOO
Red VelBaek	Drop the hair care routine SM!
plasticbac	fuck it up king!!!!!! how is he so powerful and sexy and elegant at the same time u may ask? its bc hes a legend! taemin is shaking
cheorruy xx	We love us a Coca Cola Boy!!! Slay Jungwoo!!!!!â¤ï¸ğŸ’•ğŸ’—
Long Live JaeYong	00:02   Jungwoo's phone to Yuta : Hello, Jungwoo's UWU can't pickup the phone right now. Yuta: Why? Jungwoo's phone : Cause she's dead Yuta: Aaah~ *I knew that*
Kat 123	3:23 TAEMIN VIBES
Fall for Red Velvet's Banana	Coca cola hoodie, okay
shannen ericka	*He nailed it cause IT WAS SO EASY*
drippin my love to hyuck	he's not junguwu anymore he's jungwoo tHat jungwoo
sarah imchy	I'm so proud of Jungwoo, he improved his dancing skills a lot since Boss and his moves are very powerful and beautiful ! He made significant progess, don't sleep on him please !
STAN Ten , Lay , Hoony , Donghyuk forever!	alright baby your are already my bias so please stop being bias breaker
nct is the biggest hit on the stage	Junguwu.exe not found
flat a	ì‚¬ë‘ì•„ ì •ìš°í•´
emi du	1:25 ooft that hit me hard
Victoria Alzurut	PUTOS FUCK YOU 38 DISLIKESğŸ˜¡ğŸ˜¡ğŸ˜¡ğŸ¤¬ğŸ¤¬ğŸ¤¬
ì§ë˜¥ì›íˆ¬ë”°ë¦¬Drink	Handsome
That One Girl	I never knew i needed this... *THANK YOU SM FOR BLESSING MY SOUL WITH THIS VIDEO*
nia âœ¿	oh, so he's FINE fine ğŸ˜©
Arnelle Diane	THANK YOU. THIS IS EXACTLY WHAT I NEEDED.
cik Kinnik	1:24 Taeil being mess in the other Cam.
kimmy girl	u w u
Alyssa Sarah	2:34 baby diva
Nurul annisa maydina	So always love you so much
Henriska N	coca cola's brand ambassador be lykeğŸ˜
infires man	2:34 i felt that
æœªæ¥Mirai	Wow he really amazed me so much. He looks always so calm and shy but his dance moves are amazing and he is so TALENTED.
FlyFly	sponsored by coca cola
elfi	he distracted me through the other focus cams ğŸ¤£ğŸ¤£â¤â¤â¤â¤â¤â¤â¤
í”„ë Œ	ì°©ì¥ë„ ë„˜ë‚˜ ì¢‹ë‹¤ ì •ìš°ì•¼ ë‹¤ë¦¬ê¸¸ì´ëŠ” ì™ˆì¼€ ê¸°ë‹ˆ ì‚¬ë‘í•´
1998 0219	Jungwoo is talented
Pauline	HI JUNGWOO
ayu fitriafebriani26	Hello uwuu â¤
AmeriThaiKong	Junguwu is someone I just wanna cuddle and eat oatmeal withğŸ’•ğŸ’•
gillian kimberly	his uwu just turned him to a mothafucking hottie
BLINK GING	Jungwooyahhh~ I love you â¤ï¸
Awes Full	JUNGuwu
Nat	2:32 Taemin MOVE moment there
avis L	His proportions are perfect
Bittinut	It always hit me, how tall he really is ğŸ˜‚ Jungwoo dances and sings really well, plus he is hilarious and cute, so happy to have him with 127
Sleepy Owl	good job, uwu! we love you, member nct 127
Lintang Kinanti	His moves are super neat
Fanny PiÃ±ashca Misaico	Jungwoo visual, dance and vocal ğŸ˜
Nyjhia Stokes	CARROT TOP!!  ğŸ‘ğŸ½ğŸ˜«ğŸ˜«ğŸ’šğŸ’šğŸ’šğŸ™ŒğŸ½ğŸ˜
lily bilbrough	Iâ€™m in love with this sexy skinny legend!!! canâ€™t relate
ê·€ì°¨ë‚˜	ìš°ë¦¬ ì •ìš° ì§„ì§œ ìµœê³ êµ¬ë‚˜ .. ì •ìš°ì•¼ ì§„ì§œ ì°¸ë§ë¡œ ë©‹ìˆë‹¤ ì°¸ë§ì´ì•¼ ì°¸ë§ .. ë‚œ ì •ìš° ì•ì—ì„œ ë†ë‹´ê°™ì€ ê±° ì•ˆí•œë‹¨ ë§ì—¬ .. ì°¸ë§ì´ì—¬ ì œì¼ ë©‹ì ¸ ...
Ludmila Ramireez	Asii estooyğŸ˜»
Lexi Shadows	The people who rejected Jungwoo for being in 127 should be ashamed. He deserve all the love and support from NCTzen
Min Jun	YAS BABY YAS YOU OWN MY HEART UWUâ¤ï¸â¤ï¸â¤ï¸
patty	his gaze at the end will be the death of me
Tair Nave	I adore him
Hareem Fatima	Serious Jungwoo makes my heart go Jungwoah.
Leejenelle4	You can really tell how good of a dancer Jungwoo is. His moves are detailed and with power. Its not too much hard nor too fluid. My mans, I'm proud of you.
d w	2:34 idk why but this killed me where did junguwu go
St Baerris	Jungwoo-yaaa u want to take off your jacketttt????? Omg ğŸ˜£ğŸ˜£ğŸ˜£ğŸ’šğŸ’šğŸ’šğŸ’šğŸ’šğŸ’šğŸ’šğŸ’š
HÃ´ng Anh Pháº¡m	Where is my UWU Nation?? ğŸ˜¢ğŸ˜¢ğŸ˜¢ğŸ˜¢  He looks Uwu and Sexy as fxcj at the same time!!!
Pia  Alcantara	AAAAAAH I LOVE HIM SO MUCH
scout	1:55 Mark don't laugh at your hyung, he's a swaggy boi now haha Jungwoo is doing so well in 127 I'm so happyyy
dana â€” exol & lavely	2:32 ......o-okay
- Ì—Ì€ matisse Ì–Ì-	jungwoo really is such a poweful dancer, seriously during boss era and even when they covered celeb five's i wanna be a celeb, he goes _really_ hard, he's nothing near to a weak dancer, and honestly there's no weak dancer in nct at all
Mia Asuit	ALL THOSE HAIR FLIPS THOUGH... JUNGWOO STANS HOW WE DOIN?!
Selective Fangirl	0:03 well i think this is the side effect of hanging out with taeil too much
Merryl Cherrywood	My UwU is so talent and soooo pretty. I love you so much honey. Your move is killing me
WhaTHefUCK	BoyğŸ‘didğŸ‘notğŸ‘comeğŸ‘hereğŸ‘toğŸ‘playğŸ‘
viephoria LSJ	Hands up if u have this urge to ran ur hand through his fluffy hair while lookin at this video!
Lovely Cat	2:32 jungwooğŸ˜­ğŸ˜­ğŸ˜­ğŸ˜­ğŸ¹ğŸ’šğŸ’šğŸ’š
Se Hi	ëŒ€ë°• ì˜ë¦¬ì§ˆë¡¸ã…ã…ã…ã…ã… ì •ìš° ìµœê³  ì˜ˆì•„ã…ã…ã…
nyeon x	ì‚¬ë‘í•´ ã…œã…œã…œã…œã…œã…œ
PhanTrash.-. No.1	I didnâ€™t know I needed this until now
routhleine jozile	2:32 KILT ME ğŸ’€ He looked like Taemin for a sec
Bethel Naig	Amazinggggg!!!!! ğŸ§¡ğŸ§¡ğŸ§¡
Serlin Septia	My babeğŸ’•
Verafel Verdan	2:34 that is so damn sassy sweetie i luv u
DO TY	Jungwoo and Yuta's interaction at the beginning....
sofhia oktami	ğŸ˜ğŸ˜ğŸ˜
Gee Wave	From JungUWU to JungWOAH ğŸ˜¯
MsKpopGurl	DROP THE HAIR ROUTINE
Ann Biju	Anyone want to take a wild guess and say what my favourite bit in this choreography is?
nct jjang	2:32-2:37 get it jungwoo, get it!!!!
slightly gay kids	jungwoo stans how are we
Louise B.	Jungwoo just set new beauty standards for the world and that's the teağŸ˜
Jessica Jean	Junguwuuuu
ang	this fit is fire
SNOOPWOO	honestly, Jungwoo's dancing skills is really underrated. It's sad that many NCTzens consider him as one of the weak dancers in NCT but I'm 100% sure those who said it didn't even see his fancams or even see him dance. His moves are so powerful and big yet it is very detailed,  he doesn't miss any moves or beats. Just like Johnny said, He is very fluid just like a feather. Even most idols his height couldn't even dance like him  btw not just his dance, but also his vocals and visuals are overlooked. heck this boy can even rap cause that's how talented he is, he needs more appreciation fgs.
Vale Portuguez	WOW WE STAN A DANCING KING ğŸ‘ğŸ»ğŸ‘ğŸ»
Ariella EspiÃ±a	Give some love to our junguwu ğŸ’šğŸ’š
joykimberlyy	honestly a great addition to the group damn
h.j	i still uwu-ed
Cats Are The Best	let me hold your handğŸ˜¡ğŸ˜¡ğŸ˜¡
Persephone Greendale	0:27 The bouncy hair squad!
JiSuHope NaMinTaeJung	jungwoo is like hot af when he's serious but cute af when he smiles haha
Cindy priyu	Baby ğŸ˜­ğŸ˜­ğŸ˜­ğŸ’œâœ¨âœ¨
jackhyun's just jwoos'	UWU nation represents
kosai	Great dancer+great vocal=Jungwoo
the chicken who is so done with kookie	Jungwoo honey u r doing great ğŸ‘ sweety and can u plz tell me what shampoo do u useğŸ˜ŠğŸ˜Š
jeon FIys	Jungwoo look so cute ğŸ’š
Sarah Adele Lee	y'all better trust that I'm going to go buy three boxes of coca cola after this video, king of promo
isabelle uwu	i just wanna touch his hair for some reason uwu
vznixsx	Even his hair is soft as him :â€)))
j â€¢	THE BEGINNING LMAO
kion 1128	love u jungwoo......â¤
Kimy Abdy	I find jungwoo very handsome and he dancing very well we love you jungwoo â¤ï¸ğŸ’š
yosi pspt	Uwu attack
ilikeyourkeyblade	Jungwoo is so entrancing wow
Zeela Raz	his bair is so fluffy
Tracy gdrgn	He's so perfect ğŸ’šğŸ’šğŸ’šğŸ’š *2:35** I'm still alive*
Tiu Rase Oh	Jungwoo's dance really is something. ğŸ˜
Ashleyyy194	JUNGWOO MY DANCE KING
cisly myr	2:34 Yesssss Jungwoo yessss
Nourrato 95	Ø­Ø¨ÙŠØ¨ÙŠ ğŸ˜ğŸ˜ğŸ˜ğŸ˜ğŸ˜ğŸ˜â¤â¤â¤â¤ ÙŠØ¬Ù†Ù† Ø´ÙƒÙ„Ù‡ ÙˆØ­Ø±ÙƒØ§ØªÙ‡ ÙˆØ±Ù‚ØªÙ‡ ğŸ¤© Ù‚Ù„Ø¨ÙŠ Ù…Ø´ Ù‚Ø§Ø¯Ø±Ø© Ø§Ù†ØªØ­Ù…Ù„Ù‡ ğŸ˜­ğŸ˜ğŸ˜
Tsunami765	WHAT A QUEEN 2:34
Bryan Brathwaite	ğŸ˜­ğŸ˜­ğŸ˜­ğŸ˜­ i love this man
taeyong's teddy bear jelly	such a skinny legend
Yolanda Susan	so i started from Haechan and then Taeyong and Mark, i saw Jungwoo's tummy flash so here i am. guess who's next? Johnny errbody. reason? âš¡ï¸
M U L T I - S T A N	Who ever disliked your mom is a hoe
Umjiâ€™s Aegyo	Lezgidit Jungwoo, *the latest and smollest nct 127 addition*
peachmin	2:35 NOT TODAY SATAN
blackvelvet	Jung+uwu he's so cute
Narunaru Bananananana	2:34 sweetie you'll get cold..........
Ruth Gimenez	2:33 ğŸ˜ğŸ’–ğŸ’–ğŸ’–ğŸ’–ğŸ’–ğŸ’™ğŸ’œğŸ’œğŸ’œ
My bias is the cute one	Does everyone just like become 100x hotter when they dance??? Cause like if thatâ€™s the case why doesnâ€™t it happen to me?
Vonny Bennett	**junguwu has left the chat**
Bianquira- Chan	I can't believe this, where is our UWU boy?  :((( anyway, I love this concept for 127
laura little jan	0:03 lol
ME DO MOLLA~ ì‹¸ë‘í•´!	lol jungwoo at the beginning, it's him indeed and it's cute how yuta jz leaned his head a lil bit to jungwoo ğŸ˜†ğŸ˜†ğŸ˜†
Victoria Cardona	The focus of the tummy flashes
yuna kero Kero	Your the best Jungwoo ğŸ’‹ğŸ°
felicity	junguwu â¡ï¸ jungwoah
Ğ“Ğ¾ÑĞ¿Ğ¾Ğ¶Ğ° Ğ‘ÑƒĞ»Ğ°Ñ‚ĞºĞ¸Ğ½Ğ°	Ğ§Ğ¾Ğ½Ñƒ Ñ‚Ğ°Ğº Ñ…Ğ¾Ñ€Ğ¾ÑˆĞ¾ Ñ‚Ğ°Ğ½Ñ†ÑƒĞµÑ‚! Ğ˜ Ñ‚Ğ°ĞºĞ¾Ğ¹ Ğ¼Ğ¸Ğ»Ğ°ÑˆĞµÑ‡ĞºĞ°!! ĞºÑŒÑÑ!!! <3
alica chavez	SNOOPY POPPED OFF ğŸ”¥ğŸ”¥
Sofia Grilanda	jungwoo is an amazing dancer he deserves being more recognized!!! his facialâ€™s expression also wowwww
ridha jr	jungwoo.. how dare you
marshmellow bunny	HE'S A WHOLE MASTERPIECE
Michelle Pr5	Jungwoo is truly the CUTEST baby alive
Chunji Lee	I'M SO PROUD OF YOU JUNGWOO!!! YOU'RE DOING GREAT! I LOVE YOU!
Chef Mark Lee	WHAT HAPPENED TO UWU JUNGWOO
Pacific Downtown	uwu
B Yu	UWU
Rvell Raizel	WHERE'S MY UWU?
seo soojin	Heâ€™s so pretty ğŸ’–
Luck Key	Baby ğŸ˜˜ğŸ˜˜ğŸ˜˜
Avy Williams	My day has been blessed by this
carat soup	*where did JUNGUWU GO*
skittles	2:33 oh fucc...
Lucy Smart	He really owned this one
CT ì•ì—N ë¶™ì—¬	ì•” í† ê³µì¶œì‹ ì¸ë° ì¶¤ì€ ì§¬ë°¥ì´ì§€ ã…œã…œ
Jaojoi Jxojoi	OMGGGG gonna die T______________T luv u naka â™¥â™¥â™¥â™¥â™¥â™¥
Dess Allas	I LOVEEE YOUU UWUUU T.T
ë¹µë– ê¸°	ìš°ë¦¬ ì œìš°ìŠ¤ ì‚¬ë‘í•´â™¥ï¸
mel	FLACO . te amo ğŸ˜”
Play S.	OH MY GOD I can't breatheã… ã… ã… ã… 
sushisoon	IM LOSING IT
Kimberly Arellano	â¤
ivory lemons	WTH this ain't soft
shipyour Favoriteyoutubers	UWU ğŸ˜ğŸ˜ğŸ˜ğŸ˜â¤â¤â¤
Azi Shagnal	Were there 10 cameras? Good job ğŸ‘
Chriseline Muncal	wow dance king kim jungwoah jumped out!
jaems candy	2:33 i feel taemin 'move' vibe here lol
Naufaldi Purnama	FULL MEMBER PLEASE
Rebeca Flores	Cuteee
ì›… ì›…	ìš¸ìŠ¤ë‰´ì‚ V í–ˆì–´
Chogiwa	Damn im early today 2nd comment yay
Luz mila	QUE HERMOSO QUE SOS
Greisy C	UWU
VODKA -Multifandom	LOS AMOO CARAJO
Dream127UNCTzen-LCaratARMYWannable BuddyBlink	THAT EYE CONTACT AT THE END ADSFSHSHSJSJ
Slip Into The Diamond Life	I got a problem. I canâ€™t choose a bias! I love them all!  Oh well. My life is already a wreck. â¤ï¸
CuddleNct	okay honey imma NEED YOU TO CALM DOWN FOR A SEC
kris	2:35 - 2:38 WOAH
NORA ALAZZAWI	Soooo much sass, I Love it ğŸ˜˜ğŸ˜˜ğŸ˜˜
Bunga Cendani	I'm dead by your stare, baby!!! Why are you cute but also sexy at the same time!!! You have worked hard, Jungwoo ya! Proud of you! :')
iseullee s	Wanna touch his hair....
Julia 93	His fluffy hairğŸ˜±....wow
á„‰lina	ğŸ˜­ğŸ˜­ğŸ˜­ğŸ˜­ğŸ§¡
ê¹€ê°€ì˜	ì§„ì§œ ì¶¤ì„  ë„ˆë¬´ ì´ë»ã… ã…œã…œ
Arely Olivas	I'm fall in love with this video, stop Jungwoo, is so beautiful and I can'tğŸ˜­â¤ğŸ˜
Nelly Dahn	And people really wanna say he canâ€™t dance.....LET ME SEE SOMEONE SAY JUNGWOO CANT DANCE AGAIN IMMA FIGHTğŸ˜¤HIS MOVES ARE SHARP AND FLUID!!
Kendall Yu	STAN TALENT STAN JUNGUWU
shifa tsy	my babyyyy
allie.fitzy	that eye contact.....
cocotaemin	2:33 wHEW
stan NCT	LOOK I'M TRYING TO TAKE MY EXAM HERE MY INSPIRATION IS GOING UP UP
Maricar San Pascual	He be starin at my soul 3:36
xxx xxx	He's so good in dancing â™¡â™¡ and handsome too â™¥â™¥â™¥
Lovely pony	UWU BABY
Shanen A	0:03 *secretary kim jungwoo holding the phone for yuta*
giana black	cutie
S SUN	he's so talented â¤â¤
peachy bb02	Baby,,,,you doing nice but don't grow up plx,,,xDD
Gerald Quanico	how to unseen his ant waist tho
Multi-fandom Kpop lover	KIM JUNGWOOâ¤ï¸â¤ï¸ğŸ§¡ğŸ’ğŸ’ğŸ’šğŸ’œâ£ï¸ğŸ’ğŸ’â¤ï¸ğŸ’—ğŸ’œğŸ’–ğŸ’–ğŸ’˜ğŸ’–ğŸ’–ğŸ’˜ğŸ’–ğŸ’šğŸ’šğŸ’šğŸ’šğŸ’šğŸ’šğŸ’šğŸ’šğŸ’šğŸ’šğŸ’šğŸ’šğŸ’šğŸ’šğŸ’šğŸ’šğŸ’šğŸ’šğŸ’š
Nana Dixon	What did this dirty bitches did to you, babyğŸ˜­
IcePrincessV	Even nct's vocalists have dancing THIS amazing.
Finding Memo	Sponsored by coca cola lmao
Too Lazy To Make A Name	AHHHHHHHH
7WINGS 7WINGS	He's a good dancer ğŸ‘ğŸ¼ğŸ‘ğŸ¼
cutie onds	2:34 holy zeus stop
IM LIVING FOR CHENLE'S LAUGH	He's so Talented ğŸ˜­ğŸ’š UwU
jungwoo the uwu president	1:25 yes mr.  kim jungwoo???? y u gotta be so cute ğŸ˜©ğŸ˜©ğŸ˜©
Maria Dominika	BAD SQUISHY BAD SQUISHYğŸ˜¡ğŸ˜¡
bungwoo	my sweet baby boy! perhaps he snapped!
ë¡œìš°Lou	coisa mais linda do mundo
Dew And	Wow jungwoo look different, so cool ğŸ˜­
Dung Láº¡i	Angelâ¤ï¸
I'm Questioning	WENT FROM JUNGUWU TO JUNGWOAH REAL QUICK
Visa Danastri	Jungwoo tummy flashin
jin park	ğŸ˜®ğŸ’š
Gi Nagata	I LOVE YOU UWU ğŸ¤§ğŸ’šğŸ’šğŸ’šğŸ’šğŸ’šğŸ’šğŸ’šğŸ’šğŸ’šğŸ’šğŸ’š
VOVO MO!	Uwwwuuuuuu
ì •í˜œì›	ê¹€ì •ìš° !!!!!!!!! ë‹¤ë¦¬ ì™€ë°©ê¸¸ë‹¤ !!!!!!!!! ì¶¤ ê°œì˜ì¶° ì •ìš° ëª» í•˜ëŠ”ê²Œ ë­ì–€ ã… 
Shawnte	You better get it bias â¤ï¸ğŸ˜©ğŸ˜ğŸ”¥
Amritha I.	SM feeds us so well
Ryu Jiwon	THAT'S MY MAN
Risa whyuu	LOVEEğŸ’šğŸ’šğŸ’šğŸ’šğŸ’š
elpiem wonpil	2:33 is that taemin???? lmao
Shermein Corbett	1:24 GET ITTTTTTTTTTTTTT BOY!
IZIk31	he is such a great dancer iâ€™m proud
Jolly Chan	Dancing King
Danica Castulo	AND THERE GOES MY SOUL BEING SNATCHEDBY THIS GUY
Hyeaon Jin Bae	ì˜¬ ì¤‘ê°„ì— ì¹´ë©”ë¼ ë´¤ì˜¹..
SugaTaeKookie Lana	It's Junguwu omg
Meme K.	Yessssss Jungwoooooo ğŸ’šğŸ’šğŸ’šğŸ’šğŸ’šğŸ’šğŸ’š
Kaeapop	uWUUUUU INTENSIFIES
ë§ ë§ í•˜ë‹¤	ì •ìš° ì¶¤ì¶”ëŠ”ê±°ë³´ê³  ì˜¤ëŠ˜ ë¨¹ì„ ì—ë„ˆì§€ë“œë§í¬ ë‚´ë ¤ë†¨ë‹¤... ì™œ ì´ë¦¬ í˜ì´ë‚˜ì§€ ë‚˜ ì§€ê¸ˆ ì§€êµ¬ ëš«ì„ê¸°ì„¸ì•¼ ì–´ë¨¸ ğŸ’šğŸ’šğŸ’šğŸ’š I love jungwoooo~~~
habib billal08	Hai
Gianelli Nucum	UWU :")
kimmy ğŸ’›	everyone say thank you sm
jisungtrash _	There goes VLive spamming me. Now it's YouTube. *-proud-*
K-Pop Fanficion	I NEED JESUS
siem tekle	Y
JiKookMin	YOU'RE DOING GREAT SWEETIE.
kamaiya vang	yass
luwoo	junguwu ğŸ’š
REHANA3 _Ø±ÙŠÙ€Ø­Ù€Ø§Ù†Ù€Ø©	Ø´ÙƒØ¯ ØªÙ†Ø²Ù„ÙˆÙ† Ø­Ø¨ÙŠØª Ø§ØµÙŠØ± Ø§ÙˆÙ„ ØªØ¹Ù„ÙŠÙ‚ Ù‡ÙŠØ¬ ğŸŒš
