Reina Arana	Awesome
GAcolo216	This is why James cordon is the most likable late night host
Richard Morey	Wow respect for Gordon Ramsay doing marathon and stuff
Christian Maramba	â¤â¤â¤â¤â¤â¤â¤â¤â¤ dakota it so beautiful and i laughing when she laugh contagious im a fangirl i love you idol dakota you are the best â¤â¤â¤â¤â¤â¤â¤â¤â¤ dakotajohnsonfangirl damiefangirl angellevidal
Jeyar Chardy	50 shade of raw
Robin Hood	I WOULD EAT HER VAGINA BEEF 24 7 TBH
musa khan13	I feel bad for the horse I mean REALLY ğŸ˜…ğŸ˜‚
Brandon Perez	me 3 44
avoiding the plump	Love James and Gordon together Always brilliant
Sindu Gokulapati	Even I will try
Michelle Foucault	Dakota look like a grown up Matilda
Peter Shaw	James corden is too big boned to be able to lose enough weight to do a marathon
Susana SÃ¡nchez	Im I the only one who DOES NOT find Gordon s body attractive
Raiez njr	Anyone counted the beep
ViVi K	Do it James really I ran this year London marathon it wa amazing never ran a Marathon befor Training wa hard a s I wa 37 year old to that time You can do it and with an awsome running partner it even better Good luck
LivinArt	2 50 who picture is in the background very weird
tom 123	idiot
PoppyCorn144	ğŸ˜‚ My new go to phrase â€œ I â€™ d rather shit in my hand and clap â€ thank you James I may alter it to â€œ crap â€ rather than â€œ shit â€ to keep it PG 13 SFW Dakota laughing at the thought of James hiking is also me yep he â€™ s hiking to his car and from his car
Ambar M	Can t wait to see them do it in 2020
james S	Isn t Dakota a porn star
Åukasz ZieliÅ„ski	I thought he said at the very beginning we all know you love cocaine D
M V	Im in love with Dakota
Rock n Roll	When a weird American sit between two Brits in a awkward discussion
Andrea Flores	Yo ima do that marathon now 2 year lol
I. A.	Ramsay need to stop eating carrot or wear sunscreen
V S	This is actually amazing if he doe the marathon
Christopher Rubio	Omg â€œ you â€™ re hiking for IG â€œ that â€™ s all people do now Lmfao
raj zuber	Why the hell dakota always look and sound to be turned onâ¤ï¸ğŸ¤·ğŸ»â€â™‚ï¸
IAmAdictiveX	The girl look nervous ğŸ˜‚
dlxe	Dakota Johnson would be great on DWTS
Anna Kelly	My favourite chef and my favourite singer â€™ s girlfriend â˜ºï¸
Lowenna Clark	I hike up the stair
Ayesha Jasmine	I need her lipstick eugh but i need her face to pull it off ğŸ˜ğŸ˜ğŸ˜
Susanna Murrett	And the point is
Carol Mooney	oh please I cant stand that kiss as James Corden
YouTube Zone	Love Dakota Johnson
Mai Thanh	dakota look rlly tired
justforyouenjoy	She look like her dad
Jackie Castillo	LA marathon 2020 okay let â€™ s see it
lola brini	she finally hid that colossal forehead keep that haircut look great
Shona McKenzie	He hate the fact his kid came in better
JACK36AFC	I would rather circumcise myself with a rusty knife covered in lemon juice then run a marathon
Shneak X	I see Gordon I click
Jweezy34	The funny and most amazing thing about this is that James is actually 100 gon na do it lmao Remember the skydiving thing with Tom Cruise
Sunsetter678	I weighed 280 when i met and married my Husband of almost 15 year now Throughout the year s I sadly ballooned up to roughly 330 YIKES But then I got ill and now I weigh a whopping 234 and I look GREAT A FAR cry from the Woman who used to tell her Husband to harpoon her because I wa so big
donny charli	you re DEAD James
ChrisFun	She would be a great stand up comedian so naturally funny
KNO	I know Gordon really well Trust me he is always star struck when he meet celebs Although not only he hide it he make it his duty to hide that fact
Josh Heinz	now Dakota we know you love cocaine 0 01
XoRoW Gaming	everytime james make a schedule about whatever it is with the guess it s gon na happen soon I believe everyone here remember what he did with tom cruise
Issa Gabito	That Chaka khanğŸ˜‚ğŸ˜‚ğŸ˜‚ğŸ˜‚ğŸ˜‚
Monster Hanna	That s in here Oh my gosh I love you Dakota
Heidi Thomas	I love Gordon s sense of humor He s straight forward and to the point He ha earned the title top chef through hard work and dedication Too bad so many lazy ignorant people don t want to hear where they are going wrong He treat others like they are kid because that is how they act like spoiled bratty kid Restaurants fail because of poor management Food is nasty because of improper service He put his life on the line eating in those dive I d be pissed too if someone I m trying to help stood there saying it s not my fault the food is rotten the cook don t care and the place is dirty
Meg Anderson	She s obviously not around horse THAT often They can feel fly land on them but not her Lol Sure She s funny though
lamees saleh	Why mike posner photo is behind the couch 3 02 I know he wa singing in the same day but still why
Stella Bella	Riding horse a a hobby is such a rich person thing
access	That s shocking indeed old man body trying to be a young man xD
nurul syazana	going to marathon would be nice
justin Christ	Most bleeped show
Felix Rodriguez	Am I the only one who noticed the photo of a hairy man in the background
Marie Silfverberg	I d rather shit in my hand and clap HAHA I m so gon na use that in the future
yes you are right	Dang Gordon is so fuckin handsome Yeah I know he is old and what but I ll do him anyday
Theresa Neigum	Gordan ramsey i think he get turned on by these actress he so different from his ignorant dimeanour on his cooking show
rory ferguson	James Cordon doesn t want to lose weight because he would lose all of his comedic material
Kenneth Torres II	ğŸ‘ğŸ»
Brianna Rene	The man went skydiving I â€™ m pretty sure they â€™ ll do this
John Smith	Dakoda Johnson pardy
The Uber Tuber	Maybe if James start it now he ll be finished by 2020 xD
emile heskey	You don â€™ t sensor â€˜ move your arse you fat bastard â€™
okay 0	Hey im james corden i make fat joke thats the only joke i have
YouTubsel	Now Dakota we know you love cocaine WHAT replay video Ooooohh You love COOKING
Mikeztarp	I hope he keep that promise
Bob Meyers	GO JAMES
Rahimaaa	I like how when Gordon is there they ALL swear ğŸ˜‚
Ethan Aleman	Count me in marathon
gia grey	http youtu be 7s9P6ZTHUSc love these two together
deathbym0nkeys	i m in tear i am laughing so hard
Geoffrey Feinberg	She s cute She s finding better role to play than Anastasia Steele
Jessica Love	Gordon being modest ğŸ˜±ğŸ˜±
Wolf	he better do the run tbh or I will be so anger
Kate	2 54 move your as you fat bastard they didnt bleep it hahaha
Philip EngstrÃ¶m	Did James say Dakota we know you love cocain Thats fucked up hahaha
War Horus	Another Hollywood brat who got famous just because of her parent
Jolie Barnes	She is adorable can t wait until you can see her in public a a couple with Chris Martin they are a great couple because Chris is always joking and is such a lovely well rounded humble guy He is perfect for her
greyandanasteele	I like how Gordon think James will only keep on going for the next ten yearsğŸ˜‚ğŸ˜‚
Princessa Kelsey	Dakota is my fav celeb
Mr. Chicken	Dakota is so gorgeous I want her to punch me in the throat
Editing by Itstscenes	All legend in one video
Jun Kazama	What kind of fucking bullshit is this You don t even have footage of her promoting BOTH OF HER FILMS COMING OUT THIS MONTH LAMEEEEEEEEEEEEEE
Mc Muffin	The Lamb Souce God is back
CallMeCourt	I really like Dakota â€™ s tone her voice is really calming
Duggs	18 stone is 252lbs not 280 280lbs is 20 stone
Floppy Bird	she love to ride horse ok i bet she love to ride something else too
parbattie persaud	Dakota is so pretty ğŸ˜ â¤
PaulPlaysMinecraft	280lbs is 20stone Gordon lol
Jaron Schipper	He is gon na have to lose some weight in order to do the marathon Cant wait to see that I hope he is serious about it
aclaybass	This is one of the best Late Late Show clip out there
Natalia Arce	She s adorable â¤â¤
mayra rodrigues	dakota is so funny
Olympias	2020 wa a little too ambitious I think I do hope James really start training and get a bit fitter though He s so funny sweet and genuine compared to a lot of other host and celebrity figure
FruittisMaris	that girl is stupid
Esmerelda Estrella	oh man she got a little defensive I could see her ready to fight him and peta lmao
Irma Rossanie	I hate that I am starting to say shut the front door because of James
Lara Kardaly	Gordon is orange ğŸ˜‚
Olivia	i love how much they cursed in this
Ester	What an amazing unexpected trio
MASH FERDISTA	Did James say that he would shit on his hand and then clap If so I m gon na steal and use it almost everywhere
ArtsyPutsy	Dakota is like bellatrix sealing the deal between snape and narcissa This is an unbreakable vow james Don â€™ t bail on this
hafiz bonzAi	shut the front door
Maite Sekhwela	Why is Gordon orange
Jakartasaurus	Please also watch like and SUBSCRIBE my youtube channel Newbie here Love you
Joseph John Anzur	Great fun
GameThruz	I d love to see James go with Gordon for a show similar to Diners Driveins and Dives
elzeus13	She didn t agree to that pact
Adrian	this reminds me of James Corden dealing with Tom Cruise to skydive DD now he s gon na do a marathon with Gordon noice
Maximillian	How are they not gon na show the dancing
Najwa Shariff	Love the accent
Andhi Kenny	ğŸ˜‚ğŸ˜‚ğŸ˜‚ğŸ˜‚
Al finto	James cordenğŸ˜ğŸ˜ğŸ˜˜
Tiffany T	Like chaka khan ğŸ˜‚
A D	Dakota can t take her eye off Gordon s pic ğŸ˜‚
Itsmeharper Jacksons	ğŸ˜‚ğŸ˜‚ğŸ˜‚ğŸ˜‚ğŸ˜©ğŸ˜©ğŸ˜©ğŸ˜©ğŸ’€ the horse would say really he got Dakota and I got this guy
SlowMotion	Ramseys doe not dance he doe not dance at the party
SlamJam92	Just came from the future of the 2020 marathon event James almost died after 20seconds of running
nobody survives even one bit	Loving Dakota
Nancy Suarez	Love Dakota â¤â¤â¤
Frederic Poisson	We are with you James Right guy
steven counter	god will kill all of you peopleï¼Œi am a muslin
audi rahmat	I d rather shit in my hand and clap HAHAHAHA
Michael Holmgaard	She s such a terrible actress even worse than Jamie Dornan
Adi	i love how dakota wa just dragged into this XD she didnt even say she would do it
Justin Aaron Supe	I d rather shit my hand and clap Jesus James I couldnt breath for a good 5 minute
Ki Adi Mundi	u know there gon na be swearing when gordon is there
Jazzy G.	Of course I m here for DakotaJohnson
Laylla's Locker	I d walk a marathon yes but run oh NO XD
Retina Frost Bite	Thats an amazing ending
lilycupcake11	I thought James wa going to say you love cocaine at the startğŸ˜‚
Bernadine Gittings	you re hiking for instragram shut up AND IM DEAD
ìµœëª…ìˆ˜	No dislike This is perfect
ILove Anime	HE S ORANGE
gigi stoner	I believe Corden when he say I ll try in regard to the 2020 marathon challenge You go Corden
ScarlettP	Dakota looking like a big present wrapped up lol
IJ March	6th Is this a contest hahahha pretty Mayi
Kaylee Situ	DAKOTA ğŸ˜ğŸ˜©ğŸ”¥
EmmaCherie	Ye forth
Nona Sora	3rd ğŸ‘Œ
Jay loves Larissa	FIRST CAN YOU PIN ME PLS
