Samyog Khatiwada	Plzzz put nepal flag
Rosemberg murcia caceres	Eliminaron los barriles de esqueletos
Tommy Neu	Ich hab nichts verstanden ğŸ‘€â“â”â“â”â“
9imches deep	Witches are officially useless guy
Ø±Ø¬Ù„ Ø­Ø·Ù…Ù‡ Ø§Ù„Ø®Ø¬Ù„	Ø®ÙˆØ´ ØªØ­Ø¯ÙŠØ«
LAZAR BLADE	Coc will never pin me there â€™ s just no way
Steven Holz	Please reduce the cost for the hero PLEASE PLEASE PLEASE ğŸ‘ğŸ‘ğŸ‘ Greetings from GermanyâœŒ TH9
Hamid Ijaz	Pakistan flag please
Warrior 01	We want attack time longer
Mr Kariball	ĞĞ¸Ñ„Ğ¸Ğ³Ğ° Ğ½Ğµ Ğ¿Ğ¾Ğ½Ğ¸Ğ¼Ğ°Ñ
Jess K Tom	My hero s are not boosted correctly in training portion time have anybody else ha same issue
Ayaan Verma	This update suck Th12 didn t need the 3rd inferno tower and even Eagle artillery is buffed Do you want u to quit playing clash
RAPID WIEN ein Leben lang RAPID WIEN ein Leben lang	How much cost the clocktower drink
LORD ALPHA	Please remove the 24 time delay on clan challenge and add resource collection
it's Gaming Time	Lol war matching Fix it like if u agree
sandhya awasthi	badai ho megahi km ho gyi
anime protector	Is the skeleton barrel and giant skeleton in the game permeantly or just temporary
Andrew Harness	UM EXCUSE ME WHY IS THE TRAINING TIME SO MUCH LONGER FOR BARBS AND ARCHERS IT USED TO BE 6 SECONDS NOW 20 24 THAT IS THE WORST THING THAT HAS HAPPENED TO THE GAME
Irfan Momin	Plz supercell builder base war update
Wellington santos	Nao tinha necessidade de nerfar a bruxa
MAX GHOST	Administration of CoC please add an Ukrainian flag and Ukrainian language
Rakesh Jindal	My coc is not downloadingğŸ˜­ğŸ˜­
Ğ’Ğ»Ğ°Ğ´Ğ¸ÑĞ»Ğ°Ğ² Ğ¡Ğ¾ĞºĞ¾Ğ»Ğ¾Ğ²	Ğ½Ğ°Ğ±Ğ¾Ñ€ Ğ±Ğ¾Ğ¹Ñ†Ğ¾Ğ² Ğ² ĞºĞ»Ğ°Ğ½ 5 ÑƒÑ€Ğ¾Ğ²Ğ½Ñ Ğ´Ğ»Ñ Ğ»Ğ¸Ğ³Ğ¸ ĞºĞ»Ğ°Ğ½Ğ¾Ğ² Ğ² ĞºĞ»Ğ°Ğ½Ğµ ĞµÑÑ‚ÑŒ Ğ´ĞµĞ²ÑƒÑˆĞºĞ¸ UUP9VLJC UUP9VLJC UUP9VLJC
nathan BR	Supercell vcs poderiam equilibra o tempo de regeneraÃ§Ã£o do herÃ³is tambÃ©m
CouchHobbit -	This is a good update Finally the air bomb have reduced activation
Farid Gabriel Elemantal Lol 2	Ãntrax esta bobo
7_ H E R O	Ø§Ù†Ø§ Ù…Ø´ ÙØ§Ù‡Ù…Ù‡ Ø­Ø§Ø¬Ø© ğŸ˜¥
Ù‡Ø´Ø§Ù… Ø§Ù„Ø¹Ø±Ø§Ù‚ÙŠ	Ù…Ø§ ÙÙØªÙ‡Ù…Øª Ø´ÙŠ
Ø­Ù€ÙÙŠØ¯Ù‡Û£Û—Û ØµÙ€Ù€Ø¯Ø§Ù…	Ù…Ø§ÙØªÙ‡Ù…Øª Ø´ÙŠ
99 ft.	Need BH fair opponent balancing
SPECTRUM zx	The witch became weaker
Alex Lambrechts	Yo it s a good Vid you no
à¸¡à¸” à¸ªà¸²à¸¢à¹à¸‚à¹‡à¸‡	à¸„à¸·à¹ˆà¸­à¸­à¸°à¹„à¸£
Sammy Su	1 18 What doe that even mean
kity kitkat	Wut y y wifi
Gaurav Patel	YE BELAR HAI JISKE GAAD ME DUM HAI PUBG KHELO YE PIDDI GAME HAI
Beerus sama	best update ever ğŸ”¥ğŸ”¥ğŸ”¥ğŸ’ª
harish metha	Do not update the coc why
Ebaad Azam	Bhai mere game update nhi ho rha hai batoe kya karo
Ranju Sharma	I am not happy with balance decrease all training troop elixir and decrease gem
Dalin Hall	You should make the wall cost le Level 1 100 to 200 Level 2 500 Level 3 1000 Level 4 1200 to 1500 Level 5 2000 to 2200 Level 4
Sunil Sharma	Coc is the best
Ø«Ø§Ù…Ø± Ù…Ù…Ø¯ÙˆØ­	Ø³ÙˆØ§ ÙƒØ°Ø§ğŸ‘ğŸ»
POTATO POTATO POTATO POTATO POTATO POTATO POTATO	Quiet
Omar R Sosa	Hola Porque le bajaron daÃ±o y vida a la bruja
War king videos	Nice balance update
HEMANT SAHU	â¤
Nishikant kumar	Always maintanace break
Bahaedin Baha	Ø´Ù†Ùˆ Ù‡Ø°Ø§ ÙˆÙ„Ø§ÙÙ‡Ù…Øª Ø´ÙŠ ÙŠØ±ÙØ¹ ÙˆÙŠÙ†Ø²Ù„ ØµØ§Ø¹Ø¯ Ù†Ø§Ø²Ù„ ğŸ¤£ğŸ¤£ğŸ¤£ğŸ¤£ğŸ¤£
RANDOMIZE FOR YOU	Who want to see muskeeter in coc Hit like
princysoni 8888	We want howallon updated version
Md Galib	Hlo nice video
Soilen Marak Dipankar	HMM GOOD
imran ansari	http youtu be WrpLa DdU8w CLASH OF CLAN IN HINDI
Tiá»‡p HoÃ ng	No like
Syahrul Clasheer	Supercell sometimes halloween update
brothercraft ID	COC Mania indonesia mana
Endrii Slank	Update bad
BEDOT 3rd	Join ajajajajajajja
Kiran Rai	Hi it is true that new troop will come that mega or golden dragon â˜ºâ˜ºâ˜ºâ˜ºâ˜ºâ˜º
Gopi Amarnath Reddy	I am not able to install COC through shareit after this update
Aidil Guel 305	Taiiikk jirrrr Sekrng mau masuk lama bngt Kpn kita main klo gini Coc
Gian _	Let s pray for th9 ğŸ˜‚
Atul Singh	My COC game wa not started
truant reja	where is the seige machine update in th game cost remais same and time also where the balancing go lol xD
Maria Arias	Cool
Nick486	Why u gon na nerf the x bow but buff the eagle artillery ğŸ¤”ğŸ¤”ğŸ¤” Edit I m top comment
Vivek chandravanshi	Nice coc
ONLINE GAMEING TIP	Ma tumare channel pa kam karna chatahu toom loge ke na bolo
samad 2016	New update is COOL
Sarnam Grg	EAST AND WEST CLASH OF CLAN IS THE BEST
Ø¹ØµØ§Ù… Ø´Ø¨ÙŠÙ„ÙŠ	Ø§Ø­Ù„Ø§ ØªØ­Ø¯ÙŠØ« ğŸ˜š
JEPOnatics 2004	WoW all hero using gem decreased but why giant
Cosmic Blox	Super cell you just made the witch super useless now that you made a lot of bad decrease on it and it wa a bad idea
PastaPlays	Who care about this Give u Clash A Rama We want it
Gita Devi	Only one thing that I hated about this update is that you have changed music and desgine of shop
Ismail Khan	Witch wasted
Rebeca Rodrigues	Tem algum brasileiro ai Rsrs
Shane Finkelstein	What do y all hate the witch y all keep decreasing her damaged and her health
Fool Proof Gaming	I love clash of clan but this video look like it wa made in Goolge slide
King of the world	ØªÙ… ØªØ«Ø¨ÙŠØª Ø§Ù„ØªØ­Ø¯ÙŠØ« Ø§Ù„Ø¬Ø¯ÙŠØ¯ 1 44
Ø­Ø³ÙŠÙ† Ø§Ù„Ø¨ØµØ±Ø§ÙˆÙŠ	ğŸ˜˜ğŸ˜˜
RayRayJordan	I am very very disappointed on this update I ve been saving my limited troop since they first came out I update the game just so you guy can delete all of my special possession I am not happy There go the year I wasted on taking care of them R I P to my limited troop and spell 2013 2018
jesus hernandez	Cool
Nazrawi Zena	Horrible update
Ğ Ñ‹Ğ±Ğ° Fyga	ĞĞ¾Ñ€Ğ¼Ğ°Ğ»ÑŒĞ½Ğ¾Ğµ Ğ¾Ğ±Ğ½Ğ¾Ğ²Ğ»ĞµĞ½Ğ¸Ğµ ÑĞµÑ€ÑŒĞµĞ·Ğ½Ğ¾
Arun Kumar	At leasrt i can upgrade pump
Hia	Omg this wa released on my birthday
Universe Girl	Erm mine wasn â€™ t updating so I undownloaded it is that the word and tried again It â€™ s not working and it â€™ s not my data a I still have 5g left HELP
Renz Beragsang	Its still not fair
Con Lynch	Can you guy add when you want to collect your treasure form the clan castle you can chose how much you want to take oit
Emilianoprogamer 007	Genial
Shex Ahmed	ğŸ‘ğŸ‘ğŸ‘ğŸ‘
Helen Bannerman	I m trying to get the update but it s to slow so are you doing it or is App Store doing it
Eren Karahan	My Favorite game
First class Jackass	I hate the new shop look
Bhushan N	In new update today update I can t play clash of clan when I started to update can t update app then I uninstalled and give the game from my friend but they always say this file is not correct my mobile is very much space an ram and I checked where problem please fix thisğŸ™ğŸ™ğŸ™ğŸ™ğŸ™
Md Anowar Hossen Shahin	Please give bangladeshi flag in coc game shop please
Smart Hemant	Sir Please help me after 23rd October s update clash of clan wasn t running in my android mobile please do something ğŸ˜­ğŸ˜­ğŸ˜­
Ali Shabada	http youtu be eRrqJJyVsEA
ĞœĞ°ĞºÑ Ğ“Ğ°Ğ½Ñ–Ñ‡	Amazing
Quinta Lee	Wait EA get a buff Yeah it headed to get stronger ğŸ™„ğŸ¤¬ğŸ¤¬ğŸ¤¬
Nirmal Kishore	Xbow hit decreased ğŸ˜¢ğŸ˜¢ğŸ˜¢
BEST WORLD	Perfect update
Megha Patil	lol
Sp ifey	NO it kinda destroy witch slap
Jekabs Zemzale	One question what de freck is a gem donation deccrese
Vishnu Priyan	tamilan like hit
Mietz die Katz	Please ban those Siege Machines from Clan war when there is no th12 in the war itself It is literally impossible to win against someone who get one donated by their clan member and then us it in war
Ù…Ø­Ù…Ø¯ Ù…Ø­Ù…Ø¯	Ø§Ù„ÙŠ Ù…ØªØ­Ù…Ø³ Ù„ØªØ­Ø¯ÙŠØ« Ù…ØªÙ„ÙŠ Ù„Ø§ÙŠÙƒ ğŸ˜…ğŸ˜‚
Abdullah Shah	Clash of clan Fan s Like my Comment ğŸ˜Š
Ğ¡Ğ°ÑˆĞ° Ğ“Ğ¸Ğ¶ĞºĞ¾	ĞĞ±Ğ½Ğ¾Ğ²Ğ° Ğ³Ğ°Ğ²Ğ½Ğ¾
Berkantan Berkan	Why did you remove Ä±ce wizard
DANANG GAMER	Witch nerf
Siddhartha Paudel	Can we change clan name
FrostieLP	EndlichğŸ‘Œ
Zarif Ahmed	After the new update i don t get the star bonus But i collect more than 5 star from the multiplayer battle Please answer me a quick a possible
Bao Duong	I can not receive the bonus
Michele Porcu	Non mi assegna le stelle quando attacco per ottenere bonus stella can you fix that Thank you
Himanshu Jain	coc is not working on my phone after the update supercell plz fix this
Emil orucoV	SÃ¼percell oyundan doydum artÄ±k yoruma dikkat alÄ±n Ya nasÄ±l insanlarÄ±mÄ±z kÃ¼fÃ¼r etmiyom saygiliyim ismim Ayxan oyunda ya isim nedeniyle 7 gÃ¼n Ban yemiÅŸim neresi kÃ¼fÃ¼r nolur yapmayÄ±n boyle SÃ¼percell hesabimi lÃ¼tfen geri veriniz Bu ne ya oyundan soyuyor insan kuran Ã§arpsÄ±n isim ve Kufretmiyom tobe Hesabimi geri verin yağŸ˜­ğŸ˜­ğŸ˜­ğŸ˜­ğŸ˜­ğŸ˜¢ğŸ˜¢ğŸ˜¢ğŸ˜¨ğŸ˜©
sohyun kim	Make the clan game 3 day only please
YBX	Kinda sad for witch well go back to using valkeries
Rocking Boy Bhaskar	fix the bug of star counting in loot
Pinkyy Pop	Who care about gem donation anyways
ZUHAIB COC MASTER	COC best hai jee
CR RONALDO	Is there anything new in the latest update to clich Thank you
Nora Joldi	Super schel con questo aggiornamento ai migliorato tutto
07806184074 Ø§Ù„Ø¹Ø±Ø§Ù‚ÙŠ	Ù…Ø±Ø­Ø¨Ø¢ ÙˆØ´ Ù‡Ø§Ø°ÙŠ ØªØ­Ø¯ÙŠØ« Ø¬Ø¯ÙŠØ¯ ÙˆØ´ Ù‡Ø§Ø°ÙŠ Ø¯ÙØ§Ø¹ Ø¬Ø¯ÙŠØ¯ Ø¹Ù„Ù‰ Ø´ÙƒÙ„ Ù„ÙˆÙ„Ø¨ÙŠ Ø¨ÙŠØ®Ù„ÙŠ Ø¬ÙŠØ´ ÙŠÙØªØ± ÙˆØ§Ù„Ù„Ù‡ Ø®Ø±Ø¨ØªÙˆ Ù„Ø¹Ø¨Ø© ÙƒÙ„Ø§Ø´ Ù…Ù† Ù‡Ø§Ø°ÙŠ ØªØ­Ø¯ÙŠØ«Ø§Øª Ø§Ù„ÙØ§Ø´Ù„Ù‡ Ù†Øµ Ø§Ù„Ø¹Ø§Ù„Ù… ØªØ±Ùƒ Ù„Ø¹Ø¨Ø© Ø¨Ø³Ø¨Ø¨ ØªØ­Ø¯ÙŠØ«Ø§Øª
Max Zamberger	Clash of clan isn t Working at me now
Sep Rooijen	Yeeeeehaaaahhh valk is stil the best
Josh Foust	For some reason some of the building texture on the builder side is 720p I think it s a texture glitch Please fix this a soon a possible I don t like staring at it I look to weird
Xerxes Khan	There is a problem I attack on a village and get 3 star s But it s not added in star bonus
Yagi Cimaron	22 10 more like 23 10 You had one JOB
yuz uzazyi	malah nambah beban peningkatan bangunan gmqna mau max klo kya gini caranya haduhhh
Suhail Malik	Please make a video which clear all doubt of clan war league so we can understood it well ğŸ™„ğŸ˜º
Dinesh Pathre	So nice but
JustRandomGuyFrom Somewhere	Next balance change Gem donation decresed
Tejbali Singh	Why you add device I d in clash of clan
shajalal shajalal	I didnot get star pls help here is my tag YRP2VVOVJ
Ø³Ø¹Ø¯ Almore	Ø§Ø­Ù„Ø§ Ù‚Ù†Ù‡ ÙÙŠ Ø§Ù„Ø¹Ù„Ù…
Kumkum Queen	Plz give one gem mine in home village plz coc
Asmat Ali	When to updateØŸ
Hiá»‡p Tráº§n	What king of update No more reward
bae bae	Nice
splatoon 619	I HAVE ONE BIG CONCERN MY COC ACC DOSNT HAVE A EDIT BASE ICON LIKE WHY CAN ANYONE HELP ME OR COC HELP ME
Ajin T ajai	witch s hit point and damage reduced it soo baad
Saria sy	Clash royal the best ğŸ’™
Dubbangi guys	Ooooooo mmmmmm gggggg any another change also
overlord	Wow update with no clan war leages uninstall
Dodger01 The Awesome	After all those good thing Supercell pulled a sneaky 1 06 XD
LazyPanda	Now thats alot of damage
Ğ”Ğ°Ğ½Ğ¸Ğ» Ğ›Ğ°Ğ´Ğ¸Ñ	Ğ˜ Ñ‡Ğ¾
Ø­Ø¨ÙŠØ¨Øª ÙˆØ³Ø§Ù…	ÙƒÙ„ Ø´ÙˆÙŠ ØªØ­Ø¯ÙŠØ« Ø´Ù†ÙˆÙˆÙˆ Ø§Ù„Ù‚ØµØ©
Eon Uy	I have quit playing now sorry supecell and thank u for all those 3 year of playing
MONTASIR RAHMAN SIAM	coc
Collin Pearce	Finally a new upgrade for the gold mine
Leman Hesenova	Nice
Matthias  Kalweit	Xbows again They were way to low they need an incresement
wondering winston	start the game plzzzzğŸ˜¥ğŸ˜¥ğŸ˜¥ğŸ˜¥
Malar Ashoke	Please help me Idk whats wrong with the maintenance problem It said to stay for 1 and half hour Then 45 min then 20 min then 10 min Then few minute then again started over to stay for 20 minute Please help meeeee From Srilanka
Anita Nandi	where is update ğŸ˜¡ğŸ˜¡ğŸ˜¡
Uma Joshi	We have to wait 2 hour
Ø¯Ù„ÙˆØ¹Øª Ù…Ø§Ù…Ø§	ğŸ‘
Mr.Kittipong Panomchai	à¹€à¸à¸ˆà¸¯à¸­à¸·à¹ˆà¸™à¹€à¸„à¹‰à¸²à¹€à¸­à¸² wifi Â¥ niternet à¹€à¸Šà¹ˆà¸™ Pube G
RIFQI 01	Witch ok hell nah
Epic Fails	Wow too many decrease gem
Senay Genel	Yes yes yes Welcome yes
Nuvok kal	UPDATE IS HERE
demon coc king	When this update will come I am very excited
Ø§Ù„Ù‚ÙŠØµØ± Ø§Ù„Ø±ÙŠØ­Ø§ÙˆÙŠ	ÙƒØ°Ø§Ø¨ÙŠÙ†
top vines	the game that I wa addicted before 2 year
Gobinda Halder	Dear Supercell please maintio break close
Ghost Minecraft	Ñ€ÑƒÑÑĞºĞ¸Ñ… Ğ¸Ñ‰Ğ¸Ñˆ
Dig Bick	They kill the witch in cash royal and now on here too
Shoyab Kadeer	From so long m trying but the maintance break is showing from almost an hour love ur gamesğŸ˜ŒğŸ˜Œ
Muku Muku	If we can chat with our friend please make this update
YOUTUBE GENERAL	JUST BRING IT
Ø­Ù…ÙˆØ¯ÙŠ Ù†ØµØ±Øª	Ø³ØªÙ…Ø±
Asim Butt	Thank you soo much supercell
Rohan Kumar	Thankyou coc
Filip KZ	New level to the resource That s the best 3
Sinan Mohammed	Nice update Guys Join my clan GL28UV9P The Blaze Drag
U Tiup	This is suck
Yogeshrao Yogesh	Thanks
Ù†ÙˆÙˆÙ†Ù‡ Noor	Ø´Ù†Ùˆ ÙŠØ¹Ù†ÙŠ ğŸ˜¹
BISHWA MUSIC CHANNEL	Wow
Preeti Kumari	ğŸ˜±ğŸ˜±ğŸ˜±ğŸ˜±ğŸ˜±ğŸ˜±ğŸ˜±
***Ø²Ù‡Ø±Ø© Ø§Ù„Ù…Ø±Ø­****	Ø§Ù„ØªØ­Ø¯ÙŠØ« Ø¯ÙˆÙˆÙˆØ®Ù‡
TuRaL Y-Zade	ğŸ‡¹ğŸ‡·
Ken Way	Pls make it fast i need to attack in my warğŸ˜­
FunBo	Where is the update
Minh QuÃ¢n	S láº¡i báº£o trÃ¬ tháº¿ supercell
Ritik Wavekar	Unnecessary update
Amazing vishal	I am father coc
Ravindra Kumar Singh	This is the best thing
Joe Ke	Ù„Ù…Ø§Ø°Ø§ ØªÙ… ØªØ£Ø¬ÙŠÙ„ Ø§Ù„ØªØ­Ø¯ÙŠØ«
mario eliel	Supercell ya no tiene idea estÃ¡n haciendo bien estÃºpido juego con malas idea
Xx_tyrome_Xx	Gets stupider and even stupider
Takam Tajo	Why the hell decrease witch damage and hitpoints
Abhi Gaming	Now it having a big update of oct NEW UPDATE CLASH OF CLANS thanks clash team
Ù‚Ù„ÙˆØ¨ ÙƒÙ„Ø§Ø´	Ù…Ø±Ø­Ø¨Ø§ Ø´Ø±ÙƒÙ‡ ÙƒÙ„Ø§Ø´ Ø§ÙˆÙ ÙƒÙ„Ø§Ù†Ø³ Ø´Ø±ÙƒÙ‡ ÙƒÙ„Ø§Ø´ Ø§ÙˆÙ ÙƒÙ„Ø§Ù†Ø³ Ø§Ø±ÙŠØ¯ ØªØ­Ø¯ÙŠØ« Ø§Ù„Ù„ÙŠÙ„ÙŠÙ‡ Ø§Ù„Ù‰ 28 Ø§Ø±ÙŠØ¯ Ø§Ù„Ø­ØµÙˆÙ„ Ø¹Ù„Ù‰ Ø¬ÙˆØ§Ù‡Ø± ÙƒÙŠÙ Ø¹Ù„Ù‰ Ù‚Ø±ÙŠÙ‡ ØªØ§ÙˆÙ† 9
Welysson Mendes	FaÃ§am em portuguÃªs ajudaria bastante amo Clash of clÃ£s pohhha
Niranjan Prasad	Bhai Jo hota hai bhale ki liye hota hai isme hum Tum kya kar sakte hai
caitlin abbot	WHAT THE HELL ARE YOU DOING BY SEPARATING US FROM FB OFFICIAL PAGE
Ram Kumar	No update still now
AnoNYMouS HaCKeR	what about matchmaking update it take too long to search an opponent
Kevin Lau	Gem donation decreased
Î“Î¹Î¬Î½Î½Î·Ï‚ ÎŸÎ¹ÎºÎ¿Î½ÏŒÎ¼Î¿Ï…	ğŸ˜¡ğŸ˜¡ğŸ˜¡ğŸ˜¡ğŸ˜¡ğŸ˜¡ğŸ˜¡ğŸ˜¡
CLASH WITH WISZARDS	Wooo
Gaming world	Plzzzzzzzzzz give u a gift to upgrade aur wall rusher ğŸ˜³
Ø§Ø­Ù…Ø¯ ØªØ¨ÙŠ	Ù„ÙŠØ´ Ø§Ù…Ø³ 10 22 Ù„ÙŠØ´ Ù…Ø§Ø¬Ø§ ØªØ­Ø¯ÙŠØ«
mostafa cnass	ÙƒÙ„ÙˆÙˆÙˆÙˆ ÙƒØ°Ø¨
Luca Freyer	Wy dit the Update didnt come
Sublofe V	Can you give me max money supercell And my name is can t touch this I am a town hall 8 and I am not close to max thanks I hope you give me money and e
modo m	Why clash of clan don â€™ t UPDATE
Antonio Jordan	23 10 still waiting ğŸ˜…
anuj thakur	Wow Dislike from my side
Jhantu Biswas	Yea update kab hoga
Maxim Negara	Where is it
Hussein Irap	She s dying Update for Androy
Gaming with Umair	1 13 OMG
argho turjo	We Don t Need The Clan War League Update Supercell Plz Don t Give Us The Clan War League Update If You Get The clan War League Update Then It s Very Diffecult For Us To Play Coc
Wrestling Online	Sad for witch
Md Abul Hossain	world record sooooo many balance change ğŸ˜°ğŸ˜°ğŸ˜°ğŸ˜°
AKU	naga listrik pesingkat waktunya dong lama bgt
David IoniÈ›Äƒ	Sorry to ask supercell can you nerf the archer tower I fell like it ha too much range
Lilik Aning	WiZARTğŸ˜ğŸ‘‘ğŸ’ªğŸ˜‰
Dnjdj Bxbb	Oh won
Kanav Manhas	Where is the update Today is 23 10 ğŸ˜¡
TrÃ­ Nguyá»…n	What time update
Ian Chris	Aw man and i wa just getting good at the witch slap for clan war
ALL ABOUT TECHNOLOGY	Now this is time to reinstall the game 15th time
Nishant Tomar Vlogs	Where is updated I have just go to play store every single minute
Adnan Malik	I quit this game
Kahlil Reyes	How bout the housing space
Abu Bakar Siddik Dipto	Your great brother I love clash of clan ğŸ˜ğŸ˜
Stephen King	Lol bro this game is more dead than clash royale
sherly putri	this is my favorite game
Nicx Genesis	Well this wa utterly useless
conny vaz	When is the update comming
BAC Cartoon World	Where is clash of clan new update
cunning hitman	MERCI POUR LE GOLEM
IkHebGeen YTKanaal	wherr is the balance update
abhishek karmakar	Coc becoming so shitty because of these shitty update
Okan TunÃ§	GÃ¼ncelleme neden gelmedi
Anand Gamer	All dislike comment come from pubg
DmaJkan	Im new th10 and i hate upgrading colectors and mine and u add this rly
Fernando Cm	DÃ³nde estÃ¡ mi pinshe actualizaciÃ³n pa irme
Mayur 1345	East or West COC is the best
Matthew Nancarrow	Lies my golem is still 450ğŸ˜«
RJ Jose	When will be the exact date to update
Deviant sAint	Hmm so se y ğŸ˜
Huynh Pham	No up
Ricardo	Walls are still to expensive
Don Carlos	RIP Witch
Venkatesh Chowdary	Where is update today is 23 10 Anyone got update Ples tell me
Cristal Zeballos	Muy mal con la bruja muy mal
Kylee Bustamante	Wheres update
Ravi antaal Ravi antaal	No
manik hossain	chudi galo ha murgi gore tol
Talal Rashid	When will this come
Before you Know	When the update of coming
ARIDRAKE1	Ğ˜ Ğ“Ğ”Ğ• ĞĞ‘ĞĞĞ’Ğ
KRAY-Z	Give u the update already damnit Guys my player tag is 8RR8P9JRV just saying bye
My Little Heavy	I didn â€™ t get the up date
Ù†Ø³ÙˆØ± Ø§Ù„Ø§Ø±Ø¯Ù†	Liars
geodimo	I am satisfied with reducing the build time and cost of siege machine I am surprised they didnt touch the e dragon Should be adjusted a little bit with faster movement and lower attacking power
Jake Schmidt	Can we get a NEW troop
Ricardo GÃ³mez	I wish you could introduce Mexican Flag We are a lot of player in this country I guess it isn â€™ t hard to add it to the current list of flag
Jyoti Joshi	Like those update
Rodwel Aleman	And when are fixing cloud for leyends That s something that requieres attention ğŸ˜ 
Ø¹Ù…Ø± Ø¹Ø¯Ù†Ø§Ù†	Ø§Ù„ÙŠ ÙŠÙ„Ø¹Ø¨ ÙƒÙ„Ø§Ø´ Ù„Ø§ÙŠÙƒ ğŸ™ƒğŸ™ƒğŸ™ƒ
Anderson Diaz LÃ³pez	L bruja noooo
mary vasquez	Ya e 22 y nada de actualizacion ğŸ˜ ğŸ˜ 
Fire Wizard	There wa no update on the 10 22 18
Chetu kulal	When wa update is coming
Lord Faruque	COC u r always best best bestest
Delano Limbo	Where is the update
Raghu Veer Singh. jai.maa.chandi	Kab aayega ye ubdate
GAMING TECH. WITH. ROHITH	trending coc
pratima sinha	No update comeğŸ˜
Yogesh Dhungel	Thia is very much good update thanks supercell
Eduardo HernÃ¡ndez	Â¿DÃ³nde esta la actualizaciÃ³n
ChÃ¢u ToÃ n	ae viá»‡t nam Ä‘iá»ƒm danh
5000 subs without videos ?!	Basically it all about Gem Donation decrease indirectly revenue increaseâ¤´ï¸
vijay luxmi maurya	You fool witch damage decreaseğŸ‘¿ğŸ‘¿ğŸ‘¿
JAN DOMINI CALICA	More town hall
Salt and chilli	Don t need anymore I switched game
Phrase	Where is the update people
best pranks ever	Rip coc
Jesse lin	Dead game anyways lmao
Andrei Fernandez	Please give a townhall 13 in 2019 please supercell please
demoncarp permutation	Whens the october theme coming out
Chepi feryan	SMELLS LIKE CLASH ROYALE
Saroj Kumar	What BUT I THINK THERE WILL BE SOME NEW TROOPS IN UPDATE LIKE YOU KNOW HALLOWEEN S COMING SO SOME HALLOWEEN THEME TROOPS BUT INSTEAD YOU REDUCED WITCH POWER ADD TROOPS
Joshua Armendariz	The eagle artillery kinda pissed me off a little
Lesther Steven Sanchez Flores	Puedo decir q no le entiendo a nada
Imam Hanafi	R I P TOWN HALL 12
Eli Vlogs	Pretty much half of the troop had hem decrease
Mashook machu	Man witch damage should never be down or else she will be a waste Or after she destroys make some raged skeleton troop
BlackKnight	what time is going to be the update
Joey Rohlf	How dare you
Frame Drop	Who care no one play this game anymore
Cristian XD	Que caca lo de la bruja
TheYogibear20	Well we â€™ re waiting
The Rebel	It s 10 22
Ultra Instinct Dekeidric	AHHHHH WTH SUPERCELL
MUTIPLA ESCOLHA	Supercell cadÃª atualizaÃ§Ã£o
WhysoseirousG59 gaming	Make a gold pekka
MCAWESOME 19	Are we going to be able to know what day the update ha been pushed back to
Alon zo	They have 11 min left ğŸ˜‚
QUICKSCOPE 45	I hate all these balance update we don â€™ t need them BECAUSE EVERYTHING IS ALREADY EVEN Like give u a real update for once
Mauricio Saravia	I â€™ m from China and here it â€™ s already October 23 where is the update ğŸ¤”
Evan Smith	It â€™ s 6 30pm on the 22nd WHERES MY UPDATE
BiozZz	What about discouraging rushing retard to level up in the builder base to get a higher advantage against lower bh I can â€™ t get out of my trophy range bc higher BHs keep winning bc I have le building and they have more building
Tatsumaru K	Why you dont update clash of clan
Mr. Partz	Rip xbow
Maycon Silva	Where s the balancing update you said it would be 22 10
Anabella del Pilar	no updatesfor th 9
kerby claro	new wall
David Mailloux Colin	Rejoignez notre clan on accepte tous le niveaux le ashtag du clan dans me commentaires ğŸ‘‡ğŸ¾
GAMER COC	I m waiting 25th update
Ø¹Ù„ÙŠ Ali Ø§Ù„Ø¹ÙƒØ±Ù…ÙŠ alakrame	ØªØ­ÙŠÙ‡ Ù„ÙƒÙ„ Ø§Ù„Ø¹Ø±Ø¨ â™¡
Vlad Borbyliak	Dislike the developer that misinformation is 10 23 2018 Nothing happened Dislike In my top comment so that everyone can see
KnowingRemiel5 _	I hadn t got the update yet
TheRedRaph	This game is getting easier and easier I m playing since when Pekka needed 45 minute to train
AHMED MAHMOUD	I waited 24 hour but did not come update and today is 22 10
MIx	22 10
CaRToN TV	ĞĞ¾Ñ€Ğ¼
Amit Thapa	It â€™ s good
Davey Breedlove	i didnt see tornado trap on there
Luiz Fernando	CadÃª
santiago gonzales	No entiendo el inglesğŸ˜®ğŸ˜®
Matthew Leiren	Thanks
WE GAMERZ	When this update suppose to be released
Ahmed 3RATAN	When UpdateğŸ˜ğŸ˜‘ Today 23 10ğŸ˜’
All Vide	Update 22 10
BroFist Army	NO NO NO DONT NERF THE X BOW THEY MEANT SO MUCH TO ME AS A TOWN HALL 9 NERF EAGLE ARTILLERY NERF EAGLE ARTILLERY NERF EAGLE ARTILLERY NO NERF X BOW OH MAMA MIA
kevin khang	Play this at 1 5x speed Save you time lol
Jean Claude Castillo	That awesome i like the new level upgrade at th10 to the mine the elixir pump and to the Dark Elixir Drill âœŠ thank you so much that the big plus ğŸ”
Ø§Ø¨Ù† ÙƒØ±ÙƒÙˆÙƒ Ø§Ù„Ø§Ù†ÙŠÙ‚	Ù‡Ù„ Ø§Ø¬Ø¯ Ø¹Ø±Ø¨ Ù‡Ù†Ø§
Fighter	La Supercell getiriyorsan getir su gÃ¼ncellemeyi
Rayson Ganura	And yet no balance on nerfed Clock Tower Dissapointing
SHUBHAM SHARMA	Nothing interesting ğŸ˜
Ù†Ø§Ø±ÙˆØªÙˆ Ø£ÙˆØ²ÙˆÙ…Ø§ÙƒÙŠ	Good
los royales	Para cuando ğŸ˜§
Die Dummen Bros	â—
DOGMA TIZM	Ğ“Ğ´Ğµ Ğ¾Ğ±Ğ½Ğ¾Ğ²Ğ»ĞµĞ½Ğ¸Ñ
Shree jala creation	When update coc
hassen karkech	Ø´Ø±ÙƒØ© ÙƒØ§Ø°Ø¨Ø© Ø¹Ù… ØªÙ‚ÙˆÙ„Ùˆ Ø§Ù†Ùˆ Ø§Ù„ÙŠÙˆÙ… ØªØ­Ø¯ÙŠØ«
Ahamed Rifat	Need a BH9 ğŸ˜âœŒ
Black Heart	ğŸ˜±ğŸ˜¨ğŸ˜¦ğŸ˜§
ØµØ¹Ø§ÙŠØ¯Ù‡ Ù„Ø§ÙŠÙ	Ø§Ù„Ù„Ù‰ Ø¨ÙŠØ­Ø¨ Ø§Ù„Ù„Ø¹Ø¨Ù‡ ÙŠØ¶ØºØ· Ù„Ø§ÙŠÙƒ ÙˆÙŠØ¬Ù‰ Ø¬Ù…Ø¨Ù‰
Cheesy1cheese	Those annyoing sound kept going in my head for the next 5 minute
Akbar Pasha	This is going to die
Dragan Vuletic	Today 22 10 and no update why lie
Bleon Jashari	Is the update coming today Supercell
RePz OxYgEnHD	Thanks finally
Paul Designer	where
The Fighters	Where is the update today is 22 10
Mandra34	Quando esce sto aggiornamento
Ryan M.2216	You should make it so TH 9 get like free 100k or so resource like every weekend yes that â€™ s what the collector and mine are for but you see u upper TH â€™ s have expensive upgrade and if you were dumb when you were younger and rushed then you have a lot to recover from
Jay Lo	Are the clan game removed or transitioned to something new I don t see the box where a guy sits on the upper left of the screen
John Smith	Game is dead supercell bury it
Karamjit Bhangu	Super cell lying u about update No update come ğŸ˜ˆğŸ˜ˆğŸ˜ˆ
ĞœĞ°ÑÑ  Ğ ÑƒĞ´Ğ½Ğ¸Ğº	ĞĞ¿ÑÑ‚ÑŒ Ğ²ĞµĞ´ÑŒĞ¼Ñƒ Ğ¸Ğ·Ğ½Ğ°ÑĞ¸Ğ»Ğ¾Ğ²Ğ°Ğ»Ğ¸ Ğ²Ğ¾ Ğ²ÑĞµ Ğ´Ñ‹Ñ€Ñ‹
JoDaMessi 0103	Eagleatillery is too op
MLG Jezus	Where is the update
LORenzO CoC	WHEN THIS UPDATE
Ø¹Ø¨ÙˆØ¯ Ø§Ù„Ø¹Ø±Ø§Ù‚ÙŠ	ğŸ˜’ğŸ˜’ğŸ˜’
King RivorPlate	It â€™ s a trollllll
Shahab farahani	Where is the update now Is say at the end on 22nd of October balance change will come
Mouad Hadiri	When the update ğŸ˜ ğŸ˜ ğŸ˜ ğŸ˜¡ğŸ˜ ğŸ˜¡ğŸ˜ ğŸ˜¡
Ù…Ø­Ù…Ø¯ Ø§Ù„Ø¹Ø±Ø§Ù‚ÙŠ	ÙˆØ§Ùˆ Ø´ÙƒØ±Ø§ Ø¬Ø²ÙŠÙ„Ø§
Steve Eilertsen	Why played Since start well i lost 20 million last timme the dropped the price of Walls today people go all in buy th 12 well allmost all end Quick lower power than u raise Pekka to lvl 200 but he still the same power bad supercercell u just wan na get an reason to make money do all warrior bow witch etc lvl 10 immidetly and throw the greedy game money talk for u to Supercell
ÙƒÙ„Ø§Ø´ Ø§ÙˆÙ ÙƒÙ„Ø§Ù†Ø³	Wheres the update
Rahul Pirwani	Plz best event clash of clan member I have request to you And I have wish listen and you reply me Thank you
Lesterjin Jin	witch got nerfed hope you could put explanation to those change
Mateus Galista RS	Cade a atualizaÃ§Ã£o seus mentirosos
yusuf alghazali	Buff Nerf
SKB legandzz	Sry super cell we r move to another game bye coc lvğŸ˜˜ğŸ˜ pubgğŸ˜‹
Ekmek ArasÄ±	Whan time update Say me please
Hafez Muaz	à¦¸à¦•à¦²à§‡à¦° à¦•à¦¾à¦›à§‡ à¦†à¦®à¦¾à¦° à¦à¦‡ à¦›à§‹à¦Ÿ à¦šà§à¦¯à¦¾à¦¨à§‡à¦² à¦Ÿà¦¿ à¦¸à¦¾à¦¬à¦¸à§à¦•à§à¦°à¦¾à¦‡à¦¬ à¦•à¦°à¦¾à¦° à¦…à¦¨à§à¦°à§‹à¦§ à¦°à¦‡à¦²
sudipto halder	When the update will come
alper kaya	where is update dude
stop pollution	Hi where go your update 20 10 ğŸ¤ª
Antonio Majin	aggiornamento non Ã¨ ancora arrivato bilanciamento come volete chiamarlo Sono rimasto deluso dalla vostra poca serietÃ  e professionalitÃ  del mantenere la parola data A sto punto era meglio scrivere a breve Costruttore fermo per l update che non Ã¨ arrivato oltre al pensierino che ormai mi ero fatto tutto trasformato in delusione e frustazione verso il gioco ancora una volta Dislike al video UTENTE DELUSO
stephon hector	This suck going to stop play this
WoLDeR TV	There is no update
james bond 007	Even Thanos didn t do that much of balancing ğŸ˜•ğŸ˜•ğŸ˜•
Jakub Veber	Balance update in coc After year In Cr is balance every 6 week
A.D GAMER	Nice trops
dilroopvk vk	I quit coc PUBG is life ğŸ˜ğŸ˜ğŸ˜ğŸ˜ğŸ˜
Tanase Mihai	You forgot to release the update ooo it is a bug what a joke so happy that I don â€™ t give money for this game
the believe the judgement day	India koi update nhi AyağŸ˜ ğŸ˜ ğŸ˜ ğŸ˜ ğŸ˜ ğŸ˜ ğŸ˜ ğŸ˜¡ğŸ˜¡ğŸ˜¡ğŸ˜¡ğŸ˜¡ğŸ˜¡
Syed Usman	Please join my clan The Gamerz it ha only two member it is a new clan so thats why i want member plz join it leader name is Clashking
aziz kale 33	Saat 19 45 amk daha gelmedi
Sanjay Coc	Th11 should have siege machine we are not getting siege machine donation becz it is available in th12 only plz supercell include wall walker in th11 so player don t need to rush there base for siege machinesğŸ™ğŸ™
Grevin Ortiz	She wicht ğŸ˜¢
M0EMENTUM	All of this and you still let the little people sleep in the tree and bush smh
Titan Bull 05	I love Valkyrie
Nippe Pelkonen	This game is like clash royale atm Balance Changes
Pedro Quispe	cuando sale la actualizaciÃ³n
gaming with SAT	Oh egal ğŸ˜±ğŸ˜±
Com	Nice prank
THE. GAMER	CLASH OF CLANS AND MINECRAFT IS THE BEST TWO GAMES IN THE WORLD YEAHHH ğŸ’™
ì „ìš°ì˜	NO MY WITCH ã… ã… 
Sabir Zamanli	Uptade
Saqib Arshad	Waoo
devanarayan cs	Can u put a video on how to play clan war league
Quality Low Low	I should start playing the game again I miss the good old day I wonder how the new interface look like
Seth Quinn	Where is the update
Emdadul Huq Milon	22 10 18 today Whr is the f g update
Shihoto Sumi	My only complaint in this game is excessive clouding Please resolve Clouding make me way too impatient to raid ğŸ˜¥
faizzan nakves	JOIN MY CLAN EVOS WARRIOR
Ø¹Ø§Ø´Ù‚ Ø§Ù„Ù…ÙˆØª	ÙˆÙŠÙ† Ø§Ù„ØªØ­Ø¯ÙŠØ«
Bence TÃ³th	Thank you the gold mine elixir collector and drack elixir collector max upgrade higher
Kevork Kevork	When is the update plz tell me
OnO Leno	Will a Halloween update come soon
Falk LÃ¼nenbach	Today
Ayush Tiwari	I have expected some new troop
orges DudeTV	22 10 MARAPT
COC JAAT	When there is coc october update come plz tell
Abdul Sajid	Add a new tesla level too Make the defense stronger especially for air strategy Its th12 And it shouldn t be that easy to 3 star Clan war get draw just like 3 staring the lower THs
Nepali coc gamer	Plz update fast
Sahitya Sekhar Roy	whr is the update
Manas Thakur Rx	Why they nerfed witch and x bow I am a new TH9 What the is thisğŸ˜­ğŸ˜­
Wanderer Ranger	When is update
Thors Helmet TH 6	what time doe the update drop
adnan naemaz	There go all witch related attack
Ashish Sah	A Bhai update kub ay ga
Rishi Tech	JOIN HERE PUNE WARRIORS CLAN TAG URLYVOOJ CLAN JOINING LINK http link clashofclans com action OpenClanProfile tag URLYV00J
Mani Jatt	Update not come still I am waiting
Cricket World	When the update is coming Today or direct on 25
Beko1 Beko1	ÙŠØ§ Ø´Ø±ÙƒØ© ÙƒØ°Ø§Ø¨ÙŠÙ† Ø¹Ù„Ù‰ Ø§Ø³Ø§Ø³ Ø§Ù„ØªØ­Ø¯ÙŠØ« Ø§Ù„ÙŠÙˆÙ… Ù…Ø§Ù†Ù…Øª Ù…Ù† Ù…Ø¨Ø§Ø±Ø­ ÙƒØ³ Ø§Ø®ØªÙƒÙ… Ø¹ Ø§Ø®Øª Ø§Ù„ØªØ­Ø¯ÙŠØ« Ø¹ Ø§Ø®Øª Ø§Ù„ÙƒÙ„Ø§Ø´ ÙƒØ±Ù‡ØªÙˆÙ†Ø§ Ù„Ø¹Ù…Ø§
Preety Gupta	Clash of Clans Update for 22 10 is postponed They didn â€™ t mentioned about when the update would be arriving but most probably it would arrive tomorrow
A.I. Rá´€ÉªÊœá´€É´	When update will start
MD SAIFUL ISLAM	Today is 22 10 18 But We Don t Have Update Why Update is late when will be updated in the game please let me know this day
ĞĞ½Ğ°Ñ‚Ğ¾Ğ»Ñ–Ğ¹ Ğ‘Ğ°Ñ†Ğ°Ğ½Ğ¾Ğ²	ĞĞ´Ğ½Ğ¸Ğ½ Ğ²Ğ¾Ğ¿Ñ€Ğ¾Ñ ĞšĞ¾Ğ³Ğ´Ğ° Ğ²Ñ‹Ğ¹Ğ´ĞµÑ‚ Ğ¾Ğ±Ğ½Ğ¾Ğ²Ğ»ĞµĞ½Ğ¸Ğµ
Dinesh purushothaman	I doesn t like this update especially on x bow damage
ĞšĞ¾Ñ€Ğ¿Ğ¾Ñ€Ğ°Ñ†Ğ¸Ñ Ğ²Ğ¸Ğ´ĞµĞ¾	ĞšÑ‚Ğ¾ Ñ€ÑƒÑÑĞºĞ¸Ğ¹ Ğ»Ğ°Ğ¹Ğº
pedro morais	E Bei no dia do meu aniversÃ¡rio
zXxSWC-_LDR	When will the update release It s 10 22
Ù„ÙˆÙÙŠ_ Ø§Ù„Ù‚Ø±ØµØ§Ù†	Ø§Ù„Ø³Ù„Ø§Ù… Ø¹Ù„ÙŠÙƒÙˆÙ… Ù†Ø´ÙƒØ±ÙƒÙˆÙ… Ø¹Ù„Ù‰ Ø§Ù„ØªØ­Ø¯ÙŠØ« Ø¨Ø³ Ù…Ù…ÙƒÙ† Ø·Ù„Ø¨ Ù…Ù† ÙƒÙ„ Ø§Ù„Ø¹Ø±Ø¨ Ù†Ø±ÙŠØ¯ Ø§Ù„Ø§Ø¹Ù„Ø§Ù… Ø§Ù„Ø¹Ø±Ø¨ÙŠÙ‡ Ø±Ø¬Ø§Ø§Ø§ Ù„Ø§Ù† Ø§Ù„Ø¹Ø±Ø§Ø¨ ÙƒØ«ÙŠØ±ÙŠÙ† ÙŠÙ„Ø¹Ø¨ÙˆÙ† ÙƒÙ„Ø§Ø´ ÙŠØ¹Ù†ÙŠ Ù†Ø±ÙŠØ¯ Ø§Ø¹Ù„Ø§Ù… Ø¹Ø±Ø¨ÙŠÙ‡ Ù…Ù…ÙƒÙ† Ø§Ù„Ø±Ø¯ Ø¨Ø³Ø±Ø¹Ù‡
Elijah.lÃ¶bbe	I thought it come Today
NeTo GaMeR	WHATTT HAPPEN WITH THE UPDATE CMON SUPERCELL THE VIDEO SAY 22 10 IN THE GAME ARE 2 EVENT MORE CMONN
_crayu 05	Hour
Teju Singri	Superb
Naveen Boss	They should reduce some training time
Khalid 88	Today is 22 were is the update
ĞšĞ¸Ñ€Ğ¸Ğ»Ğ» ĞĞ½Ğ¾Ñ„Ñ€Ğ¸ĞºĞ¾Ğ²	ĞÑƒ Ğ¸ Ğ³Ğ´Ğµ Ğ¾Ğ±Ğ½Ğ¾Ğ²Ğ»ĞµĞ½Ğ¸Ğµ
Raunak Dayma	WHERE S UPDATE
De Gamingboys	Why ist not comming
marwan hassan	Shitty update
Hari Haran	When did the update the community said that new update is 22 today is 22 but where is the updateğŸ˜µğŸ˜µğŸ˜µğŸ˜µ
Dai Pham Van	why not update so Ad
Gui Li	22 10 When am waiting
Tmjon	This way much better than Blizzard patch note
rahul jindal	when will it come today
WAR GAMING	Update nahi aaya
shoukat ali	there is no loot at town Hall 12 you just pooped on your self with your last update
ÙˆØ§Ø¦Ù„ Ù…Ø·ÙŠØ¹	Ù„Ùˆ Ø³Ù…Ø­ØªÙ… ÙŠØ§ Ø´Ø±ÙƒÙ‡ Ø³ÙˆØ¨Ø± Ø³ÙŠÙ„ Ø¨ØªÙØ¹Ù„ÙˆØ§ Ø§Ù„ØªØ­Ø¯ÙŠØ« Ø§Ù„ÙŠÙˆÙ… Ø§Ùˆ Ù„Ø§ Ø§Ù„ÙŠ ÙŠØ±ÙŠØ¯ Ø§Ù„ØªØ­Ø¯ÙŠØ« ÙŠÙ†Ø²Ù„ Ù‚Ø±ÙŠØ¨ Ù„Ø§ÙŠÙƒ ğŸ˜˜
Emre Erdal	Nerde kaldÄ± bu gÃ¼ncelleme
Aqib javid	what about update timee because now 22 oct is going to end i think they are making all of u fool by showing 22 10
Ø§Ù†Ø¨Ø±Ø·ÙˆØ± Ø§Ø¶Ù„Ø§Ù…	Ù…ØªØ§ Ø§ØªØ­Ø¯ÙŠØ« Ø´Ø¨Ø§Ø¨
THE MAGIC WORLD FOR TAMILANS raghul	When update is come all the player rock
TAMILAN DA 1234	Ouch ğŸ˜¨ what x bow power ğŸ”‹ reduce
M Z	Sup
VlaDuTz	Today is the update guy
preet soni	Which time we get update
AdÄ±m Groot	22 10 Ne zaman Gelecek Bu GÃ¼ncelleme
Sahil Bhandari	Plz speak about fixed date of upcoming new update in clash of clains
MOHAMD GAMER	Where update
movie maker tech	Pls for dragon also
THE JOKER	now i hate witch
Maestro body	Ø§Ù„ØªØ­Ø¯ÙŠØ« Ù…Ù†Ø²Ù„Ø´ Ù„Ù‡
nagesh nv	Where is the 22 10 update
Ù…Ø¯Ø±ÙŠ Ù…Ø¯Ø±ÙŠ	Yala we still have the update
Ù…Ù†ÙˆØ¹Ø§Øª hamza	Ø§ÙŠÙ…Øª Ø§Ù„ØªØ­Ø¯ÙŠØ« Ù„Ù‡Ù„Ù‚ Ù…Ø§ Ø·Ù„Ø¹
merve Akyildiz	This day is not Uptadt clashofclans
Neymar Jr	When will the update come
Too Sweet	Waiting for the update ğŸ˜ Who is exited ğŸ˜ğŸ‘ğŸ‘ğŸ‘
ROYALE GAMING	Ø´Ø¨Ø§Ø¨ Ù‡Ø¯Ø§ Ø±Ø§Ø¨Ø· Ø§Ù„ØµØ¯Ø§Ù‚Ø© Ù„ÙŠ ÙŠØ±ÙŠØ¯ ÙŠÙƒÙˆÙ† ØµØ¯ÙŠÙ‚ÙŠ Ø¨Ø§Ù„Ù„Ø¹Ø¨Ø© http alfnkoush com ZTGtCb4V
Saksham Tripathi	When is the manual selection of troop in battle are coming
ibrahim Haj ali	Where is the update of today ğŸ˜¡
Luis avalos	The video say October 22 we are at 22 and there are no balance change
Rahul Roy	Awesome
Jonas Roeles	What time come it
kahinor kha	No not the 3rd inferno tower It s totaly unbalancing
TrÃ o LÆ°u Hot	Viá»‡t nam Ä‘Ã¢u rá»“i
Zilender Bhar	when it will come
Ahmed Saber	Update clash of clan
Premlata Sinha	Nice but somewhere bad like witch giant X bow etc
NEXT LEVEL PLAYER	Is it 22 10 19 Or 22 10 18 ğŸ˜‚ğŸ‘Š
Enis Gamer TV	22 10 doe this mean today will be the update
JS GAMING POINT	When it s coming
Sergioman sainz	A que hora sale la actualizacion en espaÃ±a
Hamid Hussain	thx u clashofclans
mbrwk fox1	Ø´Ø¨Ø§Ø¨ Ø§Ù„ØªØ­Ø¯ÙŠØ« Ù…Ø§ Ù†Ø²Ù„ Ø§Ù„Ø¹Ø¬ÙŠØ¨Ù‡ Ø§Ù„ØªØ­Ø¯ÙŠØ« ÙŠØ¶Ø¹ Ù„ÙŠÙƒ
MARK AN	It â€™ s not came out yet
ØµØ§Ø¯Ù‚ Ø§Ù„Ø¨Ø¯ÙŠØ±ÙŠ	Ø´Ù†Ùˆ Ø§Ù„Ù…Ø¹Ù†Ø§
Azeem Khan	Guys kab aaege new update date to btao
Ù‡Ø§Ø¯ÙŠ ÙƒÙ„Ø§Ø´ Ø§ÙˆÙ ÙƒÙ„Ø§Ù†Ø³	Ø§ÙŠ Ø³Ø§Ø¹Ø© Ø§Ù„ØªØ­Ø¯ÙŠØ« Ø´Ø¨Ø§Ø¨
CraZZy	Ğ­ĞºÑĞºĞ»ÑĞ·Ğ¸Ğ²Ğ½Ñ‹Ğµ Ğ½Ğ¾Ğ²Ğ¾ÑÑ‚Ğ¸ Ğ¾Ğ± Ğ¾Ğ±Ğ½Ğ¾Ğ²Ğ»ĞµĞ½Ğ¸Ğ¸ Clash of clan ĞºĞ¾Ñ‚Ğ¾Ñ€Ñ‹Ñ… ĞµÑ‰Ğµ Ğ½Ğ¸Ğ³Ğ´Ğµ Ğ½ĞµÑ‚ Ñ‚Ğ¾Ğ»ÑŒĞºĞ¾ Ñƒ Ğ½Ğ°Ñ Ğ² Ğ³Ñ€ÑƒĞ¿Ğ¿Ğµ http vk com neexs
Rohan Tellis	Is the clash rama over
Alpha - Onur Acar	Buda mÄ± enflasyonlaTğŸ‡¹ğŸ‡·yekÃ¼nmÃ¼cadele
R Researcher	I lost to attack today
devansh khanna	Does this mean update come today
zaid1234 kayali	Your update it s a lie
G R F	Whwre is the update
Honda5353 Honda5353	Hello why update is not come on 22 october
Jesus H Henriquez	Tremenda mentiraaaaa no actualizaronnnn
Mouhannad Abude	Thx for decreasing the Golem
ÑÑ‚ÑƒĞ± ĞºĞ°Ğ½Ğ°Ğ» Ğ¿Ğ¾ ĞºĞ»ĞµÑˆ Ğ¾Ñ„ ĞºĞ»ĞµĞ½Ñ ÑÑ‚ÑƒĞ±	Ğ Ğ°Ğ·Ñ€Ğ°Ğ±Ñ‹ ÑĞ´ĞµĞ»Ğ°Ğ¹Ñ‚Ğµ Ğ¿Ğ»Ğ¸Ğ·Ğ· ÑĞµĞ³Ğ¾Ğ´Ğ½Ñ Ğ¾Ğ±Ğ½Ğ¾Ğ²Ñƒ Ğ²Ñ‹ Ğ¶Ğµ Ğ¾Ğ±Ğ¼Ğ°Ğ½Ñ‹Ğ²Ğ°ĞµÑ‚Ğµ Ğ»ÑĞ´ĞµĞ¹ Ğ±Ğ°Ğ³Ğ¸ Ğ¿Ğ¾Ñ‚Ğ¾Ğ¼ Ğ¸ÑĞ¿Ñ€Ğ°Ğ²Ğ¸Ñ‚Ğµ
Ğ¡ĞĞĞ¯ ĞŸĞ ĞĞ”ĞĞšĞ¨Ğ!	R I P X Bow
samer monla	ÙÙŠ Ø§ÙŠ Ø³Ø§Ø¹Ø© Ø³ÙŠØªØ§Ø­ Ø§Ù„ØªØ­Ø¯ÙŠØ« ØŸØŸ
legendary gamer	Why are you killing the witch
LoganPlayz	No
je	Update iOS 22 Android 23 ğŸ˜¥ğŸ˜‚ de Supercell tho
ØªØ·ÙˆØ±Ø§Øª Ø§ÙƒÙ„Ø§Ø´	ÙˆÙŠÙ† Ø§Ù„ØªØ­Ø¯ÙŠØ«
TimoRoyale	Guys please Supercell spends alot of time thinking about balance change and they finally released it and like 50 of the people dont understand the nerfes Just c mon I am happy with the update Opinions can be shared i know but it s NEVER good I always see people begging bout training time reduce buff nerfes new level Let s just be agreed with these change maybe we dont hear too much about witch being too overpowered Or X Bows being too annoying But maybe they ARE And whats the problem about gem donation reduce Just be HAPPY I feel like i am the only one who understand it ğŸ˜• I also feel a bit sad for Supercell Hard thinking for new exciting update but always see begging player who aren t agreed with it or the beggers are just people who don t understand anything
Goutam Ray	22 10 wow it s my birthday ğŸ˜±
_Alex _	ĞšÑ‚Ğ¾ Ñ€ÑƒÑÑĞºĞ¸Ğ¹ ÑÑ‚Ğ°Ğ²ÑŒ Ğ»Ğ°Ğ¹Ğº Ğ¸ Ğ¿Ğ¸ÑˆĞ¸ ĞºĞ¾Ğ¼ĞµĞ½Ñ‚
Ø³Ø¬Ø§Ø¯ ÙƒØ§Ø¸Ù…	Ø§Ù„Ø³Ø§Ø¹Ù‡ ÙƒÙ… Ø§Ù„ØªØ­Ø¯ÙŠØ« Ø§Ù„ÙŠÙˆÙ… Ù…Ù…ÙƒÙ† Ø¬ÙˆØ§Ø¨
KHUSHAL	Plz up kro
BAD BOY	Kab aygaya upded ğŸ˜€ğŸ˜€ğŸ˜€
Nihad Koth	Please do training time reduce
Giovanni 07	22 10 2018 nessun segno dell aggiornamento
MAJOR BLADE	Glad to see they are rapidly working on coc proud of u supercell ğŸ˜€
Maari Single	When update is coming
zaino/// YouTube	Ø§Ø·Ù„Ù‚Ùˆ Ø§Ù„ØªØ­Ø¯ÙŠØ« Ø§Ù„Ø¬Ø¯ÙŠØ¯ Ù…Ùˆ Ù…Ù„ÙŠÙ†Ø§
RaKesH 765	Clash of clan user Decreasedâ¬‡ï¸
alby ts2015	ğŸ˜¨ğŸ˜¨ğŸ˜¨ğŸ˜¨ğŸ˜¨
pickyalex1	I thought this wa gon na come out today
Ø§ÙÙ’Ù„Ù‘Ø®ÙŠÙØ§ÙÙ’Ù„Ù‘ siraje	Ù‡Ù‡Ù‡Ù‡Ù‡ ÙƒÙ„ Ø´ÙŠ Ù…Ø§ÙØªÙ‡Ù…Øª
hunter x hun	ThÃ© update IS tomorow
Techno Gamer	Where is the update of today
sohil mohite	Update date
Area 51	no no diminuire il danno al secondo al arco x non va giÃ  l avevano diminuito una volta basta poi troppo facile che ti arano
Tukang Cendol	How about Warden s change mode attack on war Can u just make it like CC that can change the mode from regular to ram or blimp As simple a that and no one in SC realize that thing
Diamond King	Nice
chameleon	Ğ­Ğ¹ Ğ²Ñ‹ Ñ‡Ñ‚Ğ¾ Ğ’ĞµÑ€Ğ½Ğ¸Ñ‚Ğµ Ğ²ĞµĞ´ÑŒĞ¼Ğ°Ğ¼ ÑĞ¸Ğ»Ñƒ
Alaa Nassef	Ù„ÙŠÙ‡ Ø§Ù„Ø³Ø§Ø­Ø±Ù‡
vimala muthu	But I don t like witch hitpoint and damage per second is decrease ğŸ˜ğŸ˜ğŸ˜ğŸ˜ğŸ˜ğŸ˜˜
sukh khaira	When the update is coming
Hardik Mehta	It is saying 22 10 but what are the timing
ElectricZap	Why nerf the wich
HARI PRASATH	ANY FORMER CLASHERS HIT LIKE IF U ARE
Juan Samue	Dont upgrade witch
Arbnor Bytyqi	Yesssssss ğŸ˜ğŸ˜ğŸ˜
Classy Games	NYC video
Spread ch	Excellent
Shawn Devera	Why the witch is weak now
King Ahmed Ø§ØºØ§Ù†ÙŠ Ø´Ø¹Ø¨ÙŠÙ‡	Ø§Ù„ÙŠÙˆÙ… 10 22 Ù…ÙÙŠØ´ ØªØ­Ø¯ÙŠØ« ğŸ˜“ğŸ˜“ğŸ˜“ğŸ˜“ğŸ˜“ Ø§Ù†Ø§ Ù…Ù†ØªØ¸Ø± Ø§Ù„ØªØ­Ø¯ÙŠØ« Ø¹Ù„Ù†Ø§Ø±
Skull Gamer	Guys come to 2k18 PUBG ğŸ˜ğŸ˜˜ Watching this video make me laughter ğŸ¤£ğŸ¤£ğŸ¤£ğŸ˜‚ğŸ¤£ğŸ¤£ğŸ˜‚ğŸ¤£ğŸ˜‚ğŸ¤£ğŸ˜‚ğŸ¤£ğŸ˜‚ğŸ¤£ğŸ˜‚ğŸ¤£ğŸ˜‚ğŸ¤£ğŸ˜‚ğŸ¤£ğŸ˜‚ğŸ¤£
Azad Abdurzayev	Bu ne diki bele yani
Ù…Ø±Ø§Ø¯ Ø¥Ø¨Ø±Ø§Ù‡ÙŠÙ…	Ù„Ù„Ø­ÙŠÙ† Ù…Ø§Ù†Ø²Ù„ Ø§Ù„ØªØ­Ø¯ÙŠØ« Ù…ØªÙ‰ ØŸØŸ
roshni gopal	22 10 2018 no sign of update
Azar Khan	Plz decrease the cost of pekka and dragon ğŸ™
Pal lob	I love witch So why there is so many change
Windlix K&F	Still waiting for the upgrade
manda back	When is the update
Govind Rajan	Boss game wa not updated pls update u tell update today but not maintenance pls fast
Aashish Pal	The update is not coming
ThÃ nh Gaming	X bow Nooooooo
YUTUB FENOMENÄ° YUTUBER	Bu ne anlamak ikin yoruma bakanlar1
KrisFederer	Today is 22 10 Where is the update liar
Little mallow	Clash of clan suck
Just Gamin	Nithing update
Musa Bayrak	Where is update
Computer Made vedios with science materials	They mentioned 22 10 but the time is 21 10 so update is today
Elmer Cataros	Im a gamer nice
bonumidol team	Why super cell you decrease the damage of the x bow I dont care of if there tropps to nerf but why the x bow gdluck th9 easy 3star
ma gamerz	Games very good i like this ğŸ‘
Anil Deshmukh	111
Tdyyg5 G6f4yfhf	Clock
neon Ving	I hate coc
harshit singh	Still play coc ğŸ‘ğŸ˜‘ğŸ¤¨ğŸ˜…ğŸ˜‚
Manikanta Reddy	What about miner No change ğŸ˜¤ğŸ˜­ğŸ˜­ğŸ˜­
Memes tube	Cool
Saeed Sam	update now plea
Ù†Ø¬ÙˆÙ… Ø§Ù„Ø¹Ø§Ù„Ù…	ÙŠØ´ØªØ±Ùƒ
ÙƒØ±Ø§Ø± Ø§Ù„Ø¬Ø§Ø¨Ø±ÙŠ	Good
Shaif Ullah	They re turning it into a defence meta again
Riko Bruce	I DONT LIKE THE THIRD INFERNO
HS Gaming King	great change but it would be great if electro dragon training cost wa reduced
Kritic GamING	10 like and i will tell u to do that
ÏŸÏŸ PanzerShafter ÏŸÏŸ	Witch Getting NERFED
DeathDrone MCPE Gaming Indonesia	why x bow nerfed x bow is useless and you nerfed the x bow how useless the x bow after update 0 damage or 9999 damage huh you can just buff the bowler s hitpoint he is very squishy and you nerf the witch how useless is she now i dont care la
WORLD OF GAMING	Wow halloween update 22 10
the tecnical gaming	Nobody donates with gem
NdeyenG Comunity	Im from INDONESIA
Ø£Ø­Ù…Ø¯	Ù…ØªØ§ ÙŠØ¡ØªÙŠ Ø§Ù„ØªØ­Ø¯ÙŠØ«
Shoaib Nadeem	Witch is very strong
Hayds 126	Damn buff all the high th stuff but nerf the stuff for lower player Getting 3 star at th9 is so easy
Ø­Ù‹Û’Ù€Ø³Ù‹Û’Ù€Ù†ÙŒÛ’Ù€ Ù±Ù„ÙØ¹ÙÛ’Ù€Ø±Ù±Ù‚ÙÛ’Ù€	When
Jaydip Kalekar	But this game is literally dead
Ravi Ravi	When we get this update
Nitin s	In short game is dead
Krish 007	Yeah supercell Coc is best game I love coc and superce
Suma Gurudutt	Does someone know when will the update come
hasan engin	sÃ¼percell nerde gÃ¼ncelleme bugÃ¼n gelcekti ne oldu
Bijendra Singh	thank you supercell
Ayush Singh	Man don t decrease lvl 1 and 2 witch I have just unlocked them
K.balakrishnan P	thx coc
Yuvraj Bansal Uv Bansal	Thanks supercell for this
Chandan Rapper	It is not still updated I am waiting
Redstone Channel	Ai vn
Ravinder Chib	COC is the best game
ãƒƒPresto	Rip witch slap
Yadhu Krishna	LetsSaveGems lol
Suraj Kumar	ANY DONET ME GEMS
jc denton	Why would you nerf lvl 1 3 xbows It â€™ s the only good defence th9 ha
_DorianGames_	Today
Dario Sidari	At what time this will be available
Ahosanul Kabir	When clash of clan balancing update
Bro tech ZGamers	why did you nerf the witch
All in One	When update come
Bikash Dorothee Official	This update is going to come on 22 Oct
mx movie	Update time plz
Arman Malik	Abe yar witch ki too what LG gye my fav player ye glat hai
Abdul Wahid Chishti	Bro I want high clan only
Wasim Phu	Why they have to nerfed the xbows tho
AlbTech	Is the uptade coming today
Deutsches Vollkornbrot	Finally new mine level and new goblin lvs these are thing i have waited so long for but the rest is just not needed sorry for my bad englisch
ANDRA GAMER OFFICIAL	Whats a tornado trap
aimen asmaael	Ù„ÙŠØ´ Ù…Ø§ ØªØ¬ÙŠ ØªØ­Ø¯ÙŠØ¯
AKE The Pr0	Can you add something like when a co lead or lead want to kick a player other member can vote except you cause I m active but some player like to kick every single elder like meğŸ˜‚ğŸ˜‚lol
Saroj Devi Yadav	Plz decrease dragon cost
Marlenka 677	ITS TODAYYYYYY
Multikumar Tech	We need that we donate gem and elixir
Saif Khan	The most I like is the seige machine updateğŸ˜ğŸ˜ğŸ˜ğŸ˜
sree jai krishnan	Please tell me update date 22 10 is today but don t show update noification today what happens
KING KJC	à®‡à®¤à¯ à®µà¯‡à®±à®¯à®¾
PHANTOM KRIS	When is the update
Ahmed Aziz	Ù„ÙŠÙˆÙ… ÙŠØ¬ÙŠ Ø§Ù„ØªØ­Ø¯ÙŠØ«ğŸ˜€
lalit kashyap	Why Witches Got Nerfed ğŸ˜Ÿ
We show you tube in i think today and do it Beam	I so happy tomorrow uopdate 22 10 18 thank you for update tomorrow i want be today update
PRATIM NANDY	What about new troop
MURID BIASA	wow amazing the nerf of big
Abid Hassan	When the update come i want to play so fast
Abdul moiz Khan	When did the update is coming new update is coming on 22 but not why
King Lee	nooooooooooo why this happen damage reduced for witch
RA P	Agar nahi hua to
jobanjeet 0001	When update please tell me
Em Monn	AE VIá»†T NAM ÄÃ‚U Rá»’I
eraZure	â€œ Balance â€ change A pretty inaccurate title unless you â€™ re trying to ruin any already existing balance
Ajay Singh	pls reduce electro dragon cost and time
Nittin Khajuria	brilliant supercell
Sarita Verma	O yea
Mahmoud Lahham	When will the update released
Michael Jordan	ha anyone ever said damn the witch is overpowered i dont get why your nerfing her
Farhaan Khan	Please launch new troop for lower townhalls
Kuma Gamer	I WANT UPDATE THE PEOPLE CAN GIVE MONEY ELIXIER AND DARK ELIXIER WHO SUPPORT ME
coc tv	As came th 13 please
Sudhanshu Kumar	decrease price of lava
karmendra srivastava	I m in clash royale Wait balanced update in Coc I don t care
saad elaty	Thank you super sell
KWENGAMEZTV 0_0	à¸ªà¸´à¸­à¸±à¸šà¹€à¸”à¸•à¸•à¸­à¸™à¹ƒà¸”à¸¥à¹ˆà¸° à¸šà¸±à¸à¸«à¹ˆà¸²à¸‚à¸±à¹‰à¸§ à¸‚à¸´à¸„à¹‰à¸²à¸™à¸—à¹‰à¸²
NOISY BOY	Is the update Relasing Today
Mohammed Salah	Ø§Ù„ØªØ­Ø¯ÙŠØ« Ø§Ù„Ù…ÙØ±ÙˆØ¶ ØºØ¯Ø§ Ø§Ù„ÙŠ Ù‡Ùˆ Ø§Ù†Ù‡Ø±Ø¶ Ø§Ù„ØªØ­Ø¯ÙŠØ« Ù…Ø´ Ù†Ø²Ø§Ù„ Ù„ÙŠÙ‡
Mehul Rawat	Plzz tell me upgrad time
nicky freefire	i thing it small update
SAJID Saad	wow
Ù…Ù†ÙˆØ¹Ø§Øª ÙÙ‡Ø¯ Ø§Ù„Ù„Ù‡ÙŠØ¨ÙŠ	Ø§Ù…Øª Ø§Ù„ØªØ­Ø¯ÙŠØ«
MC Mikey	Why the Xbows
Nahid Tube	0 47 ğŸ˜›ğŸ˜›ğŸ˜‚
Yooo King	Best thing is the zip of siege 30xp
Anil Gupta	Yaaha hu Cost down
MD RAHAT	please give Bangladeshi flag in this please please
coc hacker	Update kb ayega
DAxe4Life	pls stop this is the 3rd nerf to xbowğŸ˜¿
Carlos Rodriguez	When is the update
Jamus Lorenzo	yes i like it
Sudipta Laha # email.Sudipta.Laha[at]GMail	TH13 ğŸ˜²ğŸ˜²ğŸ˜²ğŸ˜²
sultan malik	what is new troop
X XpeK	c est quand la maj qorry i don t speak english
nayla 01	1 31
Ac SkulZz GaMiNg	When the update of coc It is today Anyone tell me
Maya Rawal	Superb update
Ø³Ø¬Ø§Ø¯ Ø§Ù„Ø¹Ø¨Ø³Ø§ÙˆÙŠ	Ø§Ø±ÙŠØ¯ Ù„Ø§ÙŠÙƒ
Nityananda Bayen	When coc finish now coc is boring game please stop upgrade please
Eric Zavala	Lmao when they release a whole video but don t even show the number of what s buffed or nerfed
Night Great	Just copying Clash Royal balance change video even portrait mode Rip coc Dead game
Dragon Lord	Ğ”Ğ°Ğ¼ Ğ¤Ğ¸ĞºÑĞ°Ğ½ÑƒĞ»Ğ¸ Ñ‚Ğ°Ğº Ñ„Ğ¸ĞºÑĞ°Ğ½ÑƒĞ»Ğ¸
Quang Huy Tu	I need my witch back
Gautam Singh	Why hell did u nerf witch Supercell u suck
tayef tayef	22 10 clan Wars not coming come y please give u the clean what
Ğ”Ğ¸Ğ¼Ğ¸Ñ‚ÑŠÑ€ Ğ”Ğ·Ğ¸Ğ¼Ğ±Ğ¾Ğ²	yeah I can produce more machine in the same time period
asmina parvin	Nice update kB Hoga yar
Aadarsh Kumar	Which one do u choose Like for Clash of Clans Comment for Clash Royale
HOUSE FULL	Electro Dragon is attack very slow WHY
biel-WM MT	Mgnificent
Argin Dionisio	Please reduce the training cost of PEKKA AND DRAGON And please remove the building time of hero They must be instantly upgraded within a second Please
Rick Sanchez	You only decreased the dark barrack troop not fair every thing get decreased after th9 not th8
Munib Shaikh	Hmmmmm
Irodoku Puzzle	I wonder what happened to my 3 year old TH10 village I let behind 18 month ago
Elite Up	13 lvl wall more look like 3 lvl lol
Afjal Soad	is the update coming today
Fernando Romera	Excellent way of providing information
technically yt	Oh it is very bad ne for th 9 that exbow hit decrease
All In one	Nice
Maruf Raunak	See the last picture coc balance update 22 10 it mean coc halloween upate will come 22 october 2018 ğŸ˜‰ğŸ˜‰
Zhalgas Bekiyev	Clash of Clans ğŸ‡°ğŸ‡¿
MY HOME	Game kebanggan 2013
Is Zul	I need a daily reward please sc ğŸ™ğŸ™
ĞÑŒÑƒÑ€Ğ³ÑƒĞ¹Ğ°Ğ½Ğ° Ğ¢Ğ¾Ğ»ÑÑ‚Ğ¾ÑƒÑ…Ğ¾Ğ²Ğ°	Wow ÑÑ‚Ğ¾ Ğ¾Ñ‡ĞµĞ½ÑŒ ĞºÑ€ÑƒÑ‚Ğ¾Ğ¾Ğ¾Ğ¾Ğ¾Ğ¾Ğ¾Ğ¾Ğ¾
Santi Brie	The best game for ever
Nilesh Dhole	Update kab hai
Xadous	GEm DoNAtiON DecREaSed
Soumyajit Manna	Is Clan War League totally replace Clan War s
bagus0134 palwa0134	Can you beat my village
Manoharsinh Sodha	We need new builder hall and new hero in builder base
snehashis saha	kab update ayga
Rajesh Dasari	Wbt war league included in this update
Digendranath Roy	ğŸ˜ğŸ˜ğŸ˜ğŸ˜ğŸ˜ğŸ˜ğŸ˜ğŸ˜ğŸ˜ğŸ˜ğŸ˜
Drayton Martinez	OK I ge
sara. mosawe	Ù„Ù… Ø§ÙÙ‡Ù… Ø´ÙŠØ¡
Naman Vora	SuperbSupercell
*jhoiner* G.T.LTM	free fire
Dipen Dai	Valks should decrease training elixer
Arun kumar	Can t wait
Technical Master	When will be the clan war league update come
Robo	It s good but why buff eagle artillery it s one of the strongest defence
random royale	This wa just a clash Royale thing wasn t it ğŸ¤”
NucleaR Gaming	will it be realesed today 22 10
Pratish Shrivastva	Why u reduce witch damageğŸ˜­ğŸ˜­ğŸ˜­ğŸ˜­ğŸ˜­
Spicy Man	Cant wait
Matthew Higginbotham	good update
Curtis Stevens	What is gem donation
Priti Agrawal	When the update will be done Pls supercell do it fast
Laltu Ghosh	When the upgrade relise
NiXer	0 23 best moment in my life
Christopher Bolquerin	The balloon should have had been reduced it way to high but yay thanks guy for the update
Ğ’Ğ¸Ñ‚Ñ ĞŸÑ€ÑƒÑĞ°ĞºĞ¾Ğ²	Ğ Ğ²Ğ¾ ÑĞºĞ¾Ğ»ÑŒĞºĞ¾ Ğ¾Ğ±Ğ½Ğ¾Ğ²Ğ»ĞµĞ½Ğ¸Ğµ
AD PLAY GAMES	Donation gem decrease and Siege Donate XP increased AWESOME
LiÃªm Pháº¡m Nguyá»…n ÄÄƒng	Gem balanced
NO PLAN A no plan a	Ğ­ÑÑÑÑÑ ĞºÑ‚Ğ¾ ÑÑ‚Ğ¾ Ğ¾Ğ±Ğ½Ğ¾Ğ²Ğ»ĞµĞ½Ğ¸Ğµ Ğ´Ğ»Ñ 10 12 Ñ‚Ñ… Ğ° 9 Ğ´Ğ¾Ğ»Ğ¶Ğ½Ñ‹ ÑÑ‚Ñ€Ğ°Ğ´Ğ°Ñ‚ÑŒ Ğ¸Ğ· Ğ·Ğ° Ñ„Ğ¸ĞºÑĞ° x bowl
Timothy Suryanto	Please increase Ballon HP for every level
SiHeX	ĞŸÑ€Ğ¾ÑÑ‚Ğ¾ ÑĞ¼Ğ¾Ñ‚Ñ€ĞµĞ» Ğ½Ğ° ÑÑ‚Ñ€ĞµĞ»Ğ¾Ñ‡ĞºĞ¸ Ğ½Ğ¾ Ğ²ÑĞµ Ñ€Ğ°Ğ²Ğ½Ğ¾ Ğ½Ğµ Ğ¿Ğ¾Ğ½ÑĞ»
peace of mind tv	Awesome
TRAM&ZYRIZ ROS	Is this an halloween update
Natsu Fullbuster	Please decrease the wall upgrade price
Ñ‡ĞµĞ»Ğ¾Ğ²ĞµĞº Ñ Ğ¸Ğ½Ñ‚ĞµÑ€ĞµÑĞ½Ğ¾Ğ¹ Ñ„Ğ°Ğ¼Ğ¸Ğ»Ğ¸ĞµĞ¹	Ğ’ÑÑ‘ Ğ½Ğ°Ñ…ÑƒĞ¹ Ñ‚ĞµĞ¿ĞµÑ€ÑŒ Ğ²ĞµĞ´ÑŒĞ¼Ñƒ
Pushprajsingh Rao	Thanks supercell
Joshua Sam	hate supercell nerfing witch wichslap th9 is dead
Ğ¢Ğ¸Ğ¼Ğ¾Ñ„ĞµĞ¹ Ğ¢Ñ‹Ğ¼Ñ‡ÑƒĞº	Ğ—Ğ° Ñ‡Ñ‚Ğ¾ Ñ Ğ²ĞµĞ´ÑŒĞ¼Ğ¾Ğ¹ Ñ‚Ğ°Ğº
Jimmy Fonseca	Constructor 6 para cuando
Swaggr Fox101	So thats on monday
NiÃ±orata Caca	Por q le bajan ala brujaa
Reuben Dey	What about the war league
Ù†Ø¬ÙŠØ¨ Ø§Ù„ÙŠÙˆØ³Ù	ÙˆØ§Ù„Ù„Ù‡ Ù†Ø§Ø± ğŸ”¥ Ø¨Ø³ Ø§Ù„Ø³Ø§Ø­Ø±Ø© Ø¸Ù„Ù…ÙˆÙ‡Ø§
Rakesh creations R&C	updation day
Aditya mishra	What is the date of the updated version of clash of Clans
Nickolai Mohammed	When is the update coming out
mohith kashyap	Update releasing time
bangla Islam	great
very noob	reduce electro dragon
Hugh Jass	They already nerfed the xbow once this year now they re doing it again Damn It s a weak defense enough a it is And I have level 4 which is the highest for th10 Doesn t make sense You would think they d give it more hitpoints or something since they just have to take away from it s already mediocre damage
thecaptain	Make a seperate army camp for donation instead ğŸ‘Œ
DIEGO FERNANDO VELA BENITEZ	1 49 100 news wall for th 13
ShyToad	Please let Giant Skeleton be a permanent troop
Siddharth Sahu	Today s date is 22\10 but I don t found the update
rickycito Intro	No entendi nada no se ingles alguien q m explique
Christian Dacaymat	How many time I ve heard that word balance on the update people adopts and find new way again another balance people s are smart and supercell failed
D tamizh	who care ğŸ˜ğŸ˜
SavageHeroGamer Yash	Yay
Exhaviz	Hold up who still play this
clash of clans gamer	east or west clash of clan is thr best
Funny and WWE videos channel mehra	Make clash a rama new episode
Es Es	How come is that suppose to be a balance update
Fly High	What time is it coming out
blizzard dude	Well the witch is now useless so
Gaming With Chappell 12.5	Awesome Can t Wait For The Update Especially the collector and thing unlocked at th12 because there is barely anything unlocked at th12 THANKS
Harsh Choudhary	When is this update coming The exact date
Shital Subedi	Wow
andre Farhan	Auto install again
SH SHAWN	I like the update
emr coc	When come Halloween update
Charmaine Carey	Just what we need another buff for the eagle artillery and another nerf for the witch just wonderful supercell you really now how to hit your player where it hurt
Jozeph. R	Baia todo baja hasta lo q ella siente por mi v
Edwar Espinoza	Nooo why witch but the rest iys fone but why witch
Nighter Zack	Thumbnail not 22 10 it s 21 10
Nikson Siyam	New update ğŸ˜
Manny the Miner	I anticipated a 3rd inferno Tha k super cell Been playing for 5 5 yearsğŸ’ª hope to keep playing more and more Hope it brings more clashersğŸ’ªğŸ’ªğŸ’ªğŸ’ª
Sengz Asg	Very excited for updated
Layankit Layankit	Clash of clan is best game in the world
good guy	please don t decree witch DPS and hitpoints
Random Android	Baby drag builder or normal
Harisankar Sethi	Wow
ã²ã¿ã£ã¡ã‚ƒã‚“	ã™ã£ã”ã„åˆ†ã‹ã‚Šã‚„ã™ã„
MasterCarmine4	MaÃ±ana e la actualizaciÃ³n
PRIYANSHU PHUKAN	CARRY ON SUPERCELL
Zekariah Coolong	Nooo Stop nerfing the witch
Ikbal Mohammad	when will the hellowen update come i m waiting for that and i cant wait any fortherğŸ˜‘ğŸ˜‘ğŸ˜‘ğŸ˜’ğŸ˜’ğŸ˜’
Justin Eze	Rip Witch ğŸ˜”
Deepankar Shakya	Why witch health reduce
GAMING WITH GUARDIAN	Wow Balance Update Clash Of Clans
Maan Singhchauhan	On what date are you launching update And can you give 500gems to me plz on the mr warrior p9rpjj8ql
Muffin Head	Please add Pakistan s flag in clash of clan please supercell
S.MTMclan Gamer	Your update today
RealiztUkno _2XL	I Have Awoken From The Depths Of Thee Abyss This is ETERNAL ABYSS 8RC28CR2C Engineered TH11 Alot of you either know me from destroying your base in raid or i m friend with you on Clash Of Clans This is something that SuperCell doe to string you along just long enough so they can please you in the next update Things go downhill in update but for some strange reason our love for the game compels u to hang on just long enough to see if they will fix thing We take constant nerfs beyond it mean and continue to fight through it all plus any penalty that are thrown our way Why you may ask yourself Simple WE LOVE THE GAME what it once represented Much like a relationship gone bad You remember back in the day how good thing were between you and your significant other And even now though thing are bad you continue to see it through because you believe in them in hope that they will change for the better We all know that SuperCell ha made this game more suitable for any person to learn and grasp the concept of the game So easy even a caveman could do it mentality Alot ha changed since the beginning and most of u are STILL here The only question is is are you willing to adjust still be here through thick thin If so then i ll see you on the other side Just make sure you re ready for me when i emerge upon your base It s time for me to head back into the depth from which i dwell
Long Pham	22 10 already where is the update
Abhigyan Borah	I like it
Gaming Guru	You real supercell
Tik Tok BD	wow so nice
Sanjay Panpaliya	Hey guy update is coming today vo hoo I am very excited about this update
CNM Xomboid	Mostly good
Travis Slaton	Why won t supercell remove an inactive for 3 year leader pas leadership to an active co leader
JamesThe HappyGamer	I wa hoping for wall upgrade decrease
Si Ocong	Bye witch welcome hell 3 inferno
SarcasmIsFun	YESSSSS FINALLY I VE BEEN WAITING FOR THE NEW LEVL OF MINES YESSS AND IT COMES OUHT TOMMROWOWOWOLWK YESSSSSSSSSS IM SO FREAKING HAPYRPTPPYPYPYPY
entspannende musik	Deutsche Xd
Joel Myrland	most of these seem good but here are my problem I like that your decreasing the cost for donating with gem however that you plan to increse the cost for giant make me worried that you won t decrese the others enough In my opinion the most expensive a troop should be to donate with gem is maybe 5 gem for golem and stuff although i d much prefer if every troop wa 1 gem like during the event a while ago cu then i used it a lot seeing a it didn t have to bother my barrack however donating 30 35 gem for some troop is just not an option the other thing wa adding an inferneo tower seems a bit overpowered i don t think it s anything that anyone asked for and you re kinda making something that s alredy hard to 3 star even harder worse then that you re buffing the eagle artillery which is alredy a NIGHTMARE for me although i m th 10 and 9 so i try to stay away from it but it just seems like another thing no one wanted that is way to overpowered and those thing plus that you re nerfing the x bow which i feel no one ha ever had a problem with it s one of the thing that have been in the game for so long and they were perfect so i don t see a reason to change them all this added up like some people alredy pointed out you re making th 9 10 easier to 3 star even tho they re alredy fairly easy atleast th 9 is really easy i with lvl 11 hero can sometimes 3 star a maxed th 9 and with my th 10 i can just walk thru a th 9 granted a th 10 should be able too but still meenwhile making th 11 12 damn near impossible to 3 star which they alredy felt like they were to me again granted i m saying this a someone who doesn t stand a fair chance against th 11 12 either way so i can only go off what i see from others but still i m also not sure about nerfing the witch twice she s not really overpower nor underpowered anymore from what i can tell atleast not lvl 1 2 which are the one getting hit wow counting down my issue like this just made me relise that the thing i disslike or worry about make the thing i like seem minor and insignificant in comparison and now i went from feeling yay to nay about this update i tried to like it okay
Manish Mittal	i would like to know about it new clan war legues
RYAN ninja oi ryan	CANAL RYAN NINJA OI
Rhino Rules	Anyone else who play clash of clan in school work
TWZTED JOKER	I m guessing the update is coming out tomorrow
Blue Slime	Wow 22k like beacause today is 22 wkwkwk
Kane The Bunny	witch is too fun to use nerf her
Tom Petley	So if you aren â€™ t th10 this doesn â€™ t really matter to you
John Mar Arada	Fixed the Clouds in legend league
Leo Ops	0 03
KNG-IceTea	At wich time
Ghytor â€¢	Very good balance
RRG JAVELIN Legos	Why the witch i like the witchğŸ˜”ğŸ˜”
MeDo Tube	Ø¨ÙƒØ±Ø§ Ø§Ù„ØªØ­Ø¯ÙŠØ« Ù…Ùˆ ØŸØŸØŸ
Melvin David H	Me encanta ese sonido
jaggernut -123	I thought bowler were already op
killer player;v	Que alguien me explique quÃ© porque no entiendo inglÃ©s le incrementaron o bajaron o que
Human Legend	Rip witch ğŸ˜­
lad with A cool doggo	Yet we still don â€™ t get fair matchmaking
roxylicious Ayeeeaah	wth i use witch in clan war and then your going to decrease it hit point and damage point srsly
Viking - Clash Of Clans	Du coup la MAJ c est demain ğŸ˜±
Carlos Moya	Clach of clan no deven3 animasiones
Diego Aguirre	Whatt
Soufiane Aouaid	This update is a joke Supercell stop beeing greedy
XanZ Eyepatch	Why nerf witch
iafarkingicehole yo	3 inferno tower screw everything up
Nick Pinck	New level to all collector holy mackerel
Joshua BossTyuna	reduce the cost of lava
Mr Gamer	Bowler ğŸ¤©â«
Maruchan :v	Y la cosas para Th9 el inferior v
Ø­Ù…ÙˆØ¯ÙŠ ÙƒÙŠÙ…Ø²	Ø§Ù„ÙŠ Ø¹Ø±Ø¨ÙŠ Ù„Ø§ÙŠÙƒ
joseph018 _ josephssA	AyÃºdeme porfavor entre ayudas y hacitenciad porque me robaron mi cuenta y aÃºn no me responden un administrador ya le pase pruebas y todo lo demÃ¡s me la robaron con super cell Id con un correo falso me llamo Joseph 018
Ù…Ø³ØªØ± Ù…ÙŠØ±Ùˆ	ÙˆØ§Ù„Ù„Ù‡ ØªØ¹Ø¨ØªÙˆÙ†Ù‡ ÙŠÙˆÙ…ÙŠÙ‡ ØªØ­Ø¯ÙŠØ«
Ø·Ù‡ Ø§Ù„Ø¬Ø¨ÙˆØ±ÙŠ	Ù…Ù…ÙƒÙ† ØªØ±Ø¬Ù…Ø© Ø¹Ø±Ø¨ÙŠ
Reyad Ahmed	How many time to waiting new update
Legend Lucas22	Come on I just maxed out all of my collector
daniel	muito legal vem atualizaÃ§ao
TONY_nuevo gta555	This look amazing
SkunkYT	Bonjour bonsoir j ai perdu mon compte coc suite a une arnaque d un autre joueur via supercell id tout sa en rec sur ma chaÃ®ne aller voir svp et envoyÃ© en masse a supercell pendant le dÃ©marches pour rÃ©cupÃ©rÃ© mon compte il m ont dit avoir retrouvÃ© le compte et qu il voulait approfondir le question pour Ãªtre sur que le compte Ã©tait bien a moi et la je viens de me faire bannir 180 jours pour tentatives de vol de compte je ne comprend vraiment plus rien
INDIAN CLASH	Love you coc always
[Slug] Assasin1068	Noooooooooo the X BOW
KUBEK 50	Ten update jest MEGA tylko szkoda mi witch Poland
Flying Dracula	I played this game when i wa a teen and in my early 20 s I stopped playing it now because of responsibility that I have but man those were one of the day I ll cherish
Mendoza SH	Â¿MaÃ±ana e la actualizaciÃ³n o o
Julie Lobato	All this is great but since I have to wait in cloud for 2 day for a base I probably wont even notice
Jovan Ragmac	Wat
hog rider 18	What about the cost to get the troop and defenese
MisterYolo	gem donation decreased Can someone explicate me that sentence
Abd Abdullah	Ù„ÙŠØ´ Ù…Ø§ ÙÙŠ ØªØ±Ø¬Ù…Ø©
G.A.L.M 123	RIP witch
robert henry	U R talking about balance they keep putting our clan against th12 included clan in war we don t have any th12 in war included It wouldn t be matter if they won t put that freaking wallbreaking ram included in th12
TheGreatestPanda	ANOTHER INFERNO AT TH12
Bram Goeting	So it coming 22 10 2018
Lord Stark	Noooo why are you downgrading the witch again You are going to make her weak and useless again
Sandro .k	Why a third Inferno
BusterAlan	Yo pienso que deberÃ­an poner los nuevos niveles de recolectores y mina en TH9 ğŸ˜£ğŸ˜²ğŸ˜•ğŸ˜¤ğŸ˜§ğŸ˜¢
wolfpac 111	i left coc
Sayandip Poddar	dont need any balance
Alosh hamode	Thank you super sell
xXRAFAELYTXx jajasalu2	Que
Youssry Mohamed	Wow ğŸ˜²ğŸ˜²ğŸ˜²ğŸ˜²
Wizartik	Its a prdy good
Dary DBZ	Why the X bow ğŸ˜• ğŸ˜• ğŸ˜• ğŸ˜•
Heavy Tsa	Sub if you a coc fan 1 you are the best coc player Don t forget to subscribe ğŸ›ï¸
â€¢ CryXenon â€¢	When This Update Comes Out
ĞĞ½Ğ´Ñ€ĞµĞ¹ ĞœĞ°ÑĞ½Ñ†ĞµĞ²	ĞĞµ Ğ¿Ğ¾Ğ½ÑÑ‚Ğ½Ğ¾ ĞºĞ°Ğº Ñ‚Ğ¾ Ñ‡Ñ‚Ğ¾ Ğ¿Ñ€Ğ¾Ğ¸Ğ·Ğ¾ÑˆĞ»Ğ¾ Ñ Ğ²Ğ¾Ğ·Ğ´ÑƒÑˆĞ½Ğ¾Ğ¹ Ğ¾Ğ±Ğ¾Ñ€Ğ¾Ğ½Ğ¾Ğ¹ ĞµĞ¹ Ğ´Ğ¾Ğ±Ğ°Ğ²Ğ¸Ğ»Ğ¸ Ğ·Ğ´Ğ¾Ñ€Ğ¾Ğ²ÑŒĞµ Ğ¸Ğ»Ğ¸ Ğ½Ğ°Ğ¾Ğ±Ğ¾Ñ€Ğ¾Ñ‚ ÑƒĞ¼ĞµĞ½ÑŒÑˆĞ¸Ğ»Ğ¸ ğŸ¤”
Hakim_ Aslan	Ù„Ø§ÙŠÙƒ ÙŠØ§Ø¹Ø±Ø¨ÙŠ
Dandosheh Star	i didnt understand the 100 wall thing could someone explain plz
Amal A	I don t like this update
Clash and GAMER	Good luck supercell ğŸ”¥â¤ï¸ğŸ˜
Mohammadx YT	The witch Is now very bad
destroyer longbow	X bow is weak in th9 why you nerf it
Abdul Khaliq Faqiri	Ø¹Ø¬Ø¨ Ø§ÛŒÙ†Ù… Ø§Ø² Ø¢Ù¾Ø¯ÛŒØª Ø¬Ø¯ÛŒØ¯
ê„Iâ´‚G Slà¹‘â´….	ğŸ˜ğŸ’”ğŸ˜¦ğŸ˜ fu
Ø§Ù„Ø¬Ø§Ø±Ø­ Ø§Ù„Ø­Ù…ÙŠØ¯ÙŠ Ø§Ù„Ø­Ù…ÙŠØ¯ÙŠ	Ù‡Ù„ Ù…Ù† Ø¹Ø±Ø¨ÙŠ Ù‡Ù†Ø§
Halilhan DÃ¶nmez	sÃ¼per
lional Kc	everything reduced now i am sure coc will also be reduced by many player to play because it boring
Peter Hauge Andersen 9X SkÃ¦ring Skole	When doe clan league come
GaMinG TRenDs	Plz don t decrese damage of witch and hitpoint
Darth PEKKA	Xbow again
Alvaro Juarez	no one is ever going to use gem to donate
Giovana Ferreira	Aaaa muleke
the ver**	Comentario espaÃ±ol v
Ø³ÙˆØ³Ùˆ Ø§Ù„Ø±Ø§Ø¦Ø¹Ø©	ğŸ˜‚
Edwin Gonzalez	YAAAAAAAAAT AN UPDATE
Turtlelover300	Please bring the royal giant to clash of clan I think I speak for the entire community when I say we love that card
jaren johnson	Why they do witch like thatğŸ˜‚ğŸ˜‚ RIP
Huthifa Allan	0 32 R I P bow witch army ğŸ˜¥
Ø¹Ù…ÙˆØ±ÙŠ Ø§Ù„Ø¹Ø±Ø§Ù‚ÙŠ	Ø§ÙƒÙˆ Ø¹Ø±Ø¨ Ø¨Ø·ÙŠØ§Ø±Ù‡
funny tik tok	Ad pakistan s flag on high cost
Kzr7	Are you Seriuos Witch damage and hitpoints decresed but you but another inferno tower and increase the damage caused by the Agle Artillery Come on
09wolf Guy	You made the witch crap
vaniya gopal	Clans of clan good morning
Alex Rich	All this is on my birthday thanks not thanks
GoEze	What 2milions for 9 wall Its normal
Killerman YT	Gl attacking th 12 with 1 extra inferno now
Sachin Kumar	Dariane can I transfer my base to another gmail
GUCCI GANG	x3 Inferno 12th
TECHNICAL GAMER	Good coc gud update
RB STUDIOS LIVE	Omg update tomorrow
Secrets poems	Hey donar la mÃ¡quinas de asedio deberÃ­an de ser un LOGRO PLEASE ğŸ˜
Eddy Conejo II	What if you decrease the stacked damage that inferno tower do Something kinda like what you did with healer I mean balloon hog rider bowler and miner have a very hard time against two inferno tower
Yvanne RJ Seguerra	Supercell What about spell There soo damn expensive
Don Loo	I wa upset seeing the witch nerf
Killer man io	Bunlar neki
Princess Monique	just fix the damn cloud
abhishek kumar	no man it not fair with the witch
redistheman39 o	Can you please make it easier to drop trophy â€™ s on the builder base
Ayan Sardar	Why xbow power decreased th9 only have xbows and you decrease it s power now th9 have force to move th10 third class balancing for low th1 to th9 this balance change only for th10 to th12ğŸ˜ 
Fikri Muhammad	3 inferno LoL
Jacksonismystic	Excuse me my max th 11 got banned for some reason
Ahmad Otri	Ù…ÙŠÙ† Ù…Ø³ØªØ¹Ø¯ğŸ˜ğŸ˜ğŸ˜ğŸ˜
Simmo	Really Does anybody still play this
Ø¹Ù„ÙŠ Ø§Ø«ÙŠØ±	Ù…Ø§ ÙÙ‡Ù…Øª Ø´ÙŠØ¡ğŸ˜¡
ToÃ±ito Andrade	22 10 sale maÃ±ana no vrd
Pubg gaming	Love you update
kevin Chicas	Osea maÃ±ana e la actualizacion
çœ‹Pa1wuLl	Rip Witch 2016 2018
top4 asiat	Kiitos supercell pÃ¤tseistÃ¤
Rashmika Lakshan	Awesome
The Pixelation World	Wait and the giant skeleton
Paranoikos Egklovistis	Rip bowitch for th10
le rou QuÃ©bÃ©cois	trop coooooooooool
manuel perla	LOL
Ù…Ø§Ø±Ø³ÙŠÙ„ xcu	Ù…Ù†Ùˆ Ù…ØªØ­Ù…Ø³ Ù…Ø«Ù„ÙŠ Ù„Ù„ØªØ­Ø¯ÙŠØ«
The flash	Please don t nerf the witch I love her
Simi 290	Nice new update
Haris Khan	I just upgraded my th10 to th11 if it wa earlier would have been very helpful some more work increased now
Harsh yoga	What I just got witch but why did like this happen with me oh shet
zM4GO TM	Actualized for Halloween
b0nel 115	hype
Matheus Amaral	Q dia vai ser a atualizaÃ§Ã£o
x Step x	EPICâ¤ï¸ğŸ‘Œ
Mehmet can Kamalak	TÃ¼rkÃ§e meal i
Eviltony616	Â¡Good update
Ariel Amaro	Why X bow Why If it is okay
noorin moon	Ø§Ù„Ù…ÙØ±ÙˆØ¶ Ø¹Ø±Ø¨ÙŠ Ù‡Ù… Ø­ØªÙ‰ Ù†ÙØªÙ‡Ù… Ø¯Ø§Ø¯Ù‡
izic	u actually killed TH9
Shahina Khan	Winner winner balance update dinner
DeanLPHD MCPE	Nooooooooooo why the witch will be badder ğŸ˜©
Akhil S	3 inferno are too much ğŸ˜”ğŸ˜ªğŸ˜ª
The Dino fan	ĞšÑ‚Ğ¾ Ğ·Ğ´ĞµÑÑŒ Ğ ÑƒÑÑĞºĞ¾Ğ¹
IMLR.	Still no miner nerf
Phenomenonal	When is the update
Kaner Play	AtÃ© que fim resolverÃ£o colocar uma data da att pq so vejo falar e nunca sabemos o dia
Naitik Ki Duniya	When it will come
2012Trolls xD	How about something to counter lava loon for u th9
Jose Perez	Deberian hacerlo tambien en espaÃ±ol ğŸ˜…
AER Z	Why â€™ d they nerfed the witch she â€™ s not that great to be honest
ĞĞ»ĞµĞºÑĞ°Ğ½Ğ´Ñ€ Ğ¨Ğ²Ğ°Ğ¹ĞºĞ¾	ĞšĞ¸Ğ½ÑŒÑ‚Ğµ Ğ½Ğ° Ñ€ÑƒÑÑĞºĞ¾Ğ¼ ÑĞ·Ñ‹ĞºĞµ
Pro gamers	After some time they are giving something playable otheerwise i am bored
Android Game	http youtu be ipVsUNMWdUI
The Arbiter Gaming	Well done on showing Dark Troops trainig cost reduce by elixir
killer osama	0 08 golem with elixer ğŸ˜²
Twitch Maldio	were s thanos car Decrease damage
DBZ SUPPORTER #GO DBZ FANS	Supercell need to make a battle royale type game a pubg with fotnite amnimation and coc character and
Mr2nice4you B.	I have 3 Xbows All lvl 3 idk Should i lvl then on lvl 4 Cuz they get buffed
Fares gamer	Ù‡Ø§ÙŠ Ù…Ù† Ø¹Ø±Ø¨ÙŠ Hi who arabic
Fannimation Studios Stop Motion	Guys what level is your townhall
VIRAL MONSTER	Ruined the witch
Musically and Tik Tok videos	Update kB aa rha hai
LeoMcCat Yu	Level 13 wall rip
Technical Gaming	Coc is best
AAYUSH AGRAWAL	What s gon na happen to mah witch slap
Ash King	Plz up witch s hit point don t decrease
KRIDLO PILE	where are real update giant update
Leonardo Miranda	Um absurdo levar 28 minutos para treinar um dragÃ£o elÃ©trico Absurdo
wilma pereira	Any other update like a new troop giant skeleton pumpkin barbğŸ˜˜ğŸ˜˜ğŸ˜˜plzz reply me I req u
Ø¹Ù„ÙˆØ´ Ø¬ÙˆØ²ÙŠÙ	Ù…Ù…ÙƒÙ† Ù„Ø§ÙŠÙƒ
Nilesh Sejpal	Update date
Tyler8G	Great more mine and pump to upgrade
JÃ¤Ã®r MÃ¶rÃ¢lÄ—s	Yeee
Mian Daniyal Khan	Help and support team rip
SPD YOUTUBER MOON	Thats great Thank you super cell
Bassic Boio54	Reduce wizard training cost
SteelXSpider	These sound like those slot machine in casino
gta haker	Ø§Ù„Ø¹Ø±Ø¨ Ø¨ÙƒÙ„ Ù…ÙƒØ§Ù†
Jefrin Jef	I think the update of witch is very lame
Ø§Ø­Ù…Ø¯ Ù†Ø§ØµØ±	Ø§Ù†Ø§ Ù…Ø´ Ø´ÙŠÙ Ø¹Ø±Ø§Ø¨ ÙˆÙ†ÙƒÙ…ğŸ˜„ğŸ˜„
SOMA MAYBE	I LOVE CLASH OF CLANS THANKS SUPERCELL ğŸ˜
Work4 days	Not the witch nooooooooo
Ahmed Masri	ÙŠØ§ Ø´Ø¨Ø§Ø¨ Ù…Ø¹Ù†Ø§ Ù‡Ù„ ÙÙŠØ¯ÙŠÙˆ Ø§Ù†Ùˆ Ø¨ÙƒØ±Ø§ Ø§Ù„ØªØ­Ø¯ÙŠØ«
BOYKA BOYKA	ÙƒÙ„ Ø´ÙŠ Ø¹Ø±Ø¨ÙŠ ÙŠØ·Ø¬ Ù„Ø§ÙŠÙƒ
Barun Deep Ghosh	not happy with witch and x bow
Dead Hunter Gaming	Looks Fine To Me
MATT PLAYS	Nice
Pakistani Chokro	Left playing few day back nothing in the update to get me back
Breno Junio	Thank you supercell
Sai Yalnati	Super
Bobiltimung Bobil	Yeh Acchhha nahi hai bhaiiiiiii plsz Mt k
Slavny TV	ĞĞ¾Ğ²Ñ‹Ğ¹ ÑƒÑ€Ğ¾Ğ²ĞµĞ½ÑŒ Ğ´Ğ¾Ğ±Ñ‹Ğ²Ğ°Ğ»Ğ¾Ğº Ğ¼Ğ¼Ğ¼
Ajay Verma	Wow amazing
Sharing Ideas	Very
dark gamer	Basically gem are buffed have more value Bases playing the defence have been nerfed
noah p	Why you bashing on my witch
Ynn3k Ğ¯	Walls are too expensive
Pet Care Tips	Omg
1000 subs with no videos. Only 100 more to go!	Man and he â€™ s I thought â€œ finally my collector are maxed â€
CLASH WITH LEO	East and west coc is the best ğŸ˜€ğŸ˜€ğŸ˜€
Jahid Hasan	âš¡ğŸš€ğŸš€ğŸš€
Sanju Kankuntla	It s a very big update
Challenge Booster	Where is clash o rama ğŸ˜¤ Like if you agreeğŸ‘
MLG TUBER	I hate this balane
AndrÃ© Cavalcante	Algum BR
Outlas 0-0	Nadie habla espaÃ±ol v Pd Feliz dia ğŸ‘€ğŸ”¥
NaÃ©n :V	Mine lvl 13 th10 ğŸ˜¡ğŸ˜ 
Caleb Caudillo	I just got the hog xd
Ahlixemus The 45th	This is a HUGE game changer
Ø§Ù„Ù‡ÙˆØ¬Ø§Ø³ 16	Ø§Ù„Ø¹Ø±Ø¨ÙŠ Ù„Ø§ÙŠÙƒ
The Tzetan	Why witch why
Mr. Ducky	Why is this game still trying to be relevant
MUKUND BAJPAI	Why lava training time increased
COC WITH SP	Need a BH war mode
Gaming Hub	is there gem donation feature tooğŸ˜¯
Deep Dey	1 more inferno tower it goona suck
omar alejandro Bastidas	great
LEGEND ANMOL	I think witch is lol
ONEGODFORME	Where s my clash of Rama
Hokage Gonoha	ÙˆØ§Ù„Ù„Ù‡ Ù…ØªØ­Ù…Ø³ Ù„Ù„ØªØ­Ø¯ÙŠØ«ğŸ˜ğŸ˜
Gurra_1	Finally new level for collection resource
alin8080	Gem donation decreased
Arturshov Games Stas swoy	Way nerf x bov
need for subs	From 1 28 those balance were awesome
BRAYDEN GAMING CLASHING	We need more balancing in the attack side the update is still not balanced if you guy agree then click on this sign ğŸ‘ and if you guy don t agree the click on this sign ğŸ‘ below
educarlos educarlos	Love
TV LCD NET RUIM	Quem Ã© br ae
ishika pandey	Nice update i am big fan of This game ğŸ˜ğŸ˜
Henrique Wob	Golem dark elixir
frezing87	wau ton of update 3 inferno increase damage by eagle that will be hard to get 3 star in TH11 and TH12
o-: Ğ”Ğ¸Ğ¼Ğ° :-o	Ğ£ Ğ¼ĞµĞ½Ñ 8Ñ‚ÑÑ… Ñ„ÑƒĞ»Ğ» Ğ¼Ğ½Ğµ Ñ€Ğ°ÑˆĞ¸Ñ‚ÑŒ Ñ‡Ñ‚Ğ¾ Ğ»Ğ¸
BD Freefire Gaming	Banned ACC back supercell
Conrrado Torres	That 3rd inferno is gon na be mean
Yasin Mahmud	nice
assault sethu	Please reduce the cost of wall this is the main wish of all clashers
Grazna ĞŸĞµ4ĞµĞ½ÑŒĞºĞ°	ĞÑ–Ñ…ÑƒÑ Ğ½Ğµ Ğ¿Ğ¾Ğ½ÑĞ² Ğ½Ğ¾ Ğ¾Ñ‡ĞµĞ½ÑŒ Ğ¸Ğ½Ñ‚ĞµÑ€ĞµÑĞ½Ğ¾
Darylmar M. O. Fonseca	EstÃ¡ de sacanagem nÃ© supercell Mais um nÃ­vel dessas porcarias de coletores JÃ¡ Ã© demorado maximizar o cv10 ai vocÃªs vÃªm com isso A Ãºnica coisa que achei interessante foi a terceira torre inferno estava precisando mesmo
JJoona a	Yes finally new level for resource collector
Liam Crawley	Where is clash a Rama
Chanki Thakur	Now 3 inferno n lvl 3 eagle artilary will destroy all troop but nice update looking for new hero
Yato sama	don t buff the witch
MINIEVIL	It took me like a quarter of the video to realize that this wasn t a Clash Royale update lmao I m blind
Devendra Tailor	Awesome And Cool Update Plz Next Update Come Fast Fast Fast And Thnxxxzz For thiS upDate
Ø§Ù„Ù‡Ø¯Ø§Ù Ø§Ù„Ø¯ÙˆÙ„ÙŠ	Ø§ÙŠ ÙˆØ§Ø­Ø¯ Ø¹Ø±Ø¨ÙŠ Ù„Ø§ÙŠÙƒ
Adnan Khan	Sirrrrr soooooooooooo plz lava decresedğŸ˜­ğŸ˜­ğŸ˜­ğŸ˜­ğŸ˜­ğŸ˜­ğŸ˜­ğŸ˜­
Shawaiz	COC PLZ HEART MY COMMENT OR IT WILL LOST IN MILLION OF COMMENTS
Justin X.	Noooo not da witch
Muhammad Ihsan	Witch kok turun damage sma hit poin nya
mehdi ghomari	Thank you supercell All the Best Inshallah ğŸ‘
Anything Everything	They mean to say that there is gold mine lvl 13
Pranav Shilpkar	ğŸ˜˜ğŸ˜˜ğŸ˜ğŸ˜ğŸ˜Its is so awesomeğŸ˜ğŸ˜ğŸ˜ğŸ˜˜ğŸ˜˜
MAHIV DAWSON	Hy superell we need a Bangladeshi language sir next updo PleaseğŸ˜«ğŸ™ğŸ™ğŸ’“ give
Rk Rudro	ğŸ˜˜ğŸ˜˜ğŸ˜˜ğŸ˜˜ğŸ˜˜CLAH OF CLANS LOVER ğŸ˜˜ğŸ˜˜ğŸ˜˜ğŸ˜˜ğŸ˜˜ğŸ˜˜HIT THE LIKE BUTTON HEREğŸ˜™ğŸ˜™ğŸ˜™ğŸ˜™ğŸ˜™ğŸ˜™ğŸ˜™ğŸ˜™ğŸ˜™ğŸ˜™ğŸ˜™ğŸ˜™
Slugs Com	Yay more wall to upgrade ğŸ˜‘
Punkiman	turun
KS Gamer	But we want our enemy shield guard time while they raid our village most hated when player s guard inactive directly under attack please provide u our enemy shield guard time
Mujeeb Noushad	Make pushing easier for low town hall like 8 9 10
Orange9098	Moral of the story Training cost reduced Gem donation decreased
Blue Knight	Why did they limit the amount of wall we can upgrade to 13
Mu'iz Gamers	Like
Smokescreen TM	The whole video wa basically Gem Donation Reduced â†“
jashan 005	I love this balancing update
Vincent Ling Wei Sen	wow so much
Theboogie boxman	Thanks
Jhon Jhon FÃ©lix Jhon	Vai ter alguma coisa dÃ¡ base do construtor
Ø§Ø¯Ù…ÙŠØ±Ø§Ù„ Ø§Ù„Ø¯ÙˆÙ„Ù‡	ğŸ˜•â˜¹â˜¹â˜¹â˜¹ğŸ¤›
Not really me	Why â€™ d you make the witch even worse
Joseph Patassini	Noice
Jaspal Singh	Great coc
soo cool	Worst game
Amit Parmar	1 47 What They Mean To Say ğŸ¤”
Ylham Ibragimov	ĞºĞ»Ğ°ÑÑĞ½Ğ¾ âœŒ
Renjith John	halloween update plea fast waiting for it
Krishna Gupta	if supercell seeing this help me please
LIVE WITH mynk	So witch are dead ğŸ˜¡ğŸ˜¡ğŸ˜¡
Kala Kannan	please do new defense we bored with old ğŸ˜Šif you like then like hereğŸ‘â¤ğŸ‘Œall the best supercell Ë˜ Â³Ë˜ â¤âŠ‚ ãƒ»â–½ãƒ» âŠƒ zzz
Kalpana Gawande	Bring new potion
m mcdonald	Add a sandbox mode with infinite recorces and 1 second building speed please
Karan Cheema	who like coc like here ğŸ‘‡
Lone Wanderer	So is witch balanced
jutjuber sa kruske	Nerf witchğŸ˜“ğŸ˜“ğŸ˜¢ğŸ˜¢
Gulam Itoo	Love u coc
Ø®Ø§Ù„Ø¯ Ø§Ù„Ø­Ø±ÙŠØµÙŠ	Ø·ÙŠØ¨ Ø§Ø³Ø¹Ù‡ ÙƒÙ…
Jonathan Mendoza	Yay new update tomorrow so hyped
Anshad Anu	Pls adjust upgrade time
Fam Gaming	Wow one of the best balancing so far lol
Ğ²Ğ°Ğ½Ñ Ğ¼Ğ°Ğ»Ğ¸ĞºĞ¾Ğ²	No supersell
FukkatsuRyu	But I just upgraded Golem to 4 and Witch to 2 to make my GoWiWi stronger Will the nerfs to the Witch kill GoWiWi or will it still be a strong strategy
Morteza Emami	Huge balance
Adrian MtZ	I like the sound effect
Sabahoon Sahibzada	Date of clan war leages update
TemIcH Starbucks	NeiKindeveloperCoC
Ali Alshawaf	FinallyyğŸ”¥ğŸ”¥ğŸ”¥ğŸ”¥ğŸ”¥
KEVIN flow	Para los th8 9 no hay nada
learn and clash	Who want new troop in this update like Ice wizard
Nazin Khan	Why witch why
Tyler Pony	Nerf the Royale Giant Please
Tauseef Raza	Yyjolgp2q please help me
Edward Selvanovich	wow thats alomost everything stroop in the game like if oyu agree
Ù…Ù†ÙˆØ¹Ø§Øª ÙˆØ§Ø­Ø¯ Ø¹Ø±Ø§Ù‚ÙŠ	fantastic
Sonu Singh	Hello Sir we got the news of your balance update good Cheng But the more need is in Cheng s hero In their update cost and time If you get a little bit Cheng then more fun in the game à¥¤à¥¤à¥¤
Bla Ze	Buf the HOOOG RIDERRRRR
Lord Osh	Only update we need is 1 gem donation foreverğŸ˜’
Cambodia Movie HD	nice
suresh krishna	Now graphic is too poor in next update u can increase graphic bro waiting for next update
Oussama Ar	Ø´ÙƒØ±Ø§ Ø¹Ù„Ù‰ Ø§Ù„ØªØ­Ø¯ÙŠØ«
game giáº£i trÃ­ on	my x bow
HectorJacobo	Why October 22 Today is 21 ğŸ‘€
Reymart Martesano	i dont care haha
shubham kumar	Witch why damge is low
Anthony Pool	Nice
Baumkind CoC	Nice
Dogeyboy	Now let u see how Brawl star will do the balance change thing
KlÄ“fer	You got ta admit that the update in 2018 are way better than any update from 2017
Mr. Amidam	Where
DARKHIRO	The game suck Will die soon
ItsCosmic	nerf elite barb pls
REAL GAMERS D	Gave no much loot and upgred cost high just buuu
Jao Marcos	A Baixaram Bruxa ğŸ˜­
Brian Thayer	How about them cloud you know fixing a problem Before introducing more
Ù…Ù‡Ø¯ÙŠ Ø§Ù„Ø´Ù…Ø±ÙŠ	Ù…ÙÙ‡Ù…Øª Ø´ÙŠ
Silvia Losano	Why doe the witch have to be weak i want a strong one not like back then when it suck
Kerem KaragÃ¶z	Electro Dragon training cost is too much You must balanced
Hamza. Seven86	Damn another inferno tower at th12 will really make a difference I m surprised to see that there wasn t an E drag Nerf
PRATIK SAMANTA	NO don t nerf the witch I love witch extremely i love witch attack ğŸ˜­ğŸ˜­ğŸ˜­ğŸ˜­ğŸ˜­ğŸ˜­
Ù…Ù„ÙˆÙƒ Ø§Ù„Ø§Ø±Ø¶ M.A.A / Clash Of Clans	Ø§Ù„Ø¹Ø±Ø¨ÙŠ Ø§Ù„ÙŠ Ø¨ÙŠÙ‚Ø±Ø¡ Ø§Ù„ØªØ¹Ù„ÙŠÙ‚Ø§Øª ÙŠØ­Ø· Ù„Ø§ÙŠÙƒ
Cricingo	Ohh yeah P
Sankhajit Paul	update is mainly for defense but what about attack
Panomo Nasabi	Village Edit Mode please Japan
update rs Raju	Which date realease this update
Rugved Wakekar	When and how this update will come
NOTHING ELSE	I miss this game
the shining dragonair	Well the witch got screwed over
ÙŠØ§Ø³Ù…ÙŠÙ† ÙŠØ§Ø³Ù…ÙŠÙ†Ø©	Ø§Ù„Ø­Ù…Ø¯ Ø§Ù„Ù„Ù‡ Ù…Ø§ ÙÙ‡Ù…Øª Ø´ÙŠ ğŸ˜¹ğŸ˜ğŸ˜
The downloader	They should decrease hound training cost
HARSHIT DHYANI	Is UPDATE OF CLAN WAR LEAGUE ALSO COMING TOMORROW
Ishaq Jakhrani	visrd ko 2000 hit point kerna chia
Ù…Ø­ØªØ±Ù Ø§Ù„Ø§Ù„Ø¹Ø§Ø¨	Ø´Ùˆ ÙŠØ¹Ù†ÙŠ Ù‡Ø§Ø°Ø§ Ø§Ù„ÙÙŠØ¯ÙŠÙˆ Ø­Ø¯ ÙŠÙÙ‡Ù…Ù†ÙŠ Ù…Ø§Ø¹Ø±Ù Ø§Ù†Ø¬Ù„ÙŠØ²ÙŠ
Andorid pixel	no I want Change my name Please understand my filling That IAM sharing with you supersell Help me last hope you are other thing can do You can understand my filling thanks ğŸ˜¢ğŸ˜¢ğŸ˜¢ğŸ˜¢ Super sell help me Please my id tag 98UGYJ9P2 change my name to Aniket
Parmila Devi	When is the clan war update coming huh
Simon Playz	Finallyy elixiar and coin collector ha more upgrade
DJ N	Pls say holloween update included
ĞšĞ,ĞœĞ	ğŸ˜¨ğŸ˜¨ğŸ˜¨ğŸ˜¨ğŸ˜¨ğŸ˜¨ğŸ˜¨ğŸ˜¨ğŸ˜¨
Anamika Saggu	When this update will start
Clash with daniel	Liked all of those ğŸ‘
Felixu Lenon	r i p witch
ANDER MAN MAN	7 20 00 00
Siy Memes	I saw the Collectors and I thought NOOOOOOOOOOOOOOOOOOOOOOOOOOO WHYYYYYYYYYYYYYYYY I JUST MAXED THESE OUT IN TH 9
Omprakash Official	Y witch hit point and x bow hitpoints decreased
Mr.Alok kumar	When doe the upadate released
Vakati Venkatesh	Its my bday gift wow
Tyler TBG	FINALLY THIS GAME GIVES NEW LEVELS TO THE ELIXER PUMPS AND GOLD MINES FOR THE FIRST TIME
Karuppusamy Samy	Super
saish Adlakonda	Who even play coc anymore
Water Blaze	See Clan War Leagues did change the game I mean it s great I don t remember last time we got Balance Change in CoC Collectors new level
doge the dog	Good 3
Masterhuntergaming101 II	Finnally new reasoure upgrading
Jorge Trochez	Perdonen pero esta f si la cagaron como le van a bajar al golem y le van a aumentar a la aguila artillera
BLacK RoSe	Need Bangla Language please
Fps Frenzy	Who else shared it to your clan group
Wendell Gtiffin	Most of the thing are for th11 or highee
Jeff Choate	So is it saying that you can even get MORE inferno tower if you have th12
Ankan tech	Hey guy why do you downgrade the witch I dont like it guy ğŸ˜¡ğŸ˜¡ğŸ˜¡ğŸ¤¬ğŸ¤¬ğŸ¤¬ğŸ¤¬ğŸ¤¬ğŸ¤¬ğŸ¤¬
Glory	Clash of Clans is the world s best game
your understander	play balance 3D game
Ø§Ø¨Ø¯Ø§Ø¹ ÙŠÙ…Ù†ÙŠ	Update your avid enthusiast to ğŸ˜âœŒ Ø§Ù„ØªØ­Ø¯ÙŠØ« Ø¨ÙƒØ±Ù‡ Ø§Ù„ÙŠ Ù…ØªØ­Ù…Ø³ Ù„Ø§ÙŠÙƒ ğŸ˜ğŸ‘
Renju Varghese	decrease Lava cost
ĞœĞ¸ÑĞ¸Ñ ĞÑĞ½Ğ°Ñ‚	Edwards
â€ Victorius CÉ¾eÎ±Ğ¼â€ 	ACTUALIZACION TOP
Asif Sardar	When you release a solution about cloud problem in legend
Amrit Khanal	22 oct balance update
SadTuber Rafi	I ain t satisfied of this balancing update
ChillieVines Entertainment	That what we need
MarcoTheGamer	so infact if you level up the witch you will downgrade her
Rohit Sharma	suppercell plz create th13 i am max th12 so what i can do in game plz told me
julo / TinKmaster	nice
xxxMaximus xx	1 40 Nooo that should not happen
Zarguz Hedwaka	Add more troop please the same strategy are boring
all in one	Have a nice update
Felipe Santos	Ah velho nao acredito que nerfaram a bruxa
clashing with sanjay	do you think upgrading wall to level 13 is easy
Steeler Mom	I â€™ m pumped finally I can save dark elixer and elixer cause of the training cost decreased and new level mine pump and drill
yomumge i	Just one more day
sudha kar	Soo gud ğŸ˜ŠğŸ˜Š
Angel Gallardo	This game is hella dead
mini militia tips and tricks in Bengali	Vary nice video ğŸ˜ğŸ˜ğŸ˜ğŸ‘ğŸ‘ğŸ‘ğŸ‘ŒğŸ‘ŒğŸ‘ŒğŸ˜„ğŸ˜„ğŸ˜„
ItsJake	This feel too much like Clash Royale
Harman Gaming	I am stop playing coc because they doe not give respect to india
Shourav Hasan	wow what a update so nice
FernandoGSGamer	Rip Xbow
rohan Kaushik	Love form India and how is happy about the news
zeyd mohamed	Ù„ÙŠÙ‡ Ø§Ù„Ø§ÙƒØ³Ø¨Ùˆ ØŸ Ø§Ù„Ù„Ø¹Ù†Ø©ğŸ˜‘
Karan Raj	Osm
SHADI .S	Ø§Ø°Ø§ Ø¹Ø±Ø¨ÙŠ Ù„Ø§ÙŠÙƒ
No Name	YES FINALLY now I can rest in peace
Abo Al-Hasan	Talking about balancing in a pay to win game be like eating spaghetti with a spoon
StrikerBoy _	Add more mine and colectors to tze nightVilage
ÙƒÙ„Ø§Ø´ Ø§Ù ÙƒÙ„Ø§Ù†Ø³ ÙˆØ±ÙŠØ§Ù„	Ø§Ù„Ù…Ø³Ù„Ù…ÙˆÙ† ÙˆØ§Ù„Ø¹Ø±Ù Ù„Ø§ÙŠÙƒ
Ù…Ø­Ù…Ø¯ Ø¹Ù„ÙŠ	Ø§Ù„Ø¹Ø±Ø¨ÙŠ Ø¬Ù‚Ù†ÙŠ Ø¨Ù„Ø§ÙŠÙƒ
LaurenForRealz Gaming	Up the attack and health on Hounds please
Md Kashem	O no
Cypher	BROOO WITCH GOT SLAUGHTERED everything else wa SICK THO
MY SERGO	wow
Galactic Pickle	Poor witch
shahwar gamer	AWM and 8x scope like if agree
Carum Sarene	So builder hall isn t changing Okay then
SonOfDoge	That â€™ s so awesome YES ğŸ‘
Hiruma sss	Que acabe de ver
Ø¹Ù„ÙŠ Ø§ÙƒØ³ÙŠØ± /ali aksar	Ø§ÙŠ Ø´ÙŠ Ù…ÙˆØ¬ÙˆØ¯ Ù‡Ø±Ø¨ÙŠ
#Prankster Rishabh Singh	Ok cool but now this game is dead for me ğŸ˜­
Troll King	3 inferno ğŸ˜“ mean 15 simultaneous target ğŸ˜‚ğŸ˜‚ğŸ˜‚and if inferno placed together RIP BOWLERS LOONS and MINERSğŸ˜‚ğŸ˜‚ğŸ˜‚ğŸ˜‚ğŸ˜‚
The KonGs	Wow se ve muy buena la actualizaciÃ³n pero me gustarÃ­a que tambiÃ©n agan actualizaciones para ayuntamientos bajos ğŸ˜“ğŸ˜«ğŸ˜­
Siddhant Das	Soo good no nerfed ğŸ˜…
gaming bro	Why you nurf the air bomb
sachin Chaudhari	Excited for the update ğŸ‘ŒğŸ‘ŒğŸ‘Œ
TIGER 004	Get back you tuber first then u can get back your old player
Lemon head	Lol
Ignacio Leypin Fernandez	When is the day for the update I m waiting soo month For halloween ğŸƒ
Kibby A. Star	Yay after i just spent a bunch of coin and card for leveling a lot of these up
Mrutyum Jayarao	3rd inferno I understood why e drag haven t nerfed haha
Pablo Monterrosa	alv va a estar genialğŸ˜ğŸ‘Œ
IRAQ Plya	Ø§ÙƒÙˆ Ø¹Ø±Ø¨ Ø¨Ù„Ø·ÙŠØ§Ø±Ø©ØŸØŸ
Ujjwal Sarkar	Good balanced
Aman Shukla	Quickly do that update plz plz
Syed Daim Hassan	Th13
bilal sezgin	22 Ekim de mi
YalnÄ±z Usta	Bu gÃ¼ncelleme ne zaman olacak gelsin artÄ±k ÅŸu gÃ¼ncelleme oyunu guncelleyek di mi yani
Tiger tank 1	Bro not the X bow plssss noooo I need that for my villageğŸ˜¢
Asish Rasaily	Supercell can you please make the map bigger it doesn â€™ t have to be much just 50x50 will be fine
MUHAMMED NASSAN	ğŸ˜ğŸ˜ğŸ˜
LONE Ğ¥ĞĞšĞ•Ğ 	ĞšÑ‚Ğ¾ Ñ€ÑƒÑÑĞºĞ¸Ğ¹ Ğ»Ğ°Ğ¹Ğº
Gamer Hack pro	Coc update date Ans me tell me
Tabrez Khan	Nice update supercell ğŸ‘
Anderson Clash	hummmm
Juan carlos Basically	Halloween update
Amore Stael	Ø§ÙƒÙˆ Ø¹Ø±Ø¨ Ø¨ Ø§Ù„Ø·ÙŠØ§Ø±Ø© ğŸ˜‚ğŸ˜‚
Vinnuban B	So many change
Badal Barman	When the update will be given plz tell first
BREEZE	Best balance update yet
Erick Estrada	THIS IS WHEN THE UPDATE OS HERE
Jacobphilip nabu	Nooooooooooooooooooooooooooooooo please don t decrease the HP of which and the attack is decreased noooooooo please noooooo
MoreAds	Who care about gem donation Little sad bad balance But still love from here
Sarita Singh	Wow
GHOST MAN	Poor witch
Games Bond	One more inferno tower are you nut ğŸ¥œ
Mike Thapa	But witch take dark but there is only elixir
Ajay Kumar	Witch hit point and damage reduced with x bow damage reduced are very much disappointing for me ğŸ˜ ğŸ˜ ğŸ˜ ğŸ˜ ğŸ˜ ğŸ˜ ğŸ˜¡ğŸ˜¡ğŸ˜¡ğŸ˜¡ğŸ˜¡
IL GAME KING	wait so the update is tomorrow
praten met j l Thesame Jdjduw	Rip wich
Ajay Meena	Perfectly Balance a all thing should be
Anjandeep Singh Kohli	1 26 cost of siege is of elxir lolğŸ˜‚is it true
Ankit Karki	When the update will release ğŸ˜ŠğŸ˜ŠğŸ˜ŠğŸ˜ŠğŸ˜€ğŸ˜€ğŸ˜ƒğŸ˜„ğŸ˜„ğŸ˜†ğŸ˜†ğŸ˜†
Nirupama Gumtam	Ye kya Ho that h
Tiny Titan1	Third inferno for 12 AWESOME
Raged gamer	Wow
Resul Can	New resource level FINALLY
Yogesh Sharma	Ho thanks coc for update
Harshit Joshi	I am waiting for clan war leage update
Mstr I Bekaso	Gem DONTION DECREASED
zoza zoza	oloğŸ˜š
Ù†ÙŠÙ…Ø§Ø± Ø¨Ø§Ù„Ø¹Ø±Ø¨ÙŠ	Ø¨Ø§Ø¬Ø± ØªØ­Ø¯ÙŠØ«
Apoorv Garg	You should not do anything to witch
RawbeE _	I wish that troop that train while you are searching for a raid to automatically join your army if you choose to attack a base Right now you have to return home to get the troop in your army
shakil hassen	tomorrow next update im sure Any one like tomorrow update So like my coment
TOTIE POGI	Who ha an active clan
MOHAMMAD MAHDI DARVISH.P	noooooo x boooooowwwww
Usuario CrÃ­tico EspaÃ±ol	Omg Thanks for that 30 gem for a pekka is a joke
Mohd Lan21	tak sabar nak tunggu btw slam from malaysiağŸ˜Š
Matias Andres	Th9 esta muerto cym
Daniel Alexandru	Yesss
Killer Tunes	Awesome upgrade
CORRIGINDO OS BURRO NOS COMENTARIOS	AlguÃ©m traduz pra mim
ReFan 4Craft	Good
Juanjose Velazquez	Hay jente q juega esto todavÃ­a lo de hoy son los batles royal
Luthfur Rahman	Plz plzplzplzpzlzpzlzplzplzplzpzlpzlzpzlzpzlzllz reduce the cost of wall by half it s too much man plzpzlzplzpzlzl
G Deathly	There must be something about Archer tower cost upgrade and loot when ever I wan na attack and upgrade just 1 Archer tower or something else that take me more than a week to collect the gold if it keep not coming good loot for me I ll quit coc
Rufat Kazimov	why x bow increased
MIRAN Mihemed	Ø§Ù„ Ø¹Ø±Ø¨ÙŠ Ù„Ø§ÙŠÙƒ
Sundareesh Praveen	Hello supercell Please introduce the voice chat facility
Gaming with Jaspreet	Nice job
elsaud elkhodry	Ø­Ù„Ùˆ Ø§Ù„ØªØ­Ø¯ÙŠØ«
Ø§Ù„Ø³ÙØ§Ø­ Ø§Ù„Ø³ÙˆØ±ÙŠ	Ù„Ø§Ø²Ù… Ø¨Ø±Ø¬ Ø§Ù„Ù†Ø§Ø± Ø§Ù„Ø³Ù†Ø¬Ù„ ÙŠÙ‚Ù„Ù„Ùˆ Ù‚ÙˆØªÙ‡
THE GAME PLAYER	One gem boost
Muhammad Mubarak	Are yar witch ka Hintpoint or damage Kam hogayağŸ˜­ğŸ˜­
DonCrafts1	Thought this wa CR lolğŸ˜…
Rafael Orozco	The update is 22 10
TheMagneticDude	ALOT OF CARDS ARE CHEAPER YAY
Clash with Drag	Don t nerf the witch
Rron Bega	Fix legend league waiting time the only reason i quited this game wa that
#noKomment #noHomo	nice
Batsuren Byambajav	whata suck update my fav witch o weaker than before buu
Ibrahim gmaing	Arabisch Ù„Ø§ÙŠÙƒ Ø§Ù„Ø§Ø´ØªØ±Ø§Ùƒ ÙÙŠ Ù‚Ù†Ø§ØªÙŠ
Charizard XYZ	ooohh my bday
alterwtfgeil 2004	and the hater say the game is dead ğŸ˜‚ğŸ˜‚ğŸ˜‚
prashant kumar	Sc pls fix up war and cloud
Ã†nzoR Ferrari	ĞšĞ¾Ğ³Ğ´Ğ° Ğ¾Ğ±Ğ½Ğ¾Ğ²Ğ»ĞµĞ½Ğ¸Ğµ Ñ‚Ğ¾ ÑƒĞ¶Ğµ ĞºĞ¾Ğ½ĞµÑ† Ğ¾ĞºÑ‚ÑĞ±Ñ€Ñ
clashing with salik	Wow let s upgrade collector again ğŸ˜‚
vilogplay. Ğ’Ğ¸Ñ‚Ğ°Ğ»Ğ¸Ğ¹ Ğ›Ğ¾Ğ³Ğ¾Ğ²ĞµĞµĞ²	Ğ¤ÑƒÑ… Ğ½Ğ° 10 Ğ¸Ğ· Ğ±ÑƒĞ´ĞµÑ‚ Ğ´Ğ¾ÑÑ‚ÑƒĞ¿ĞµĞ½ Ğ½Ğ¾Ğ²Ñ‹Ğ¹ ÑƒÑ€Ğ¾Ğ²ĞµĞ½ÑŒ ÑĞ±Ğ¾Ñ€Ñ‰Ğ¸ĞºĞ¾Ğ² Ñ…Ğ¾Ñ€Ğ¾ÑˆĞ¾ Ğ½Ğµ Ğ½Ğ°Ğ´Ğ¾ 11 Ğ¸Ğ»Ğ¸ 12 Ñ€Ğ°Ñ‚ÑƒÑˆĞµ
QuanTheAznPoop.mp4	RIP my xbow just got 1 to level 4 yesterday
Nikplaysgames	Finally a new mine level hope I don â€™ t have to be town hall 12 tho I â€™ m only 9
akshay chandran b	This suck
sarla Dhiman	No coc don t make this update happen
s buddy	Thank you clash of clan nice job
Donghoon 2	Lmao Clash Royale style
kaminey Friends	So nice game and video
Wacky ._.	X bow should be buffed
jaswant kumar	Waooo
Son Goku	I am sick of this game now
Ali Ceboll	What is purposee
MineplayerHD Youtube	pleace do every update like that i love it
Mireydi Marizol	Yessssssss
Icelanticore	Balanced a all thing should be
LightenStar // TurboLighten	Clash of Clans Balance Updates are boring honestly
Kev WT	Supercell is totally messing the freaking game up This is not balancing I love the game but you guy are destroying it imo but we will see how it play out smh
Zaire OConnor	No sign of wall price getting any lower better upgrading I guess ğŸ˜–
CM PANDEY	why is lev2 witch ap and hp are reduced they shoul be increased
Santosh Joshi	Tomorrow update
paul Gilbert	Better if Cloud is fix sooner a we all will be in need of more loot to upgrade
mr shayan984	i had to quit clash of clan but a update just released iam gon na tell all my friend that quit clash of clan
Kishor ahir	Cam we get this update tomorrow I Mean 22 10
Minaxi Kasta	Supercell ki jai ho
Davidito é‡‘é’±	22 Update
LEGEND HUNTer	I think I m watching clash of royal information
Arif	Doesn t matter The game is dead
MS3B YT	Ø§Ù„ÙŠ Ø¹Ø§Ø¬Ø¨Ù‡ Ø§Ù„ØªØ­Ø¯ÙŠØ« Ø§Ù„Ø¬Ø§ÙŠ Ø§Ù„Ø¬Ø¯ÙŠØ¯ ÙŠØ³ÙˆÙŠ Ù„Ø§ÙŠÙƒ ğŸ’™ğŸ”¥ Ø§Ù†ÙŠ ØªØ§ÙˆÙ† 11 Ù…Ø§ÙƒØ³ Ù„ÙÙ„ 187
Ricky Sharma	and where is war league
jerry Pradhan	AWESOME
Arindam Sarkar	nyc
TIKTOK HARI	Super balancing
sniper redone	Luckily those dont affect to me ğŸ˜ğŸ˜
The Curse	At least they know what is the value of gem
Unicorn Is Savage	Im a TH12 but no inferno tower ha been added
Trami Nguyen	I love this game
â¶ Octavian Simon	gEm d0nAtIoN dEcrReAse
GOGICHA TV16	Supersell you are the best YEESSSS
Coc Master	Nice
Piccolo	What about builder base Also you should buff the builder mortar
Ê™á´€É´æ„›	PT Br Como consigo parceria com vocÃªs para eu fazer vÃ­deo e adquirir app desenvolvedor do Clash of clan para mais conteÃºdo English How do I get a partnership with you for me to make video and get Clash of Clan developer app app for more content
Dino FTW	RIPwitch
Manu Karthik	What is the use of witch anyway ğŸ™„
HoÃ i Nguyá»…n ngá»c	Please reduce hero lifting time
Zaph_ Real	Time to overuse and abuse this update Jk
Toxic eh	Is the update release on 22 10 because it today 21 10
Jsl Records . com	Nice i need 1 more inferno tower ğŸ˜ğŸ˜ğŸ‘ŒğŸ‘Œ
RIN	I love COC
The Amazing Thajry	Man why is giant donation gem increased
Best Gameing	Hi I am from India
andr3mito 11	Only gel balance
hereMc	Now it come out
Abdoo Luffy	Ø§Ù„ØªØ­Ø¯ÙŠØ« ÙŠÙˆÙ… Ø§Ù„Ø§Ø«Ù†ÙŠÙ† 22 10 2018
Fleshy Gamer	Coc is worst ever game and all player thing that it s quality is more ultra hd why man you create this dumb game
INBASAKARAN KASINATHAN	witch ğŸ˜­ğŸ˜­
Enkhbat Oyunbat	MONGOLIANS LOVE IT YES
handuk basah11	walah besok to update nya V V V V V
Ø¬Ø§Ø³Ù… Ø¹	ğŸ‘ğŸ‘ğŸ‘ğŸ‘
Mr LaPrune	Guess I â€™ m staying th10 longer ğŸ˜‚ğŸ˜‚ğŸ˜‚ğŸ˜‚ğŸ˜‚ğŸ˜‚ğŸ˜‚ğŸ˜‚ğŸ˜‚ğŸ˜‚ğŸ˜‚
bwabwa bwa	Menurut saya Yang harus di update adalah waktu memasak pleton di COC
Felipe Jansen	Porque nerfaram a bruxa
El Mejor Diaz	Very good
Ø¹Ù„ÙŠ Ø§Ù„Ø¹Ø±Ø§Ù‚ÙŠ	Ø§ÙƒÙˆ ÙˆØ§Ø­Ø¯ ÙŠÙÙ‡Ù…Ù†ÙŠ
Celso Barrera	El unico nerf fue el de la bruja se puede decir
Soham Tak	Wow
Jishnu Am	Update on tomorrow
MAGIC,TRICK AND FUN	Poor upgrade but good update are also good dragon and Pekka cost should be decreased
Pramod Kumar	Nice what is the dateğŸ˜­ğŸ˜­ğŸ˜­ğŸ˜­ğŸ˜­ğŸ˜­ğŸ˜­
Debasis Khatei	It s cool
X Dragon23	Almost every balance here is jsut decrease gem donation
Clashing With Bittu	Indians hu vai Dhoka mat doo Kaya hoga hamaraaa
ELITE GAMING 57 M&J	I love you supercell and your fabulous Update
Uday Chaudhary Chaudhary	ON WHICH DATE WILL UPDATE COME
Shubham Verma	Hlo mate If any girl need a clan or unable to find clan Then I have a clan consisting of girl U can apply Thanks u
Tamal Sur	BH 9 please Thank you
Francesco Baldassarre	Just one word Decreased
Ardy Yohanes	WITCH LVL 2 ğŸ’¥Damage reducedğŸ”» ğŸ’”Hitpoints reducedğŸ”» ğŸ˜¥ğŸ˜¥ğŸ˜¥
Furkan Ã¶mer AydÄ±n	Very nice uptate
Tam Ly	Im just happy with the max level on generator haha
geovanny edgardo peech vazquez	No le bajan elixir al mazo que uso
El Pac-Man :v Bartolo	Yes D
Denis Danger	After year of waiting they have finally added a new level for mine extractor and drillers
Bob Bib	Is this a good bye for th9 Witch slap
Afzal Abir	Clash Royale type video of balance change ğŸ¤—
Oliwier KoÅ‚akowski	Time of train troop
Brian M	Nooooooo please i love to slap people with witch
Jeet Jb	This is not good
s p	Do good dont do bad ok
Abinesh S	Wow
Onik Anik	We won t Bangladesh national flag please talk to supercell
soufiane DZ	Ø§Ù„ÙŠ ÙÙ‡Ù… ÙŠÙÙ‡Ù…Ù†ÙŠ ğŸ˜‚ğŸ˜‚
Eduard Gidion	So tomorrow is the Update
Kojiro	i got excite on the new level gold pump and drill weeeeeeeeeeeeeeeeeeeeee
ibex 838	when dis update will cone
Keith Michael Tanuidjaja	IM SO HAPPY THAT THEY ADDED NEW LEVEL ON GOLD MINE AND ELIXIR COLLECTOR
Darkman Gaming	Update tomorrow
Ravindu Perera	What s the time
LethalDosage	Stop messing with troop stats What is this the 10th time you ve nerfed the witch Just so you can put it s stats back later This is not a substitute for updating the game This is an issue supercell ha become notorious for It s shady and doesn t do anything to improve the game And in some case it actually take away from the game Unless a troop type is super OP supercell need to stop messing with troop stats
Satyam Kumar Mishra	Why you did wrong with the witch why i always did witchslap attack what will i do now
Legendary gaming	Wow
momo UwU	la ballestas parecen juguetes ahora y con todo ese nerf parecerÃ¡ que esta disparando una torre de arquera nivel 10 a los th11 cualquier th10 le serum ma fÃ¡cil hacerle 3 estrellas y ni se diga th9 posiblemente hacer 2 a los th9 los th8 tambiÃ©n los arrasan deberÃ­an darle buff en vez de nerf
Ryan Brimson	When you mean level 13 do you mean town hall we don â€™ t even have that yet
Melroy Lawrie	R I P town hall 9 ğŸ˜­ğŸ˜­
purple guy	RIP witch
Andy Lechado	Why the wich
Ice Nova	This game is dead
Anonymous Guy	When this update will drop
NeoBrey. YT	Wow q cambios deberÃ­an nuevas tropas like para que vean
V Chandra	Nice for new clashers ğŸ˜ But for OLDğŸ¤”ğŸ¤ğŸ˜“
Yuvi clashers	Lvl 2 witch hit point and attack decreased Now how I will do witch slap
Angel girl	Shut do i have to upgrade this game AGAIN
Ein Zuschauer	I hope there are gon na be some more troop and hero level due to the fact that from th10 every th had 2 additional level for most defs
Lenguyen Le	Láº¡i uplate gÃ¬ váº­y ta cháº³ng biáº¿t tiáº¿ng
Rishav saini	I left playing coc but if you give me 100ruppes daily for playing coc i will play I AM TH12 PLAYER
The One	Thanks COC
Ø§Ø­Ù…Ø¯ Ø§Ø¨Ù† Ø§Ù„Ù…ÙˆØµÙ„	Ø¹Ø±Ø§Ù‚ÙŠ
ivan mansilla	Cuando sale la actualizacion
Aayush Mohite	Nice update
R CREATIONS	Which day u give update
Kulwant Saini	When update is coming
Akseli Huttunen	So i m gon na have 4 dark drill on Th 10
mohamd mlg90	URAHH
MICHAEL TM	Very good nice supersell
Radhika Kommu	Any lvl 100 wall
4n0nym0us	Need Privat chat
Fatima Hamdany	Ù†Ù†Ø¹Ø¹Ù…Ù…Ù…Ù…Ù… Ø§Ø®ÙŠØ«ÙŠÙŠØ±Ø§ Ø§Ù„ØªØ­Ø¯ÙŠØ« Ø§Ù„Ø¬Ø¯ÙŠØ¯ Ù„Ù„Ø¹Ø¨Ù‡ğŸ˜ƒğŸ˜ƒğŸ˜ƒğŸ˜ƒ
Hancock	ĞŸĞ¸Ğ´Ğ¾Ñ€Ğ¸ Ğ½Ğ° Ğ´Ğ¾Ğ½Ğ°Ñ‚ Ğ¸Ğ³Ñ€Ñƒ Ğ±ÑƒĞ´ÑƒÑ‚ Ğ¿ĞµÑ€ĞµĞ²Ğ¾Ğ´Ğ¸Ñ‚ÑŒ
Joshua Aidahir Ramirez Salazar	Buen vÃ­deo ğŸ‘Œ
Prislex X	Every thing is Neft
Harjinder Singh	Day by day coc becoming easier ğŸ˜¨ğŸ˜¨ğŸ˜¨ Remember that day when golem take 45 min to train aloneğŸ˜¢ğŸ˜¢TODAY S clashers will never know that struggleğŸ˜­ğŸ˜­ğŸ˜­ğŸ˜­
24K LIFE	For those who think COC is dead Shut up
Gaming King	Please give u event troopsğŸ™
Anand Samariya	Thanks supercede
SUPER PEKKA 4âƒ£	Infero added ğŸ‘ŒğŸ‘ŒğŸ‘ŒğŸ‘Œth12
RG TAMIL aquarium & plants	Uptateing date
amari badiyo	Welp I m twn hall 3 so I don t know y the hell I m watching this But it s cool anyway ğŸ˜†
Lipton Games	ĞĞ°ĞºĞ¾Ğ½ĞµÑ† Ñ‚Ğ¾ Ğ½Ğ¾Ğ²Ñ‹Ğ¹ Ğ»Ğ²Ğ» ÑĞ±Ğ¾Ñ€Ñ‰Ğ¸ĞºĞ¾Ğ²
Aman Gusain	Ghnta yr wicth k Hotpoint km kr diya aur x bow k bhi gaint k donation gem bada diya ghanta khelo coc ab
Banana Daily	K
Vol Anon	two inferno is still dificult to raid depend in the player base lay out how much more when you make it 3 oh noooğŸ˜©ğŸ˜©ğŸ˜©ğŸ˜­ğŸ˜­ğŸ˜­
Xbox gaming Guy	A ton of balancing ğŸ‘
Erick Reyes Gonzalez	que bien ya maÃ±ana lunes e la actualizaciÃ³n ğŸ’ªğŸ’ªğŸ’ªğŸ‘ˆğŸ‘ˆğŸ‘ˆ
SleepBuster Gaming	Please tell something about halloween
Immortal 210	Love that the word desintecrate lmao Better than thanos
Gamer K	When com the Update
ĞĞ¸ĞºĞ¸Ñ‚Ğ° ĞŸĞ°Ğ²Ğ»ĞµĞ½ĞºĞ¾	Ğ¾Ğ´Ğ½Ğ¸ Ñ‡ÑƒÑ€ĞºĞ¸
Mughilan Nadar	Now thats what i call a balance ğŸ‘ğŸ™‚ well done supercell Keep it up
DutchGamezzify	Rip
TRENTON DOES	Just release it already
prabha yadav	when update come
Mansuri Shahnawaz	My witch Damage ha decreased ğŸ˜­ğŸ˜­ğŸ˜­ğŸ˜­
J-GAMES BR	Removeu meu vÃ­deo deslaik nessa porra E tomei um Street pÃ´r calsa de VC supercell ğŸ˜’ Vai estragar o senho do diabo no inferno
APEX MEGALODON	I wont update dont force me
Abodi Raad	Aen al arb alee afthmha laikkk
jish11	kinda good
Error! Sans	Huh neat
Dan	Ğ ĞºĞ¾Ğ³Ğ´Ğ° Ñ…ĞµĞ»ÑƒĞ¸Ğ½ÑĞºĞ¾Ğµ Ğ¾Ğ±Ğ½Ğ¾Ğ²Ğ»ĞµĞ½Ğ¸Ğµ
VIWA FOOD WORLD JR.	Very good balance Coc Coc is the best game for me then clash royal
Ø¹ØµÙˆÙ…ÙŠ Ù…Ø³Ø§Ø¯	Please sign up and sign me up
Zyrelle Dave Baclor	Nice I always use my gem to donate my team mate
ThatPersonMemes	Omg I need the generator
bijinder Singh	When is the update coming
Pawan Verma	ğŸ™ ğŸ™ ğŸ™
yanix eginto	DEATH IS REAL FOR WITCHğŸ˜‘ğŸ˜‘
Kirito Aiko	Se lo robaron a clash royale Pero esta muy bien gracias y ojalÃ¡ y algÃºn dÃ­a lo pongan en espaÃ±ol saludos desde MÃ©xico
Rale BRO	Who s else hyped for gold mine and elixir collector new lvl xD
Khurshid Chowdhury	Osam
im not smart	Thank god the gem donation go down to the lava hound
Ankan Bhattacharya	I can t understand why the witch is nerved
TWITCH Ferrel	REALLY XBOW GOT NERF
Puhor Kiling	reduce training time al
krishan pal	Some balance are not good ğŸ¤’
Mr. Longinus	Why nerf x bow Its already balanced
IGROMAN	ğŸ¤”
Strikers Ğ¢V	ĞšÑ‚Ğ¾ Ñ‚Ğ¾ Ğ¿ĞµÑ€ĞµĞ²ĞµĞ´Ğ¸Ñ‚Ğµ Ğ¼Ğ½Ğµ
Saheb Ali Khan	keep it top
Manuel Delgado	THANK YOU
kevin hermoso	Am I the only one who doesn t know what Gem donation mean in the game
Coolterraria YT	wow released today
Sanju Singh	Woww nice thanks for clash of clan your update thanks
ĞœĞ°ĞºÑĞ¸Ğ¼ Ğ‘Ñ‹ĞºĞ¾Ğ²	Gem donation cost reduced
Ø³ÙƒØ§ÙŠ Ø¯ÙŠ skay DE 98i	Ø±ÙˆØ¹Ù‡ Ø§Ø­ÙƒÙˆ ÙŠØ§ Ø¹Ø±Ø¨ÙŠÙ†
Harsh harsh	Sir this update coming is 22 10 please explain
RUPAK GHOSAL	X bow damage reduce not a good sign but overall rating 5 10
Ğ£Ğ»Ğ°Ğ½ Ğ¥Ğ°ÑĞ°Ğ½Ğ±Ğ°ĞµĞ²	ğŸ‘
Monica Sotgia	Ma mi preoccupa aggiornamento Non e che facciamo meno stelle ğŸ˜±
Maikol Montagnani	I would like you to add daily reward anyway this is a very good update
champion gamer	Holy crab
It's Rema	H Y P E
TischBein	Nice balancing
ACuteRacingBoi 42	YASS LVL 13 MINES AND PUMPS
GAMING WITH PANJETA	thx for this update
Umair Farooq	Yeh Kia kerdia tune zindagiyan barbaaadi ki taraaf ja rahi hain
TUNAY Rei	Turkiyenin coc reisleri burdaysa 1
Rahul K	Finally someone brought balance to the Universe
Anthomie Santos	Wth xbow damage decreased It cant even deal a lot of damage
Prithwish Khan	Amazing
SurgeHy	is the update tomorrow
Gamerz z	Wow Nyz supercell
Asru Ahmed Auon	When we get this update
Taradito Pro	1 18 what
Elite Gaming	Not so good way to get back old player
Raj Chauhan	Am not satisfied with this update witch damage and Hit point reduced man
GURPREET SADHER	When we see Finleyupdateofcoc
Aasif Ali	Nice work
The Wild Gaming	The update will come tommorow
Ù…Ø´Ø§Ø±ÙŠ Ù…Ø­Ù…Ø¯	Ø§ÙƒÙˆ Ø¹Ø±Ø¨ Ø¨Ø§Ù„Ø·ÙŠØ§Ø±Ø© ğŸ˜‚ğŸ˜‚
aditya pawar	Why you are nerfing the witch she is already fine ğŸ˜¡ğŸ˜¡ğŸ˜¡
JO NPD	à¸ˆà¹‰à¸§à¸”à¸”
TK Khmer Gamer	Wow
kapil pandit vines	wow
David Arango	Why witch
Anandhu Aniya	When is the updation
Sasa1 Mumalo	Coc is coll
SGT Braden33	Yes thank you more level for the Dark Elixir Drill ğŸ˜ŠğŸ˜ŠğŸ˜Š
NithiÅ›h PÅ•aÅ›anth	Change archer tower theme please
La carita feliz :D	Yes I can t wait for the update of Halloween ğŸ‘»ğŸ‘»ğŸ‘»ğŸ˜ŠğŸ˜ŠğŸ˜Š
- -	I HAVE BEEN WAITING FOR THIS
Christian CoC	ğŸ‘ğŸ¤
mrTabascohot	Worthless update
RUD IX	Ø¹Ø§Ø§Ø§Ø§Ø´ Ø³ÙˆØ¨Ø± Ø³ÙŠÙ„
Divyraj Dedun	R I P Witch slap ğŸ˜¥ğŸ˜¥
technical maan	Nice
Damon V. Diggs	Hey balance deeez NUTZ
coc master gamer	in my birthday
pandix player	Ğ• Ğ±Ğ¾Ğ¹ Ğ½Ğ¾Ğ²Ñ‹Ğµ Ğ»Ğ²Ğ» ĞºĞ¾Ñ€Ñ€ĞµĞºÑ‚Ğ¾Ñ€Ğ¾Ğ²
Rishi 0025	Why you decreased witch
Just Some Dude	WITCH GOT SLAPPED on this update then
Girish Tripathy	Man Witches wont be effective at t10 now anymore Wht the heck
ĞŸĞ°Ğ²ĞµĞ» Ğ¢Ğ¸Ñ…Ğ¾Ğ¼Ğ¸Ñ€Ğ¾Ğ²	Ğ˜Ğ½Ñ‚ĞµÑ€ĞµÑĞ½Ğ¾
Shiv Goswami	Bowler and machine s balancing change wa great
Kirkdestroyer 26	Who agree guy ğŸ˜…ğŸ˜…
Jayanta Barman	Tomorrow may be update confirm for clan war league â¤ Notice 0 02
Misu panda	Wow
Mc Muffin	Omaygod
_-Unknown-_ _-Gamer-_	ğŸ‘Œ Perfect Balance ğŸ‘Œ
Bryan Omarion	Gem donation update Lol
ëŒ€ì¥ì¥êµ°	ì´ê±° ë°©ì–´ê°€ ë„ˆë¬´ ìŒ”ì§€ëŠ”ê²ƒ ê°™ì€ë° ë°¸ëŸ°ìŠ¤ íŒŒê´´ê°€
Lazy Gamer568	Well I â€™ m feeling sad for witch
Jorsen Joao	What about UPGRADE TIME
Sadman Mahir	It s really owesome specially siege machine time reduced
Å urÃ£J ÅaGÃ£R	Nerf Witches is best than all
all about technology	Like who do not satisfied with this balance
Gurvinder Singh	I Am very very very very very happy to see this thanks you SUPERCELL
Amit Kumar Paul	will this update be on 22 October
melvin troll	Que mal que borre clash of clan like si hablas espaÃ±ol
Josue Daza	por se actualisa de esa madera no de jara subir alos th 11 y 10 de poco a poco el juego se vuelve aburido
Subhojit Paul	When will the update come ğŸ˜®
Shadow black	wow ğŸ˜±ğŸ˜±ğŸ˜±
Gaming with Siddharth	0 08 How Could Golem be cooked out of Elixir ğŸ˜…ğŸ˜…
Soccer StarZs	They could just say the gem donation are decreased
Alessandro Borghese	Wow ğŸ˜±ğŸ‡®ğŸ‡¹ğŸ‡®ğŸ‡¹ğŸ‡®ğŸ‡¹ğŸ‡®ğŸ‡¹ğŸ‡®ğŸ‡¹ğŸ‡®ğŸ‡¹ğŸ‡®ğŸ‡¹
Pikabro Ultima	Aww man why did they have to nerf the witch Atleast golem and wall breaker are cheaper
TECHn TRAVEL	à´†à´°àµà´‚ à´•à´³à´¿à´•àµà´•à´¾à´¨à´¿à´²àµà´² à´…à´¯à´¿à´¨à´¾à´£àµ
Azat Ã¶zbey	20V2RYQJQ do you join the clan pls
Koteczkowy Marek	Nerf Electro Dragon
Diwas .10	Witch got badly nerfed ğŸ˜¦
JoÃ£o A. Pereira	X Best What
shane lee	When next clan game arrived
Wampum 24	No builderbase balance
Guilherme Lopes	Agora tudo e bem ma barato
DipTa	This is gd
Sourav Gayen	Dear Clash of Clans give some update king or queen
Veenu Khurana	Love everything except that giant gem donation nerf
Nisar Ali	Nice balancing but giant no
STAR BÃ˜Y	Clash of clan if lifeğŸ¤˜ğŸ”¥â¤ï¸ğŸ˜
Gabriel PH play	Ancioso
The Robot Of Gaming	OOOOOF Rip witch
Christian Cottino	Wow
10k Subscribers Without videos	I can t wait to see that update ğŸ‘ğŸ‘â¤ï¸ğŸ˜˜ğŸ˜ğŸ˜ğŸ˜ğŸ˜ğŸ˜ğŸ˜ğŸ˜ğŸ‘ğŸ‘ğŸ‘ğŸ‘ğŸ‘
Amol Raste	Nice
Hadyan Habibi	R I P Witch Neft too much
Md Abdullah Al Noman	I love play coc
AZ GAMER	East and West coc is the best Coc lover like here
Ultimate Clash	Nice that you made new lvl wall but i cant upgrade them i dont have time for steal that much gold or elixer it not making the game beter
DA_FK	Me left coc forever
Gaurav Kumar	Why are you decreased training cost of dragon bcoz Dragon is very important for best attack of COC ğŸ‘ğŸ‘
Rajput Boy	Oh witch attack and hit point reduced
Hamody gamer	Ù…Ø§Ù…Ø¹Ù†Øª Ø§Ù„ÙÙŠØ¯ÙŠÙˆØ© Ù…Ø§ÙÙ‡Ù…Øª Ø´ÙŠ
Suvo Mondal	Which date the update release
Mhamad Gassim	Ø§ÙƒÙ„Ùƒ Ù„ÙŠØ´ Ù…Ø§ØªØ®Ù„ÙŠ Ø§Ù„Ø¬Ø¯ÙˆØ¯ Ø¨Ù„ Ø§Ù„ÙÙ„ÙˆØ³ Ù…Ùˆ Ø¨Ù„ Ø§Ù„ÙƒØ³ÙŠØ±
Javier Marte	Why they put gem donation up for giant
Gurpreet Singh	reduce lawa hound training cost and reduce recovery time for warden warden took too much time to recover keep surprising u keep clashingğŸ’ªğŸ’ªğŸ’ªğŸ’€ğŸ’€ğŸ’€
MilHanSolo	Nice to see the gem donation decrease
Laddi Singh Laddi singh Laddi singh Laddi singh	Wow gurat
Daivid Cruz	So basically they made the witch even worst Wow this suck just leave the witch alone
Wael Wa2oula	WOWWWWW
Leonfnaf	So that mean we can upgrade the goldmine elixir pump and dark driller to lvl 13
kari Dom	Wuuuuiuuii
Karuna Goyal	My th 7 account is hacked
Terminator	sound like gambling for real
Ibad Elahi	Awesome update ğŸ˜ğŸ˜love u super cell
Earth today	Love this game
BlackSarlacc	Personally dont like the xbow change i m th 10 xbow 80dps and archertower 92dps is not the feeling i want when having an max xbow In my view xbow should be superior to an archertower
Ù…Ø§Ù‡Ø± Ø§Ù„Ø¹Ù†Ø²ÙŠ	ÙˆØ´ Ø§Ø³Ø§Ù„ÙÙ‡
Cute Girls Tik Tok	Hi COC how about clouding are you going to doing some change
XÃ³m ÄÃ¬nh TV HOT	Cljt Ä‘Ã©o hiá»ƒu
PaBLo GaaMeR	Meu Deus mais muros e deu ruim
Aayush Thapliyal	Clash of clan lover like here â¬‡ï¸â¬‡ï¸â¬‡ï¸â¬‡ï¸â¬‡ï¸â¬‡ï¸â¬‡ï¸â¬‡ï¸â¬‡ï¸
Sabeer Bikba	Big upgrade balance is resourse upgrade i am exiting ğŸ˜ğŸ˜ğŸ˜‹ğŸ˜‹
Abhay Pawar	Witch hitpoints decrease ğŸ˜”
Feli03gamer	Deop witch
pÃ¥tric kÃ¯rti	thats not good you decreased all the rate of the thing that we don t use and you don t decreased the thing we use like drag or loon
Orlando A Pabon	Seems nice
Akhil vin	Rip GOWIWI strategy user
Xtronic Tube	WitchğŸ˜”ğŸ˜Ÿ
Feyyaz Das Knabbermix	Halloween Update Im so hyped for the Giant Skeleton
Ù…Ø­ØªØ±Ù ÙƒÙ„Ø§Ø´	Ø§Ù„ÙŠ Ù…ØªØ­Ù…Ø³ Ù„Ù„ØªØ­Ø¯ÙŠØ« Ù„Ø§ÙŠÙƒ
Bisin Bbk	Who else is unhappy with nerding witch
salaja khan	Nice
Kawsar Ahmed Badhon	didn t like the witch factğŸ˜©ğŸ˜©ğŸ˜©
lav tazÄ±	Good
Alec Hess	Halloween update
Luxseu	NEW GOLD MINE AND ELIXIR COLLECTOR LEVELS FINALLY
mohammed nomaan	Thank you coc
Mateus Souza	Bring something for th9 pleess
Moko	Wesh y â€™ a de arbes
si ocong	Nice good
Jeffrey Joel	No witchhhhh
iscam you	Wow
Anonymous gg	OMGGGGGG
Nik'z Kingdom	Every thing u about gem Gemmers good news for u all ğŸ¤£
Rockstar Rica	ğŸ˜­Huh mummy is all over
It'sJohn&Harry Gaming	The witch became is poop
Sandeep rajput	What about air troop
Sathish Sakthi	Wow thing is new resource level
ExpressedWolf0	there gon na be lvl 13 gold mine and elixir collector and lvl7 dark elixir drill yes
Ice Blaze	I wa predicting everything wa gon na be a gem decrease after the first few the giant gem increase really caught me off guard
Technical chokra	Thanx bhai me aapka bahut bada fan hu
Saahir 1	Pretty much 1 min 30 sec of reducing gem cost fr troop
Ø¢Ù„ÙØ¬Û£Û—ÛÙ†Û£Û—ÛØ±Ø¢Ù„Ù Ø¢Ù„ÙØ³Û£Û—ÛÙˆÛ£Ø±ÙŠÛ£Û—ÛÙŠÛ£Û—Û	Ø§Ù…Ù†Ø§Ù‚ÙˆÙŠÙ…
GAMER ROY	Why witch hit point decrease ğŸ™„
DEEKSHITH DEEKSH	Sorry I movEdTo pubg
Asmit Kat	Game is with it last breath
CLASH WITH INDIA	Please increase damage of bowler
GAMING LOVER	Any pubg player is hear ğŸ˜‚ğŸ—¾ğŸ‡®ğŸ‡³
Deacon Ho	lit
BlackHack	If this game didn â€™ t get a voice chat with some live 4 to 8 co op mode attack and i mean real live attack not like the shitty night village attack this game will never rise again will they listen Ya By adding more defense and wall
BlueBlitz Star	When is Halloween update
azeri kanal	AZERBAIJAN
S Kumar	Witch hit point reduced but I still love her â¤ï¸â¤ï¸â¤ï¸â¤ï¸â¤ï¸â¤ï¸
daniel gonzalez	genial ahora puedo donar poco gemas
Simple minded Indian	Damn why you nerf down the witch
Gaming with Akhilesh	Tommorow on 1 pm update is coming i am so excited I am in enthusiasion it a very big update quality of life changing update clan war league gem donation decrease training cost decrease hitpower is increased and decreased
MontageCreator	Balanced like all thing should be
ë°•ì‚°í•˜	Got it
S D	Xbow nerfed ğŸ¤¦â€â™‚ï¸ğŸ˜±
SJan Tube	Gem Donation Decreased
SKULLMAX GAMER	Its not balance it hell
LightningProductions	Nice
Ø³ÙŠÙ Ø§Ù„Ø±Ø¨ÙŠØ¹ÙŠ	Ø¹Ø±Ø¨ÙŠ ÙˆÙØªØ®Ø±
Bauti Lauria	1 19 what
Dani050	Nice D
Ranggafajarfirmansyah Rangga	Plis update thanos
Orr Zemer	Does someone still play this game
MA RUL	Omg ğŸ˜±
GTA Ferrari RD	QUE Buena atualizacion
Ù…Ø³ØªØ± Ø­ÙŠØ¯ÙˆØ±ÙŠHD	Ø§Ù„ÙŠ Ø¹Ø±Ø¨ÙŠ ÙŠØ­Ø· Ù„Ø§ÙŠÙƒ ÙˆØ§Ø´ØªØ±Ø§Ùƒ
Mr fayz-altahhn	Make an update to donate silver oxier and dark gold
mahmoed hussien	ÙÙ‰ Ø¹Ø±Ø¨ Ø¨ÙŠØ³Ù…Ø¹ÙˆØ§ Ù‡Ø§ Ø­Ø·Ùˆ ØªØ±Ø¬Ù…Ù‡ ÙˆØ§Ù„Ø¹Ø±Ø¨Ù‰ Ù„Ø§ÙŠÙƒ Ø¹Ø´Ø§Ù† ÙŠÙˆØµÙ„Ù‡Ù… Ø§Ù„ØªØ¹Ù„ÙŠÙ‚
Blunty anims â€¢	pekka didn t get lower DPS OoF
Chang Puo Shen	Nice
CLASH TUBE	WHEN IS THE NEW UPDATE PLZ COMMENT MY COMMENT
Gaming Tamil	TROOPS needed
Akash Gadade	Very excited for tomorrow
Chan Touchkh	love up
N Nura	clash of clan bye ğŸ˜§
Fakenoodles	Holy moly I thought I wa done with resource a a th10 I now have more crap to upgrade ğŸ˜ But I â€™ m still hyped
Shubham Pal	Ok coc I m coming back
Xseron official	
kayla wat nou saak how to draw pull up	Ù…Ø§ ÙÙ‡Ù…Øª Ø´ÙŠØ¡ Ù…Ù† Ù‡Ø°Ø§ Ø§Ù„ÙÙŠØ¯ÙŠÙˆ ÙŠØµØ¹Ø¯ÙˆÙ† Ø§Ù„Ø´ØºÙ„Ø§Øª Ø§Ù„Ù‚ÙˆÙ‡
Lipa	4 3 cool
abrahan show 20	Pero maÃ±ana tan bien ban a poner todos lo nuevo y la tropas y la ligas de clanes todos
Rodrigo Martinez	Por mÃ¡s que no lo uso no me gusta el nerfeo de la brujas pero todo lo demÃ¡s me parece estupendo
Susant Nayak	Cubse
Yan Nunes	Surpecell morreu SomosGarena
Jae Chung	Can you guy do something about the clan perk I mean after lvl 10 there are no additional perk We need some perk Dammit
Ğ”Ğ°Ğ½Ğ¸Ğ» Ğ•Ğ¼ĞµĞ»ÑŒÑ‡ĞµĞ½ĞºĞ¾	ĞÑƒ ÑˆĞ¾ Ğ¿Ğ°Ñ†Ğ°Ğ½Ñ‹ Ğ°Ğ½Ğ¸Ğ¼Ğµ
ĞŸÑ‚Ğ¸Ñ‡Ğ¸Ğ¹ Ğ³Ğ°Ğ¹	Stop CoC have balance
Sayan Asad	I been playing this game for all most 6 year but i never got so much excited for new update apart from new troop because only new troop will shake this game up other thing matter to new one those who are already maxed out they don t care about gem reducing elixer reduce time or anything we want new troop added to the game but nice balanced change at least supercell is giving some time to clash of clan
It`s Rubik Clash	ĞÑƒ Ñ‰Ğ¾ Ğ¿Ğ°Ñ†Ğ°Ğ½Ñ‹ ÑĞºĞ¾Ğ»ÑŒĞºĞ¾ Ñ‚ÑƒÑ‚ Ğ ÑƒÑÑĞºĞ¸Ñ…
abo zeid	Ø§Ù„ØµØ±Ø§Ø­Ø© ÙƒÙ†Øª Ù…ØªØ­Ù…Ø³ Ù„Ù„ØªØ­Ø¯ÙŠØ« Ùˆ Ù„ÙƒÙ† Ø§Ù„ÙˆØ§Ø¶Ø­ Ø¥Ù† Ø§Ù„Ù…Ø³Ø­ Ø³ÙŠÙƒÙˆÙ† ØµØ¹Ø¨ Ø¬Ø¯Ø§
Dio Muhamad S	when new troop added
koutheir gamer	ğŸ˜
Taro	Hopefully Clan Leagues and Halloween stuff is in the update aswell
seema sharma	22 10 is the clan war league coming tomorrow
Ø§Ù†Ø§ Ø§Ù†Ø§	Ø§Ù„ÙŠ ÙÙ‡Ù… ÙŠÙÙ‡Ù…Ù†ÙŠ
Ali	Thanks for clash of clan About new ubdate
sody99	Rip witch and th12 got 3 inferno tower oml and new collector level yay
James Curzon	The best thing is the extra resource building
Heartello	pubg aaisa kyu nai karta
Baccha TV	are bc mine ka update dediya
Nikhath Syeeda	Noooo don t make withchs weak
Harendra Singh	Wall ki upgrading cost toh Kam Kar dete bahut jyada hain
Anurang Chahar	Bro what date is coming
Ù…Ø§Ù„Ùƒ Ø¹Ù„Ø§Ù‚Ù‡ ÙˆØ¢ØªØ³	Ø­Ù„Ùˆ Ù‡ØªØ­Ø¯ÙŠØ« Ø§Ø³ØªÙ…Ø±Ùˆ
Metin Ã‡akmak	OLLLEYY WALKÃœR VE BÃœYÃœCÃœ DÃœÅMÃœÅ
David Morrish	I m happy that the balancing update featured mostly good thing ğŸ˜„
vishwajeet coc	My fav Witches damage decreased
FirstSight Gaming	ooooooHh being a th8 i m satisfied No greediness guy ENJOY CLASHERS witch slaB R I p LÃµL
Ayman AK	nerfing witch keeping those DPS number for electro drag is UNFAIR
PRABHU STAR	PLEASE ANYONE SAY WHEN UPDATE BEGINNING PLEASE
Cheng Yew Hong	Clan castle treasury need to be updated so that player can choose to collect whether gold elixir or dar elixir
muhammad ali	Best update
Kervz Mananghac	super cell should do fps battle royale game
Raushan-k kumar	Nice Updates
Óƒáˆˆãƒ¨Ğ¨[Ğ•] å°¸	Ğ’Ğ¾Ğ¾Ğ±Ñ‰Ğµ ĞºÑ€ÑƒÑ‚Ğ¾
Brent Burnett	Basically drop this release a week before cwl so everyone ha to gem to have an advantage
Zarvon Komroni	Wait so the update is tomorrow
Mubarak Mirza	Thanks I thought you were bad for balancing the universe
Clash with Siddharth	Why witch reduce Mine is on level 2 Is this update coming tomorrow
Riaz uddin	Rip witch th9 10 got trouble with witch slap gobowi ğŸ˜¢
entertainment free	Nowdays i don t want to play
thekinG lol	Wer Deutschland
Ace. C	For a moment tought it wa a CR
Ø²ÙŠÙ† Ø§Ù„Ø¹Ø§Ø¨Ø¯ÙŠÙ†/ Zain-Al-Abdeen	ØªØ±Ø¬Ù…ÙˆÙ„ÙŠğŸ™ˆ
Kb Dudang	what the giant
ali akbar	wow
Nghá»‹ Tráº§n	Wow
Borderlife_ WARRIOR	When is it going to happen though
v1sion	1 22 Lmao There is the Symbol of Elexier But this Machines Cost Gold
Dali Imsirovic	Now witch suck
Phiakliam Wangsu	No witch damage decreased Lol
Hoodh Ahmed	Any one notice that sige machince see left it not gold it elisir And bowler not dark elisir it elisir
WarFarmRepeat	RIP Witch Like to pay respect Edit no bowler nerf
Ranamobeen Ranamobeen	Walls
Franco carretero	Like si no entendiste nada jaja Pero igual se biene fuerte la actualizacion
Vaibhav Ingole	If u have Townhall 10 coc lover Than hit like
TECH KID Agam	How many of u doesn t even care bout gem decreaseğŸ˜‚ I dont cuz i still donate with gem u know im rich ğŸ¤£
Samet UluÃ§am	This is Clash Royale edition
Rajdeep Ghosh	Finally Witch nerfğŸ”¥ RIP th9 witch spammer
dani2004 Michev	Buff Eagle artillery wa my wrost nightmare
Sami Khan	please reduce the cost of wall it s hard to upgrade wall
Meera Agrawal	ğŸ˜…ğŸ˜…ğŸ˜…ğŸ˜…ahhh OK
Ankit Jain	Son of a witch ğŸ˜ ğŸ˜¡
Master Saif	â˜¹ï¸ğŸ’”
Puissance Zelda	Clash of clan â¤ï¸
PJR 420	Its very good but X BOW
Ø¹Ù„ÙŠ ÙˆØ³Ø§Ù… Ø¹Ù„ÙŠ ÙˆØ³Ø§Ù…	Ù…Ø¹Ø§Ø¯Ù„Ø© Ù‡ÙŠ ØªØ®ÙÙŠØ¶ ØªÙƒÙ„ÙØ© Ø¬Ù†ÙˆØ¯ Ù…Ù† Ø§ÙƒØ³ÙŠØ± ÙˆÙƒÙ…Ø§Ù† Ø¯Ø¹Ù… Ø¨Ø¬ÙˆØ§Ù‡Ø± Ù…Ø«Ù„Ø§ Ø§Ø°Ø§ ÙƒØ§Ù† ØªÙ†ÙŠÙ† ØªØ¯Ø¹Ù… Ù…Ø¨Ø§Ø´Ø±Ø© Ø¨25Ø¬ÙˆÙ‡Ø±Ø© ÙŠØµÙŠØ± 20 ÙˆØ£Ù…Ø§ Ø¨Ø§Ù‚ÙŠ Ø¹Ø¨Ø§Ø±Ø© Ø¹Ù† Ù‚ÙˆØ© Ø¬Ù†ÙˆØ¯
Ø§Ù„Ù€Ù… Ø§Ù„Ù€Ø±ÙˆØ­	ğŸ˜
mahmoud sawy	Ya Booooooooyyyyyyyyyyyyyyyyyyyyy
CARTOONS IN ASSAMESE	Love from India
GAMING WITH VISHU	LOVE FROM SUPERCELL LOL BTW I LOVE COC
robert solpico	00 19 Poor witch
Damar Haryo Muhammad Rizqi	I think Giant must keep on 5 gem to donate friend
Triple Gaming	Y u bully the X bow but not eagle artillery
Ù…ØµÙ„Ø­	Ø§ÙØ¶Ù„ Ø´ÙŠ Ø§Ù†Ù‡Ù… Ø®ÙØ¶Ùˆ Ø³Ø¹Ø± Ø§Ù„Ø¨Ø§ÙˆÙ„Ø± ÙˆØ§Ù„ØºÙˆÙ„Ù…
Philemon Langle	Im not happy with this balancing thing it just gon na make thing even worst ğŸ˜ 
santosh kumar	That s really amazing update
Ø¹Ø¨Ø¯Ø§Ù„Ù„Ù‡ Ù…Ø³Ø¹ÙˆØ¯	ÙÙŠÙ† Ø§Ù„Ø¹Ø±Ø¨ ÙˆÙ‡Ù„ Ù…Ø±Øª Ø§Ù„Ù‚Ø§ÙÙ„Ø© Ù…Ù† Ù‡Ù†Ø§
ASSASSIN 3.0	ğŸ˜ so great thank u supercell
Veer Maratha	What is the release date of update
Football-fifa Russia	ĞšÑ€ÑƒÑ‚Ğ¾
HACKER_bro	I think this balance is ok i waiting for new lvl of colectorğŸ˜‰
Ggman2002 Goudeos	Bring sparky on coc plez
gaming champ	ğŸ‘
Ø¯Ù…ÙˆØ¹ Ø§Ù„ÙˆØ±Ø¯	Ø´ÙØªÙ‡Ù…Øª Ù‡ÙØ³Ù€â„•È±Õ¡ Ø§Ù†Ù€Ù€ÙÙÙ€ÙÙÙÙÙÙ’Ù’Ù“Ù“Ù€Ù€Ù€ÙÙÙÙÙÙÙÙÙÙÙÙMÃŠÙ€Ù€Ù€ÙÙÙÙÙÙÙŠ Ø§Ù„Ø¹Ø±Ø¨ÙŠ ÙŠØ¬ÙŠ ÙŠÙÙ‡Ù…Ù†ÙŠ
drake da dawg 62	i like the part where they showed an image and made a ding noise
Vasya Tyutyunnikov	Crazy
ANONYMOUS 100111	Awesome uptade
Spoxy Doxy	You made the witch sick
patukka boi	Balance building cuz crusher is too op
FormZ	3 Inferno Towers
Mirzado	what about the new clan war
MrAlen61	Lmao you gon na make all troop cost 1 elixir and dark elixir and make them train for 1 second
Ù…Ø¬Ù‡ÙˆÙ„ 112	ØŸØŸØŸğŸ˜•ğŸ˜¤ğŸ˜¤ğŸ˜¤ğŸ˜¤ğŸ˜£
Murthagg	Nickel rien pour le th9
DARKMAN MCPE/GT	DON T NERF
Omar Ali	Why don t they reduce the wall price
Aman Sharma	Nice sir ji
Ernest Satymkulov	ĞĞµ Ğ¿Ğ¾Ğ¼ĞµÑˆĞ°Ğ» Ğ±Ñ‹ Ğ¿ĞµÑ€ĞµĞ²Ğ¾Ğ´
scottyCZ	You could have said that everything got reduced cost and donation cost
Sumit Bhumij	Love you coc
PRIYANSHU SAHAY	Yepeeeeee
Reini Gaming	Cool
Gaming_with_Bharat	Along with Gem Donation Training time should be decreased If You are intrested on this topic like this
Ben Kibo001	Yooooo tommorow up comeğŸ˜ŠğŸ˜Š Like who interested Also bowler cost is low nowğŸ˜€ğŸ˜€
Pocket Gamer	Only Gemcoast and Eleccoast
FireShine - Minecraft	I love this update
Ø§Ù†Ù…ÙŠ fariy tall	Ø§Ù†Ø§ ÙÙ‡Ù…ØªğŸ˜ Ø±Ø§Ø­ ØµÙŠØ± ØªØºÙŠØ±Ø§Øª Ø¨Ù‚ÙˆØ© Ø§Ù„Ø¯ÙØ§Ø¹Ø§Øª ÙˆØªØ¨Ø±Ø¹ Ø§Ù„Ø¬Ù†ÙˆØ¯ Ù…Ø«Ù„Ø§ Ø§Ù„Ø¹Ù…Ù„Ø§Ù‚ ØªØªØ¨Ø±Ø¹ Ø¨2Ø¬ÙˆÙ‡Ø±Ø© Ø§Ù„Ø§Ù† Ø±Ø§Ø­ ÙŠØµÙŠØ± Ø¨3Ø¬ÙˆØ§Ù‡Ø± ÙˆÙŠÙ…ÙƒÙ† Ø§ÙƒÙˆ Ø²ÙŠØ§Ø¯Ø© Ø¨Ù„ÙÙ„Ø§Øª Ø§Ù„Ø¬ÙŠØ´ ÙˆÙ…ÙˆØ¹Ø¯ Ø§Ù„ØªØ­Ø¯ÙŠØ« ØºØ¯Ø§ ØŸ
Owen360 - Gaming & Animations	In Clash of Clans the Witch get nerfed In Clash Royale the Witch is the complete opposite of what the Clash of Clans Witch doe
Eat This	what about the tornado trap
Yash Singh	ğŸ¤˜ğŸ‘
Ubed Sayyad	Wow so nice balincing
SickMaster2010 The Last Gamist Gender	I wa happy when I saw the dragon decrease oh wait that s not elixir bought
404 Nation	People still play this game Ok
Trap Bass	I am a COC gamer
AntonioMartic YT17	Eagle artillery is really overpowerd You should better decrase it s power
Adrian Bosch	Th12 village are gon na be much more powerful with a 3rd Inferno Tower
General Mici	Qija nanen
Demon Blue	Cool
Ragendra Subba	Going to miss GoWiwi
x â€¢shy	Is balance the only truth Oh sorry that wa from the other game Good adjustment Nerf miner tho
pitit bonum	NO ARK X DAMAE ARE INCRASE THERE ARE ALREADY POURRI TROP NUL
Gaming With Rdx - Clash Royale & Clash Of Clan	Seems good except for the witch nerfğŸ˜’
BLASTARD royale	Witches r getting nerfed when I m getting it to max omg
EVIL KH GAMING Arabic	Thanks for the video
KaputtFalaMurai LPs	Is anyone really still playing CoC lol
Dave123223 YT	omg
TheOnly ShinyUmbreon	I m pretty satisfied with these balance but maybe a slight nerf for the bowler could do a little good a well
HYPERSPACE	Very bad balance
The Sk Zone	Indians Bhailog Like karo kitne Bhai he yaha
Felipe ClashYT	Gostosa clÃ£ e nÃ£o Itu eu nÃ£o tenho mais de um ano novo e
Gaurav Ray	Best game of Clash Of Clans
Mass	Perfectly Balanced Means the End is Near of coc
NITIN suryawanshi	Need some more change
sak ib	Awesome what a update
TOKYO GOUL KANEKI	Good ha
Meet Patel	I am waiting for Diwali loading screen Anyone else
Ilias Kassymzhan	ĞšĞ»ĞµÑ‡ Ğ¾Ñ„ ĞºĞ»Ğ°Ğ½Ñ Ğ´Ğ°Ğ¼Ğ¸ Ğ±ĞµÑ€ Im from Kz
Roshan Gopal	Why witch that s my favourite troopğŸ˜¢ğŸ˜¢ğŸ˜¢
Prof omar	Iam th 10 and my hero are lvl 30 and 3 canon and 4 archer tower remaining to upgrade to be max and ofcurse the wall and the new stuf for tomorrow
Like Wagon	RIP GoWiWi Mother Witch is nerfed but their husband wa still OK And about wall prepare yourselves for your gold And me preparing for resource tho collector are just important
bigmarvel eating chicken	So actually every troop gem donation is decreased
Mosa Hedr	Ø¨ÙƒØ±Ø±Ø±Ø±Ø±Ø§Ø§Ø§Ø§Ø§
This Guy	Nice but can u do some more stuff for th9
Jyoti Dakaha	Coc lover like
Venkatesh k.j	Additional INFERNO TOWER For TH12ğŸ˜µğŸ˜µğŸ˜µğŸ˜µğŸ˜µğŸ˜µ
Universeteach teach	We are waiting
sriman m	Super
ĞºĞ»ĞµÑˆĞµÑ€ Ğ·Ğ°Ğ´Ñ€Ğ¾Ñ‚	ĞšĞ¾Ğ³Ğ´Ğ° Ğ¾Ğ±Ğ½Ğ¾Ğ²Ğ° Ğ²Ñ‹Ğ¹Ğ´ĞµÑ‚
Sai Kumar	This will doe ntg helpful game eventhough nothing change happpens
BARIÅ BRA	Ä°NÅALLAH BALANCE YAPIP BIRAKMAZLAR KLAN SAVAÅLARI LÄ°GÄ°NÄ° DE BEKLÄ°YORUZ SUPERCELL 3
vicky Singh	very good
Ø¬Ù„Ø§Ù„ Ù…Ø±Ø´Ø¯	Ø¨Ù„ÙŠØ² Ø¯Ø³ Ù„Ø§ÙŠÙƒ
Salma Ilyas	Plz decrease the cost of miner
In Pulse	Yay I love update
Pranjali Anjankar	PLEASE MADE BUIDER BASE 9TH
Layton Walsh	boiiiiii
ALL ABOUT ANDROID	Love from India
The_cHosen _onE	But the graphic is still suck
Jeric Lao	Thank u coc the cost are reducing oh yeah
Tushar Chhabra	Wow
Keidar Game	ĞŸĞµÑ€ĞµĞ²ĞµĞ´Ğ¸Ñ‚Ğµ Ğ¼Ğ½Ğµ Ğ½Ğ° Ñ€ÑƒÑÑĞºĞ¸Ğ¹ ĞºÑ‚Ğ¾ Ñ‚Ğ¾
ANOTHERONE LEADER	see green red arrow me feel something wrong
Aldro Ace D Buenavista	Thanos hahahahha
sina wasiq	Thank you supercell ğŸ‘
ALBIDO'S TALES	ğŸ‘but what a hell the artillery damage increase
muhammad ripa.i	tumben ada balance update
Punjabi Status	Witch ğŸ˜¢ğŸ˜¢ğŸ˜¢ğŸ˜¢ğŸ˜¢
Deep Tejwani	Godd balancing
moon light	witch nerf ğŸ˜­
ÙØ§Ø¶Ù„ Ø¹Ø¨Ø¯ Ø§Ù„Ø£Ù…ÙŠØ±	layl mawt babiji maanryd laeibtakum
syed parvez	Coc fan like ğŸ‘‡ğŸ‘‡ ğŸ‘‡
FANS ALAN WALKER	Where clash tv Im wanted a clash tv
Eliezer Markov	Wow can t wait
Ğ‘Ğ°Ñ…Ñ€Ğ¾Ğ¼Ğ±ĞµĞº ĞÑ…Ğ¼ĞµĞ´Ğ¾Ğ²Ğ¸Ñ‡	Why
SAWON KUMAR Kundu	Good
Nazif Neziri	Hi clash of clan where is coming the snow â„â„â„in clash
Mansoor Malnas	No loot is showing how can we play only searching in game 4 loot what is this i can play more this game
ĞœĞ¸Ñ…Ğ°Ğ¸Ğ» ĞĞµĞ´Ğ±Ğ°Ğ»ÑŒÑĞºĞ¸Ğ¹	Ğ Ñ‚ÑƒÑ‚ ĞµÑÑ‚ÑŒ Ñ€ÑƒÑÑĞºĞ¸Ğµ
CAPT. IRON	Hellk supercell
UnlegitLegy	Hm i dont Like this Witcher Nerf SÃ¼ÃŸ Not so good at the moment
omar mahmoud	Ø§Ù„Ø¹Ø±Ø¨ÙŠ Ù„Ø§ÙŠÙƒ
AJ STYLES 123	Nice
MineGIO 384	NOOOOOOOOO la strega NOOOOOOOOO
Leftenan Akmal	I can t believe the inferno tower now not hot like the old one
Dark Boy	Uggh witch hitpoint reducedğŸ˜­
md saleem kba	When it come
I comment at comment sections	You re all fixing the ever so balanced clash of clan and you guy just stare in the overleveled Royal Giants Dominating in the Arenas
Nidhish Shetty	Witch is dead completely ğŸ˜­ğŸ˜­ğŸ˜­
Vince La Malice	NICE Gowiwi nerf
Veftogo Gaming	Thank you ğŸ˜šğŸ˜šğŸ˜šğŸ˜šğŸ˜šğŸ˜š
SaykOyuncu Tr	Iyi olmamÄ±ÅŸ
Kitty Crusher	I do not like the Balancing of Witch
Michael Amorim	SÃ³ o Br s viciado COC deixando like aqui ğŸ‘ğŸ‘
Mahmoud RJ	Ø¨Ø§Ù„Ù†Ø³Ø¨Ø© Ø§Ù„ÙŠ Ù…Ø§ ÙÙ‡Ù…Ùˆ ØªØ®ÙÙŠØ¶ ØªÙƒÙ„ÙØ© ØªØ¯Ø±ÙŠØ¨ Ù„Ø¨Ø¹Ø¶ Ø§Ù„Ø¬Ù†ÙˆØ¯ Ùˆ ØªÙ‚Ù„ÙŠÙ„ Ø§Ù„Ø¯Ø¹Ù… Ø¨Ø§Ù„Ø¬ÙˆØ§Ù‡Ø± Ø¨Ø±Ø¬ Ù†Ø§Ø± Ø«Ø§Ù„Ø« ÙÙŠ Ø§Ù„ØªØ§ÙˆÙ† 12 Ø¶Ø¹ÙÙˆ Ø§Ù„Ø§Ù‚ÙˆØ§Ø³ Ø¶Ø¹ÙÙˆ Ø§Ù„Ø³Ø§Ø­Ø±Ø© ÙˆÙŠØªØ´ Ø²Ø§Ø¯Øª Ù‚ÙˆØ© Ù…Ø¯ÙØ¹ÙŠØ© Ø§Ù„Ù†Ø³Ø± ØªÙ‚Ù„ÙŠÙ„ ÙˆÙ‚Øª Ùˆ ØªÙƒÙ„ÙØ© ØªØ¯Ø±ÙŠØ¨ Ø¢Ù„Ø© Ø§Ù„Ø­ØµØ§Ø± Ù„ÙÙ„ Ø²ÙŠØ§Ø¯Ø© Ù„Ù„Ø§ÙØ®Ø§Ø® Ù„ÙÙ„ Ø²ÙŠØ§Ø¯Ø© Ù„Ù…Ù†Ø§Ø¬Ù… Ø§Ù„Ø°Ù‡Ø¨ Ùˆ Ù…Ø³ØªØ®Ø±Ø¬Ø§Øª Ø§Ù„Ø§ÙƒØ³ÙŠØ± Ø§Ù„ØªØ¹Ø¯ÙŠÙ„ Ø¹Ù„Ù‰ Ù†Ù‚Ø§Ø· Ø§ØµØ§Ø¨Ø© Ø§Ù„Ø¯ÙØ§Ø¹ Ø§Ù„Ø¬ÙˆÙŠ
Babu Kumar	It official tommorow is updateğŸ˜™ğŸ˜™ğŸ˜™ğŸ˜™ğŸ˜™ğŸ˜™ğŸ˜˜ğŸ˜˜ğŸ˜˜ğŸ˜˜ğŸ¤©ğŸ¤©ğŸ¤©ğŸ¤©ğŸ¤©ğŸ¤©ğŸ¤©ğŸ¤©ğŸ¤©ğŸ¤©ğŸ¤©ğŸ¤©ğŸ¤©ğŸ¤©ğŸ¤©
Ian Wooller	Is everything being included in this update a it could be to much
Virk 22	ğŸ˜±ğŸ˜±ğŸ˜±ğŸ˜±ğŸ˜±
PETE P	Perfectly balanced a all thing should be
khreve pakdak	definitely price drop since nobody ha this game in their phone anymore consumer knew supercell are bloodsucking them thats why many left and never return When supercell knew their game going downtrend they found Tencent to bought them in 2016
Games of galaxy	Ø¹Ø±Ø¨ÙŠ Ù„ÙŠÙƒ
Suraj Samantaray	Now witch slap is gon na going to very hard
Shmeado	must play clarsh
Killer RJ	when it come
Terraria Gaming179	Omgâ˜º
Antiquus Custos	We like it Supercell Clash On
Niraj Kumar	When the update came
karan gamer	ğŸ˜ğŸ˜ğŸ˜ğŸ˜ğŸ˜˜ğŸ˜˜ğŸ˜˜
AximTM	Nerf
Abdul Kadir	Bohot acchağŸ‘
Jhuls ancheta	I m so very very happy to this update
Shivam Singh	that s good
Suraj Master	All still play this
Dj Hazardous	Giants where the last thing I thought would have a Gem Donation Increase
CRICKET FANs	Like frome Pakistan ğŸ‡µğŸ‡° and you all frome ğŸ¤”
AJ STYLES WWE	RIP WITCH ğŸ˜¢
Awe Rock	Bruh the witch is always being nerfed Thats why nobody us it
Purushoth K	Clan war leagueğŸ¤”
Yassin B.	Yes a new update
Abhijit B	R I P WITCH SLAP
Punjabi records	But when
Ø­Ø³ÙŠÙ† Ø¹Ù„ÙŠ	ÙŠÙ…ØªØ§ Ù‡Ø°Ø§ Ø§Ù„ØªØ­Ø¯ÙŠØ«
Ra6aN K	Ø§Ù„Ù…ÙØ±ÙˆØ¶ Ø§Ù†ÙƒÙ… ØªØ­Ø·ÙˆÙ† Ù…Ù‚Ø·Ø¹ Ø¨Ø§Ù„Ù„ØºØ© Ø§Ù„Ø¹Ø±Ø¨ÙŠÙ‡
SILLY CORNER	Now I will not do witch slap
FrostyMcFreeze	Gem Donation Decreased
Jai Bhim Channel	What is meant by gem donation Anyone tell me
Curzpath	This update is definitely huge shut down for those who just get to th9 Sad react only
Vinh The	Where the magic hammer
irvin the pro gaming	love balance update I really love the new level on dark elixir drill
Himal Gurung	I think supercell must reduce housing capacity of e dragon dragon pekka golem witch
WORLD GAMES	ÙˆØ´Ùˆ
ĞœĞĞ›Ğ«Ğ¨ Ğ“Ğ›Ğ£ĞŸĞ«Ğ¨	ĞºÑ€ÑƒÑ‚Ğ¾
Rajeev Kumar	yeah
Ali Alkarbalae	Ø§Ø¬Ø§Ù†Ø¨ Ø¯Ø³ Ù„Ø§ÙŠÙƒ Ø¹Ø±Ø¨ Ù„Ø§ÙŠÙƒ
Charles Wallace	Well at least I get new level drill mine and collector at th10ğŸ˜‚ğŸ˜‚ğŸ˜‚ Thanks supercell
ebubekir ipek	Gem Donations ne demek
Cas Per	Ø§Ù„Ø¹Ø±Ø¨ØŸ
Rafiaz Islam	Nice new change but the damage of x bow is already le why you decreased it ğŸ¤”
Ø§Ù„Ø¯ÙˆÙ…ÙŠ al dome	Ø§ÙƒÙˆ Ø¹Ø±Ø¨ Ø¨Ù„Ø·ÙŠØ§Ø±Ù‡
Jens Erik Jelstrom	DAMN witch Got nerfed
jay ek player	Nice
ÙÙ‡Ø¯ Ø§Ù„Ø²ÙˆØ¨ÙŠÙƒ fÃ hdalzobic	Ø§Ù„ÙŠ ÙÙ‡Ù… ÙŠÙ‚ÙˆÙ„ÙŠ Ø¨Ø§Ù„Ù„Ù‡ ğŸ˜‚ğŸ˜‚
Arun Neupane	I did not understand the last one what doe it mean 100 Wall piece can be upgraded to level 13 ğŸ˜¦ğŸ˜§ğŸ˜µ
JK MUSICS	on whuch date it will come i am waiting for update
Omar Gaber	ÙŠØ§Ù„Ù„Ù‡ Ø§Ù„Ø¹Ø±Ø¨ Ù„Ø§ÙŠÙƒ ÙØ²Ø¹ØªÙƒÙ…
Atit Patel	Nice balancing update
Rakesh Kureel	Why x bow damage reduce
TJThrasher 7G	The whole video in a nutshell Gem Donation Decreased Gem Donation Decreased Gem Donation Decreased Gem Donation Decreased Gem Donation Decreased Gem Donation Decreased Gem Donation Decreased Gem Donation Decreased
Freddy Fatbear 03	Well this is a good balance update to the game Good work ğŸ‘
Aileen Ventura	Why the x bow man
ã©ã‚€ ã©ã‚€	é‡‘ã‚¨ãƒªãƒãƒ³ãƒ—ã®æ–°ãƒ¬ãƒ™ï½±ï½»ï¾â”â” ï½¥Ğ´ï½¥ ã‚â”â”ï½½
Ø¹Ø¨ÙˆØ¯ abod	What is the meaning of the section
Purushotam Sah	Only tympass I already uninstall this my th12 with level 203
sanjay sharma	Thanks
Crack The Puzzle	Even Thanos didn t do that much of balancing ğŸ˜²ğŸ˜²
WAEL WRL	Ø§ÙƒÙˆ Ø¹Ø±Ø¨ Ø¨Ø·ÙŠØ§Ø±Ø© ğŸŒš
atom ix	Witch is nerfed ğŸ˜¥
Egor Pozitiv	Ğ’Ğ¿ĞµÑ€Ğ²Ñ‹Ğµ Ğ²Ğ¸Ğ¶Ñƒ Ğ¸Ğ·Ğ¼ĞµĞ½ĞµĞ½Ğ¸Ñ Ğ±Ğ°Ğ»Ğ°Ğ½ÑĞ° Ğ² CoC
Äá»©c Parker	Come on man I just got my first xbow
HCG Hi Candy Games	à¹„à¸­à¹‰à¹€à¸«à¸µà¹‰à¸¢à¸¢à¸¢à¸¢ à¸­à¸´à¹€à¸à¸´à¸¥à¹‚à¸”à¸™à¸šà¸±à¸ à¹€à¹€à¸•à¹ˆà¹€à¸­à¹‡à¸à¹‚à¸š à¹‚à¸”à¸™à¹€à¸™à¸´à¸Ÿà¸ˆà¸šà¹€à¸¥à¸šà¸Šà¸µà¸§à¸´à¸•ğŸ‡¹ğŸ‡­
Iti .	Nice balance update clash of clan
Prashant Wason	They didn t mention that they were adding a third inferno tower for th12
Ù…Ù†ÙˆØ¹Ø§Øª ÙƒÙˆÙ…ÙŠØ¯ÙŠØ© ÙˆÙ…Ø¶Ø­ÙƒØ©	Ù„Ø§ÙŠÙƒ Ù„Ù„Ø¹Ø±Ø¨ğŸ–’
Rajesh Mondal	Plz fast update date and clan name change or Bengali language
BoltCraft PlayPE	Hype
jayanth nihaal	Join my clan Farming Maestro
IHAB o	Ø¹Ø±Ø¨ÙŠ Ù„Ø§ÙŠÙƒ
Î—Î»Î¯Î±Ï‚ Î˜ÎµÎ¿Î»ÏŒÎ³Î¿Ï…	Halloween
Ø±Ù…Ø¶Ø§Ù† Ø¹Ù„ÙŠ	Ø¨ÙƒØ±Ø§ ØªØ­Ø¯ÙŠØ« Ù‡ÙŠØ¯Ø§ Ù„ÙÙ‡Ù…ØªÙˆ Ø¨Ø³ ØªØ¹ÙŠÙ† Ù„Ø¬Ù†ÙˆØ¯ğŸ˜”Ù…Ø§ÙÙ‡Ù…Øª Ø´ÙŠ
li8 _	Ø§ÙØ¶Ù„ ØªØ­Ø¯ÙŠØ« ÙÙŠ Ø§Ù„Ø¹Ø§Ù„Ù…
shamana	NO NOT THE XBOW
Punjab Records	Excited for new level of resource ğŸ˜Š
TECH THERAPY *GTECHLAND	Is it tomorrow new collector
Didi Stejus	Hei supercell adakan updet bangunan kalau bisa ada daily reward
Abas Ahmad	Ø§Ù„Ø¹Ø±Ø¨ Ù…Ø±Ùˆ Ù…Ù† Ù‡Ù†Ø§ğŸ˜
Benjamen Wikrent	I think there is something else supercell is hiding
INTERNET HULK	Nice I love it ğŸ˜ğŸ˜ğŸ˜
Ignatius The Great	is this supposed to make th 12 le 3 starrable
R.D.K	omg th 13
Hamza Ghaffar	Such a noob update ğŸ˜£
ROI TV	About time Three Inferno Tower is going to be a game changer
Epicel Zey	Meh
abdullah Hassan	Ù‚ØµØ¯Ù‡Ù… Ø®ÙØ¶Ùˆ Ø³Ø¹Ø± Ø§Ù„Ø¬Ù†ÙˆØ¯ ÙƒÙ„Ù‡Ø§ Ùˆ Ø§Ù„ÙŠ ÙŠØ±ÙŠØ¯ ÙŠØ¬Ù‡Ø² Ø¬Ù†ÙˆØ¯Ø¨ Ø¬ÙˆØ§Ù‡Ø± Ø®ÙØ¶Ùˆ Ø³Ø¹Ø± Ø§Ù„ØªØ¬Ù‡ÙŠØ² Ùˆ Ù†Ù‚ØµÙˆ Ø¯Ù… ÙˆØ§Ù„Ø¯Ù…Ø¬ ØªØ¨Ø¹ Ø§Ù„Ø³Ø§Ø­Ø±Ø© ÙŠØ¹Ù†ÙŠ ØµØ§Ø±Øª ØªÙ…ÙˆØª Ù…Ù† Ù‚Ù†Ø¨Ù„Ø© ÙƒØ¨ÙŠØ± Ù…Ø«Ù„ Ø§Ù„ØªØ­Ø¯ÙŠØ« Ø§Ù„ÙŠ Ø±Ø§Ø­
Ù…Ø­Ù…Ø¯ Ø§Ù„ Ø­ÙŠØ±Ø§ÙˆÙŠ	Ø§Ù„ØªØ­Ø¯ÙŠØ« Ù…ØªÙ‰ Ø§Ù„Ù‰ Ù…Ø¹ÙŠ Ù„Ø§ÙŠÙƒ
hosein 007	Es wird geil
Petreq	Nooo ğŸ‘ğŸ‘
Ø§Ù„ØµØ¨Ø§Ø­ ÙŠØ­ÙŠ	can some one explain to me
King D - Mind	Finally a new level for resource collector I â€™ ve been asking for this since 2016
Doraemon and Nobita SAAD	Wow only th10 like
Ø­Ù…Ø¯Ø§Ù†ÙŠ ÙƒÙØ´Ø©	ÙˆØ§Ù„Ù„Ù‡ Ù…Ø§ÙØªÙ‡Ù…Øª Ø´ÙŠ
Dan Enanoria	Here come another Witch Nerf
alok agrawal	When Halloween Update Is Going To Come Then
Pablo FernÃ¡ndez	GEM DONATION DECREASED
General YouTube	Super balancing
Efe Ã–ztÃ¼rk	Guncelleme ne zaman ya
Exb Exbattalion	What day update
Whampire II	wish this update reduce hero healing time ğŸ˜…
ãƒ„áš¡É¨ÓÆ·Æ–	Why all comment are from Indian player
Arin jain	22 taarik ko update aa rha h na
Syed Adil	Nice balancing
Thakur Shivam	Superb update
Ù„ÙŠØ« Ø§Ø¨Ùˆ Ø§Ù„Ø¹Ø±Ø¬	Ø§Ù„ÙŠ Ù…Ù† Ø¬ÙŠØ´ Ù†ØµØ±Øª Ù„Ø§ÙŠÙƒ ğŸ’
True Hacker	I also like supercell
Mohammad Sayem	Reduce lvl 12 wall cost
Ayush singh Bisht	Cr is best
Vishal Verma	plss give a special keyboard for chat and bestest emojis in coc plsssss and also give a feature to know the last seen of any player and give a feature to know that player is typing
STRIKE GAMER	The witch are very dÃ©bil
Ğ¸Ğ¼Ğ°Ğ¼ ĞºĞ°Ğ·ÑƒĞ²Ğ°ĞµĞ²	ĞĞ¸Ñ„Ğ¸Ğ³Ğ° Ğ½Ğµ Ğ¿Ğ¾Ğ½ÑĞ»
Ø·Ø§Ø±Ù‚ Ø³Ø¹Ø¯ÙŠ	Ø§ÙƒÙˆ Ø¹Ø±Ø¨ Ø¨Ù„ Ø·ÙŠØ§Ø±Ù‡ ğŸ˜‚ğŸ˜‚
Rohit kumar	Who is satisfied from balancing ğŸ˜…
Cameron Gray	1 08 3 INFERNO TOWERS AT TH12 THAT IS NOT MINOR BALANCING
Eslam Neo	OMG this update is incredible ğŸ‘Œ
Ø§Ø­Ù…Ø¯ Ø§Ø¨Ùˆ Ø¹Ø¯Ù†Ø§Ù†	Ù†ØªÙ…Ù†Ù‰ Ø§Ù†ÙƒÙ† ØªØªØ±Ø¬Ù…Ùˆ Ø¨Ø§Ù„Ø¹Ø±Ø¨ÙŠ Ø§Ù„ÙŠ Ù…Ø¹ÙŠ Ù„Ø§ÙŠÙƒ
RoyaleBrosHD	So cool
ÄÃ¥mÃ¯ÅˆÄŸ Ã…ÄÄÃ¯Ä‡Å¥	Well TH 13 is not far though ğŸ’™ Hit like if you noticeğŸ˜šğŸ˜™ğŸ˜—ğŸ˜ India
Nitin bhai	I like it
GamerLogic	No one donates troop with gem
Neeraj balu	Waiting for tomorrow
VK VIVEK SHAH	Love from india
Captane Jack	That s a good change but the witch power is nerfed ğŸ˜¨ğŸ˜°ğŸ˜°ğŸ˜°ğŸ˜±ğŸ˜±ğŸ˜±
TheLil Turks	THATS ALOT OF DAMAGE
Sai Prakash	Any update date confirmed
Kodama Kaam	Ø¨Ø§Ø¬Ø± Ø§Ù„ØªØ­Ø¯ÙŠØ«
YOUTUBE Gaming	I think witch should have dark elixir
THE THINGER	1 02 New skin of lavaloon Is amazing
Sub - Zero	Thank you for the balancing please heart my comment
Bhashana Harischandra	Clashers are waiting
Wulyo Edi	I like clash of clan
ĞÑ€ÑĞ»Ğ°Ğ½ Ğ˜Ğ±Ğ°Ñ‚ÑƒĞ»Ğ»Ğ¸Ğ½	Yes thanks
Agni The Hydra	We will never be a maxed TownHallğŸ˜‚
Valeriu Gosav	Another inferno it s too much
Ø§Ù„Ø´Ø¨ÙˆØ§Ù†ÙŠ	Ø¹Ø±Ø¨ÙŠ Ù„Ø§ÙŠÙƒ
Manas Vora	this is a massive balance update
All in one pvt ltd	Any th 11
Budi Prakoso	3 maxed multi mode inferno s spell the end for witch RipğŸ˜‚
BC Logic	Anyone th 8 like thoko
Night Bot	Why xbow damage going to low
Nadziej _	YEAH MORE WALLS
Vijay wakle	I just came here to say goodbye coc
gamer X	Woww tnx for new update because everytime i use gowipe it cost me 1190 dark elixir so this update benifit the gowipe user
Black Knife Gaming	Omg I love this update with the exception of the witch Why she need a nerf Maybe I will be put in the next Q A
Jagpreet Singh	Best game ğŸ‘ŒğŸ‘ŒğŸ‘ŒğŸ‘Œ
Knight of The king	Yeahhhh I love you clash of clan
It's Me BlackHeart	All Th9 s gon na hate Witch s balance update ğŸ˜¥
Qusay alwaled	Ù„Ø¹Ø±Ø¨ÙŠ Ù„ÙŠ Ø¹Ù… ÙŠØ´ÙˆÙ ÙˆÙ…Ø§ Ø¹Ù… ÙŠÙÙ‡Ù… ÙŠØ®Ø¨Ø· Ù„Ø§ÙŠÙƒğŸ˜‚
Team King	ĞšÑ‚Ğ¾ Ğ¸Ğ· Ğ Ğ¾ÑÑĞ¸Ğ¸ Ğ»Ğ°Ğ¹Ğº
Fran Dan57	The miner and the elixir collector at lv 14 and dark elisir collector at lv 7
Ø§Ù„Ù…Ø¹ØªØµÙ… Ø¨Ø§Ù„Ù„Ù‡ Avin	ğŸ˜ğŸ˜ğŸ˜
ÙˆÙ„ÙŠØ¯ Ø§Ù„Ø­Ù…ÙŠØ¯ÙŠ	Ø´Ø¨Ø§Ø¨ Ø­Ø¯Ø§ Ø¹Ø±Ø¨ÙŠ ÙŠØªØ±Ø¬Ù… Ù„Ù†Ø§ ÙˆØ§Ù„Ù„Ù‡ Ø´ÙƒÙ„Ùˆ Ø´ÙŠ Ø­Ù„Ùˆ Ø§Ù„ÙŠ Ø¨Ø¯Ùˆ ÙŠÙÙ‡Ù… Ù„Ø§ÙŠÙƒ Ù…Ø´Ø§Ù† ÙŠØ±ØªÙØ¹ Ø§Ù„ØªØ¹Ù„ÙŠÙ‚
Hacked I am is	Woooow
Phoenix Webster Gaming	Nice copy of CR xD nice change some WHAT s thru out the vid but it will be fine
joey kill	THAT S A LOT OF DAMAGE
Atahan AkyÄ±ldÄ±z	This is not balancing this is overbuffing
Ù…ØªÙ†ÙˆØ¹Ø§Øª Ø±Ø²ÙƒØ§Ø±	ÙˆØ§Ø®ÙŠØ±Ù† ØªØ­Ø¯ÙŠØ«
Raj Babu	We want hammer jam back
Alan Cherupuzha	Lvl 13 clan like
ÙƒÙ„Ø§Ø´ Ø§Ù ÙƒÙ„Ø§Ù†Ø³ Ø¹Ø¨ÙˆØ¯	Ø§Ù„ÙŠ ÙÙ‡Ù… ÙŠÙÙ‡Ù…Ù†ÙŠ
FooF n OooO	thats when my exam start
Almosthar Now	ØªØ¨Ø§ Ù„ÙƒÙ… ÙŠØ§Ø§Ø§Ø¬Ø§Ù†Ø¨ ÙŠØ§ ÙƒÙØ§Ø± ğŸ˜‚ ÙƒÙ„ Ù…Ø³Ù„Ù… ÙŠØ¶ØºØ¸ Ù„Ø§ÙŠÙƒ ÙˆØ­Ø¨ÙŠØ¨Ù†Ø§ ÙŠØ§Ø±Ø³ÙˆÙ„ Ø§Ù„Ù„Ù‡
Bilal CW G&H	Witch nerf nice p
HK technical	love clash of clan from india
WOLF Br	Gostei KKK
Das StraÃŸenschild	My Clan Die HÃ¼hnerFarm
100 subscribers with no videos challenge	Isnt this game dead
Mokrot	toworrow uptade
Lato Yo	Th10 give like
A A	daaamn we dont want a new inferno
Immanual Titus	Need a special chat box for Friends to chat ğŸ˜
victor vargas	Noooooooooooooo ğŸ˜œ
TheMoleski	This didnt need to be a video
Vishal Ghuman	Witch may ve gon na getting too weak
Ù‚Ù…Ø± Ø§Ù„Ø¹Ø§Ù„Ù…	Ø´ÙˆÙƒØª ØªØ­Ø¯ÙŠØ« Ù…Ù…ÙƒÙ† Ø§Ø­Ø¯ ÙŠÙƒÙ„ÙŠ Ùˆ ÙŠÙÙ‡Ù…Ù†ÙŠ Ø§Ù„ØªØ­Ø¯ÙŠØ« Ø´Ù†Ùˆ Ø¨ÙŠ Ùˆ Ø´Ù†Ùˆ Ù‡Ù„ ÙÙŠØ¯ÙŠÙˆ
Ang Tropps na malupit	Damn
Jasim Laskar	Please give new troups new feature
Mitthu Chaudhary	Hell of some balancing
Ø­Ù…ÙŠØ¯ Ø§Ù„Ù…Ø­Ù…ÙˆØ¯ÙŠ	Ø§Ø°Ø§ Ø§Ù†Øª Ù…Ø³Ù„Ù… ÙˆØ¹Ø±Ø¨ÙŠ Ù„Ø§ÙŠÙƒ ğŸ˜‡
KristjÃ¡n GuÃ°mundsson	Supercell really want u to donate with gem
MÃ¨szaros Dorel	WOW It so cool balanc update
LEGENDARY DRAGON EMPEROR	Additional inferno
Ø§ÙˆÙˆÙˆÙ… Ø®Ø¯ÙˆØ¯	Ù…Ù†Ùˆ Ù…ÙØªÙ‡Ù… Ù…Ø«Ù„ÙŠ ğŸ˜¹ğŸ˜¹ğŸ’” Ø§Ù„ÙŠ ÙØªÙ‡Ù… ÙŠÙƒÙˆÙ„ÙŠ â™¥ï¸ğŸ˜‰
Ù…ÙŠÙˆØ²Ùƒ Ø¹Ù„Ø§ÙˆÙŠ	ÙŠØ§Ù„Ù„Ù‡ Ø§Ù„Ù„Ù‡
ChuckN 69 _YTJack	Please change cost of upgrading wall it to much for one wall
Ian Lee	Training cost and gem donation decreased Something â€™ s not right TH13 WITH ALL NEW DEVIL â€™ S BREATH POTION there we go
Jireh Choo	Am I the only one who agrees that eagle artillery need a buff
roham parsa	NERF THE ROYALE GIANT YOU BASTARDS
Drunk Baby	First
CLASH WITH TAMIL	LOVE FROM INDIA ğŸ’ªğŸ’ªğŸ’ªğŸ’ªğŸ˜ğŸ˜ğŸ˜ğŸ˜
Super Po4an	Good job SuperCell we need 13 TH D
d j	They have the game too easierğŸ˜‘
Rovire	Rip xbow
coc reality	Nice dude
EDCEL Wiyangco	bakit
Game Cell	Th 9 max I think that collecters tention over but the lvl 13 is coming
ARSH 112	good
Shreyansh diwan	Too much balance some are good but some are not my opinion ğŸ˜…ğŸ˜ƒ
Jerrythebaum25	RIP X Bow
Rudra Saha	PUBG is boring and COC is interesting
Khan salman	India from haryana plyer like for comment
Dark Horse	When will lvl8 goblin arrive
VR Prasad	New resource collector levelsğŸ˜
Gaming with Silent Killer	INDIA ğŸ‡®ğŸ‡³
Ù†Ø§Ø¯Ø± Ø§Ù„Ù‚Ø¨Ø¹ÙŠ	ÙŠØ§Ø§ÙŠÙ‡Ø§ Ø§Ù„Ø¹Ø±Ø¨ Ù„Ø§ÙŠÙƒ
Subhadip Dutta	Thank you super cell
Johnny Moor	God dam
Ù…Ø¤Ù…Ù„ Ù‚ÙŠÙ…Ø±	ØªØ­Ø¯ÙŠØ« Ø®Ø±Ø§ÙÙŠğŸ˜±
Best dinosaur Albino	Wow
Just some guy who has hair a	Witch still stuck in a never ending cycle of buff and nerfs
Ahmad Zakkie	I am from indonesian and for clash of clan TETAP BEJAYA DAN SEMANGAT BAGI DEVELOPERNYA
Ğ»ĞµĞ³Ğ¾ Ğ·Ğ±Ğ¾Ñ€	Ğ¯ Ğ½Ğµ Ğ¿Ğ¾Ğ½ÑĞ»
Abdullah Aaa	Ø§ÙƒÙˆÙˆ Ø¹Ø±Ø¨ Ø¨Ø§Ù„Ø·ÙŠØ§Ø§Ø±Ø©ğŸ˜ğŸ˜ğŸ˜
OM SREE SAI TRADERS - CHENNAI	Coc player hit a like
ahmad alhussein - Ø£Ø­Ù…Ø¯ Ø§Ù„Ø­Ø³ÙŠÙ†	Ù…ÙŠÙ† Ø³ÙˆØ±ÙŠ Ù„Ø§ÙŠÙƒ ÙˆØªØ¹Ù„ÙŠÙ‚ ÙˆØ§Ø´ØªØ±Ø§Ùƒ Ø¨Ù‚Ù†Ø§ØªÙŠ
Ø¨Ù†ÙˆØªÙ‡ ÙƒÙŠÙˆØª	Ø¹Ø±Ø¨ Ù„Ø§ÙŠÙƒ
Deepak Chs	Snd me friend request pyqopvorp
Maga 1	I hype of October Update
Andre Schuster	Und ich bin gerade erst rh 10 geworden schon richtig gut dabei und jetzt kommen neue Level ğŸ˜ª
Dawn Hairston	FINALLY THE COLLECTORS GET A NEW LEVEL
Shubham Raj	Kal update AA Raha
vikas 8.9 coc	â¤ï¸From India
Kevlar GamingRaja	I have no pride for you who ruined everything my revolution
Delirious	What s the new obsticala
Yusuff Sony	Please indonesia
gaming dog	This is the best blance finally
Christian Allen	When they try na so hard to copy their way to introduce what s on the balance update from clash royale to clash of clan
BABOUIN UN JOUR BABOUIN TOUJOURS	Good
Mathias Cooreman	When will you get xp for donating the clan war
Punisher Lee	Yeah
Hilios Ytg	Wow the 3rd inferno u guy better introduce some op troop that â€™ s too much on the defencive side specially with the reduced xbow damage
Kasgosc	OP KAS
áƒ«ÑÑˆĞ´Ğ¹sáƒ© ĞºÑ†Ğ¼Ğ°Ñ	Collecters New Lvl ğŸ˜ğŸ˜
HAPPYBOYS Ru	ĞĞ¸ Ğ¾ Ñ‡ĞµĞ¼ Ğ±Ğ»ÑÑ‚ÑŒ
Piotrex Gaming	This update is the best in clash of clan history
Siker man	cool
Miguel Mate	rip wich
Ø²ÙŠØ§Ø¯ Ø³Ù„ÙŠÙ…Ø§Ù†	Ø§Ù„ÙˆØ±Ø¯
deepp phyroth	I don like
BSV Gaming and tech	Woohoo
Fahim IR	this is supercell defabbing coc
Muslim Cik	Ğ­Ñ‚Ğ¾ Ñ…Ğ¾Ñ€Ğ¾ÑˆĞ¾ Ğ½Ğ¾ Ğ½Ğ¸Ñ„Ğ¸Ğ³Ğ° Ğ½Ğµ Ğ¿Ğ¾Ğ½ÑĞ»
Mr King	I HATE THIS UPDATE WHY NERF WITCH SHE WAS ALREADY VERY WEAK
EUGENE WONG	How about you add to the balanced update is that the soldier that have the placed down and didn t die don t instantly die after the match
Rio Norun	Awesome ğŸ’ğŸ’ğŸ’ğŸ’ğŸ’
super pekka Decima	Â¡Â¡gracias por la informasion
Mzkzoz TFM	ğŸ˜ğŸ˜ğŸ˜
Shaher Sy	Ù„Ø¹Ø±Ø¨ÙŠ Ù„Ø§ÙŠÙƒ
YUVRAJ WITH PUBG	What doe it is mean
Saqib Sarwari	PubG is best than coc
aby sajan	I quitğŸ˜›
farid dz	Ø´Ø¨Ø§Ø¨ Ù…Ø§ ÙÙ‡Ù…Øª Ù…Ù…ÙƒÙ† ØªÙÙ‡Ù…ÙˆÙ†ÙŠ
Ø¹Ø¨Ø¯Ø§Ù„Ù„Ù‡ Ø§Ù„Ø®Ø«Ø¹Ù…ÙŠ	Ù†ØµØ±Øª ØªØ±Ø¬Ù… Ù„Ù†Ø§ Ø¨Ø³Ø±Ø¹Ù‡
Crazy Wolf	I like the balance update plus my birthday is 22 10
Bey RANGERZ	Best balancing ever
StOp DoNaT	Ğ—Ğ° Ñ‡Ñ‚Ğ¾ Ñ‚Ğ°Ğº Ğ²ĞµĞ´ÑŒĞ¼Ñƒ
ideia loka	My god
noob the dude	Hey Indians Like this comment and show how their game is played in our nation But they hate u
ë¦„ì´	í•œêµ­ì–´ ìë§‰í‚¤ê³  ë³´ë‹ˆê¹Œ ë¯¸ì³ë¸Œë €ë„¤
ĞŸĞ¾Ğ½Ğ¸ ĞŸÑ€Ğ¸Ğ½Ñ†Ğ°	Cool update thanks
hitesh bhutani	We indian love coc
Nishant Kumar	Love the new update â¤
Arafat Rahman	Very good
Pablo Souza	X Bow nooooooo
Tapan Thakur	Halloween update ğŸ˜¢
TRIBUNAL GAMING	When u guy giving u update i can t wait i am so excitedğŸ˜ˆğŸ˜ˆğŸ˜ˆğŸ˜ˆğŸ˜¢
Satya prabhu	That s y Iam big fan of coc
Aayush Pal	Can u please unban my village player tag is RORYGC8C
Player 01	You did the best for u TY
Mr Maul	Ğ•ÑĞ»Ğ¸ Ñ€ÑƒÑÑĞºĞ¸Ğ¹ ÑÑ‚Ğ°Ğ²ÑŒ Ğ»Ğ°Ğ¹Ğº
B L A C K o	Lol I stopped playing 2 month ago now I m thinking about playing again ğŸ˜¯
Sujatha Valluripalli	Waiting for tomorrow
Raf Przy	Yay
Sheikh Nishi	RIP witch ğŸ’”ğŸ˜’
Ğ—Ğ°Ğ¼Ğ¸Ñ€ Ğ–Ğ°Ğ¼Ğ°Ğ»Ğ¸Ğ´Ğ¸Ğ½Ğ¾Ğ²	Ğ¢ÑƒÑ‚ Ñ Ñ€ÑƒÑĞºĞ¸Ğ¹
gaming Rohan	When is that update
Farin FÃ¶rster	A new CollectorğŸ˜
TEAM 47 Leader	Vare vaaa
Deep Sandhu	When will this update came
Devendra Narkhede	3 rd infereno ğŸ˜¥
ziad alawy	Ø§ÙŠ Ø­Ø¯ Ø¹Ø±Ø¨ÙŠ ÙŠØ­Ø· Ù„Ø§ÙŠÙƒğŸ‘
PÑÎ±GÎ± DÑ”Î½Î¹L	When you will give this Update bro Waiting Deadly
Drunken Masta Clash Royale	Lol i m now maxed th9 moving to th10
JOE REFAT	Ø§Ù„Ø¹Ø±Ø¨ÙŠ ÙˆØ§Ù„ÙŠ Ù…ØªØ­Ù…Ø³ Ù„Ø§ÙŠÙƒ Ø®Ù„ÙŠÙ†Ø§ Ù†Ø´ÙˆÙ ÙƒØ§Ù… ÙˆØ§Ø­Ø¯ ğŸ˜ğŸ˜„ğŸ˜„ğŸ™‚ğŸ’ªğŸ¿ğŸ’ªğŸ¿
Faizi Khan	what is Balance Update Can anyone tell me plz btw my id YVV2YY88V
Mr. seif	Ø§Ø®ÙŠØ±Ø§ Ø¨ÙƒØ±Ø§ Ø§Ù„ØªØ­Ø¯ÙŠØ«ğŸ™ŒğŸ™ŒğŸ™ŒğŸ™ŒğŸ™Œ
Hriday Barman	Hit like for indian
Clash wid Gamer	WHO IS READY TO SMASH THE UPDATE
Enian Ismajli	I liked the pekka wiz and golem one becouse i use these 3 trops
YouTube Mix	âœŒâœŒğŸ˜ğŸ˜ğŸ‡©ğŸ‡¿ğŸ‡©ğŸ‡¿
Aditya Talukdar	Ohhhh yea
ããã‚Šç«‹ã¤ã‚«ãƒ¼ãƒ«	ã¤ã¾ã‚Šã©ã†ã„ã†äº‹ã ã£ã¦ã°ã‚ˆâ€¼ï¸ ã‚°ãƒªãƒ¼ã‚’è¨±ã™ãª
Noah Nasirkhan	More upgrade for gold en elixer pomp
FOX MOBAKS	ÙˆØ§Ø§Ø§Ø§Ø§Ùˆ ÙŠØ§ Ù…Ø­Ù„Ø§Ù‡ ØªØ®ÙÙŠØ¶Ø§Øª Ø­Ù…Ø§Ø³ ÙŠØ§Ø®ÙŠ
TÃ¼rkÃ§e Oyun	TÃ¼rkler nerdesiniz
Corey Angus	This out now
K FlashVEVO	They are reducing everything to make the game alive again
technical gamerx yash	rally
ICE DRAGON	3 INFERNO FOR TH12 OOOOOOPPPPPPP
Electro ice wiz	Thanks for supercells
Karthik B	ğŸ˜¶ woh
VIP Gamers Paradise	Nice
Basse stop	Ù„Ù… Ø£ÙÙ‡Ù… ÙˆÙ„Ø§ Ø´ÙŠØ¡
German	Ty for new wall i love you supercell
Team Phidim	Wow supercell
Florian ObÅ‚uski	love this
Mine FNaF	Wow now the Witch kinda suck a little bit now
Jedi Sebas	Pls add more national flag ğŸ‡µğŸ‡±
ABD gaming coc and cr	what is the date off clan war league update
The Badass	LOVE FROM INDIA ğŸ˜ğŸ˜
Ø³ÛÙŠÛÙˆÙ°ÙÛ Ø¹ÛÙ„ÛÙŠ	Nace
Nikhil Suresh	Good
Logical Kingdom	Many update coco is not dead
Axyljake Rebotazo	NICE ğŸ‘ğŸ‘
Anmol Garg	Since u put 22 10 is it mean update is on tomorrow
The Best	Th12 will have 3 inferno tower
Slugterra Slug it out	Gowipe gone so easy
NAER AMEUN	Wow the 22 10
Chetan Chetan Upadhya	This update give QOL CHANGES
COC FORCE	What about request time Its take 10 min Also reduced req Time clashofclan
Ravula Vijayendra	Awesome
SADDAB KHAN	Biggest Update Ever After Th 12
RISHIKESH WITH 1731	good
ART Lara	thanks supercell
suresh resh	Need new hero and troop
Ø­Ø³Ù† Ø­Ø³Ù†	Ù…Ø±Ø­Ø¨Ø§ Ø´Ø¨Ø§Ø¨ ÙŠØ§ Ù…ØªÙ‰ ÙŠØ§ØªÙŠ Ø§Ù„ØªØ­Ø¯ÙŠØ« Ø§Ù„Ø¬Ø¯ÙŠØ¯ Ù„ÙƒÙ„Ø§Ø´ Ø§ÙˆÙ ÙƒÙ„Ø§Ù†Ø³ Ù…Ø§ Ø§Ø¬ÙŠ Ø§ÙŠ ØªØ­Ø¯ÙŠØ« ğŸ˜”ğŸ˜”Ù„Ø­Ø¯ Ø§Ù„Ø§Ù† Ù„ÙŠØ´
comando N	Cuando e la actualizaciÃ³n
Ø§Ø¬Ø¯ÙŠØ¯ Ø§Ø¬Ø¯ÙŠØ¯	Ø§Ù„ÙŠ Ù…Ø§ ÙØªÙ‡Ù… Ø´ÙŠ ÙŠØ­Ø· Ù„ÙŠÙƒ ÙŠÙ„Ø¹Ø±Ø¨
CARLOS EDUARDO	Bruxa jÃ¡ Ã© um lixo agora jÃ¡ Ã© mais lixo ainda
Nemka Saltyblade	This is rly good news for me
KapitÃ¡n Å nek	Amazing balance
White Wolf	HYYPEE
Ù…Ø­ØªØ±Ù ÙƒÙ„Ø§Ø´ Ø§ÙˆÙ ÙƒÙ„Ø§Ù†Ø³	Ø§ØªÙ…Ù†Ù‰ Ø§Ù„Ù…Ø±Ù‡ Ø§Ù„Ø¬Ø§ÙŠÙ‡ ØªØ±Ø¬Ù…ÙˆÙ†Ù‡ Ø¹Ø±Ø¨ÙŠ
zaty js	wow awesome
deniver `sg	O at 22 10 update
Attitude 2050	I love u coc
Vlad Nicolaescu	They did almost nothing decreased gem cost for all and lowered cost for heavy troop not much good tactic to list 1 by 1 to appear a it is a HUGE list
kumar kn	Wow wa waiting for those pumpgrades from long time
Masterplayer609	YES ANOTHER INFERNO TOWER
Ø§Ù„Ù…Ø¹ØªØµÙ… TV	Ø§Ù†Ø§ Ø¹Ù…Ø±ÙŠ ØµÙØ± ÙƒÙ„ Ù„Ø§ÙŠÙƒ ÙŠØ²ÙŠØ¯ Ø¹Ù…Ø±ÙŠ ÙƒÙ… Ø±Ø§Ø­ ÙŠØµÙŠØ± Ø¹Ù…Ø±ÙŠğŸ¤”
Today's Hacker	I sad because witch is one of the best but Coc reduce damage why ğŸ˜¥ğŸ˜­
funny king	I like who like this
Poke - Leaf	Cool
Kalevv Vlog	I love it
Mohammad Fahim	Love from worldğŸ˜‚
MD Alfaz Hassan	hahahahahahahaha hahaha
DAG 005	ĞšÑ‚Ğ¾ Ñ€ÑƒÑÑĞºĞ¸Ğ¹ Ğ»Ğ°Ğ¹Ğº
Marcel Vanselow	Finally new collector lvls ğŸ˜ğŸ™
Ø¹Ø·Ø± Ø§Ù„Ø¬Ù†Ø©	Ø­Ø¯Ø§ ÙŠÙÙ‡Ù…Ù†ÙŠ
Himal Shrestha	Rip Witch
Abdurrahman Inal	Bide turkce olsa daha iyidi
ashesh ghimire	Supercell update are always awesome
Mentor TV	Ğ£Ñ€Ğ°Ğ°
SHahd SHahd	ÙŠØ¹Ù†ÙŠ Ø¨ÙƒØ±Ø§ Ø§Ù„ØªØ­Ø¯ÙŠØ« Ø§Ù„Ø¬Ø¯ÙŠØ¯ Ù„Ù„Ø¹Ø¨Ø© Ùˆ Ø§Ø®ÙŠØ±Ø§ Ø¨Ø¹Ø¯ Ø²Ù…Ø§Ù† ğŸ’ªğŸ’ªğŸ’ªğŸ’ªğŸ’ª
Broken Heart	Wow siege machine also time reduced awesome coc is the best game whole world
syed ali	Th8 ğŸ‘‡ ğŸ‘
Dharmendra Nagal	Coc please tell me that is there any tornado trap or not because I have seen in godson YouTube channel he wa saying that one new trap is unlocked yesterday
Gaming with AKT	Great
khaled Dahshc	Ø·ÙŠØ¨ Ø§ÙŠ Ø³Ø§Ø¹ÙŠØ© ØªØ­Ø¯ÙŠØ«
Ø­Ù…ÙˆØ¯ÙŠ Ø§Ù„Ù…Ø¬Ù†ÙˆÙ†	ğŸ˜ğŸ˜ğŸ˜ğŸ˜
MasterBoyTM	I think you MUST reduce the cost of the dragon
RaHuL ShAiKh	Awesome tomorrow is update yaaaa hoooooğŸ˜˜ğŸ˜˜ğŸ˜˜ğŸ˜˜ğŸ˜˜ğŸ˜˜ğŸ˜˜ğŸ˜˜ğŸ˜˜ğŸ˜˜ğŸ˜˜ğŸ˜˜ğŸ˜˜ğŸ˜˜ğŸ˜˜ğŸ˜˜ğŸ˜˜ğŸ˜˜ğŸ˜˜ğŸ˜˜ğŸ˜˜ğŸ˜˜ğŸ˜˜ğŸ˜˜
Deepak mishra super cell master	Me deepak hu ğŸ‡®ğŸ‡³ğŸ‡®ğŸ‡³ğŸ‡®ğŸ‡³ğŸ‡®ğŸ‡³
Aurelien Surget	Halloween mode
GOKU KING1	Thats great balancing
imtiyaz Khan	Wow thanks supercell
SG YOUTUBE'S	Wow whats supperb upgrade thanks supercell
Ø¹Ù…Ø§Ø± ØµØ§Ù„Ø­Ø© Amar Salha	Great â¤â¤â¤
Ù†Ø§Ø¯Ø± Ù…Ø­Ù…Ø¯ ÙˆÙ‡Ø¨Ù‡	Ø§Ù„ØªØ­Ø¯ÙŠØ« ØºØ¯Ø§Ù‹ Ø§Ø®ÙŠØ±Ø§ Ù‡Ø§Ù‡Ø§Ù‡Ø§Ù‡Ø§ ğŸ‘ŒğŸ’ªğŸ˜
Ø¨Ø³Ù…Ù‡ ÙˆØ¬Ù€Û‚Ø¹	Ù…ØªÙ‰ ÙŠØ¨Ø¯Ø§Ø¡ Ø§Ù„ØªØ­Ø¯ÙŠØ«
John michael Mondejar	Asa na mga bisakol dri nga nasaag Gawas
Ù…Ø­Ù…Ø¯ Ø§Ù„Ø¯ÙŠØ±ÙŠ	Ø§Ù„ÙŠ ÙÙ‡Ù… Ø´Ù†Ùˆ Ù‚Ø§Ù„Ùˆ ÙŠØ¯Ø²Ù„ÙŠ Ø¹ØªØ¹Ù„ÙŠÙ‚Ø§Øª
luigipeachbowser	Haven t played in the last 2 year What the hell is gem donation
Federico Cossio	Love from ITALY
handy.game.master	on 22 10 i am dont can playğŸ˜“ğŸ˜“ğŸ˜“
show de futebol Brasil 0516	Muito top vai sair amanhÃ£
Vuk Filipovic	Wow
sarah vyas	cool but add more troop
Gallery Spooky 7	1000th comment gg
Xander The sayian ssi MUI	Wow
Bilal kalarikkal	WaitingğŸ˜ğŸ˜ğŸ˜
sean michael tett	When will the big update be
savita pandey	Thanks
arnnold _6	Nice
LEBRON JAMES VICKERS	Almost everything I ve ever asked forğŸ˜†
Ù…Ø­Ù…Ø¯ ÙØ§ØªØ­	ÙØ§Ø´Ù„ÙŠÙ† ØªØ¯ÙˆØ±Ùˆ Ø§Ù„Ù†Ø§Ø³ ØªØ´ØªØ±ÙŠ Ø¬ÙˆØ§Ù‡Ø± Ù„ØªØªØ¨Ø±Ø¹ Ø¨Ø§Ù„Ø¬Ù†ÙˆØ¯ Ø´Ùˆ Ù‡Ø§Ù„Ù…Ø³Ø®Ø±Ø© Ø¨Ø¹Ø¯ÙŠÙ† ÙˆÙŠÙ† Ø§Ù„Ù…Ø´ÙƒÙ„Ø© Ø¨Ø§Ù„Ø³Ø§Ø­Ø±Ø© ÙˆØ§Ù„Ø¨Ø§ÙˆÙ„Ø± Ø¹Ù†Ø¯ÙƒÙ… ÙˆØ´Ùˆ ÙŠØ¹Ù†ÙŠ ØªØ²ÙŠØ¯Ùˆ Ø§Ù„Ù…Ø³ØªØ®Ø±Ø¬Ø§Øª Ù„ÙÙ„ ÙˆØ§Ù„Ø§ÙØ®Ø§Ø® Ù„ÙÙ„ ÙˆÙŠÙ† Ø§Ù„Ø´ÙŠ Ù„ÙŠ Ù„Ø§Ø²Ù… ÙŠØ¹Ù…Ù„ ÙØ§Ø±Ù‚ Ø´Ø±ÙƒØ© ÙØ§Ø´Ù„Ø© Ù‡Ù…Ù‡Ø§ Ø´Ø±Ø§Ø¡ Ø§Ù„Ø¬ÙˆØ§Ù‡Ø± ÙˆØ¨Ø³
ĞĞĞĞĞĞ¡ [Ğ˜Ğ“Ğ ĞĞ’ĞĞ™ ĞšĞĞĞĞ›]	Ğ£Ñ€Ğ° ĞĞ±Ğ½Ğ¾Ğ²Ğ° 22 Ğ¾ĞºÑ‚ÑĞ±Ñ€Ñ
ãƒƒScouT	Ğ‘ĞµĞ´Ğ½Ğ°Ñ Ğ²ĞµĞ´ÑŒĞ¼Ğ° Ğ—Ğ Ğ§Ğ¢Ğ Ğ‘Ğ›Ğ•ĞĞ¢
Neutral Person	Soo TH 12 now ha 3 Inferno Towers Huh
Ritik Ranjan Sahu	When will the update come any one know
Ù…Ù†ÙˆØ¹Ø§Øª Ø§Ù„Ù…Ø¬Ø±ÙˆØ­ÙŠÙ†	Ù‡Ø§Ø° Ø§Ù„ØªØ­Ø¯ÙŠØ« Ø±Ø§Ø­ ÙŠØ®Ø±Ø¨ Ø§Ù„Ø¹Ø¨Ù‡
exam hater	Ikr
kaushlendra tripathi	Thx
ê§ê¤Œê¤ˆê¤Ÿê¤”ê¤”ê¤€ê¤œê§‚	Cade o BRS
Happy Gaming	That will be cool in clash of clan
Roman Reigns	Where is Halloween update
Mistery White	Yesss
GamingWithRigby	probably only gem reduce ğŸ˜‚
sad Moment	I am always version change coc Hahaha
Vamsi Krishna Pasupuleti	Huge update Lot of hype created and wow thanks COC Keep giving update like this
LEARN WITH SWARUp	Not good with witch bad luck
Ø¨ÙŠØ³Ùˆ bisso	Ù…ØªØ§ ÙŠØµÙŠØ± ØªØ­Ø¯Ø¨Ø« Ø§Ø±Ø¬ÙˆÙƒÙ… Ø±Ø¯
Rakesh Sinha	That s a lot of balancing Lol They should say biggest update ever get ready old n new clashers Coc is getting a boost hahahaha ğŸ˜ŠğŸ˜Š
MrAldz24 _	My Witch Noooooo ğŸ˜°ğŸ˜¥ğŸ˜­ğŸ˜­
Shadulla Pasha	Who want some gem like u ministry ğŸ’¯
Sonia Chauhan	FinallyğŸ˜ How many of u think that if Clash Of Clans give u money to play it like Loco Then there every Vella person must be a milliniorğŸ˜‚ğŸ˜‚ğŸ˜‚
Ruben R	0 22 Wow Nerfed the Witches ğŸ˜ª
Phim Hay	Eo hiá»ƒu
mysterious hacker	Clash of clan unstalledâœ”ğŸ˜‚ğŸ˜‚
ÙƒÙ„Ù†Ø§ Ø§Ù„Ø¹Ø±Ø§Ù‚	Ø§Ù„ÙŠ Ù…ØªØ­Ù…Ø³ Ù„ØªØ­Ø¯ÙŠØ« ÙƒÙ„Ø§Ø´ ÙŠØ´ØªØ±Ùƒ Ø¨ØºÙ†Ø§ØªÙŠ ğŸ˜—ğŸ˜—
gggkk jgfbv	nice
Sujesh kumar Suresh	WoW
kostas xalkiadakis	Good balance change
KURDISH EMPIRE	wooow nice
Govind Gaming	You mother father supercell stop fooling u clash is not dying clash is dead you guy have dumbest update learn from PUBG stupidest community i have ever seen RIP COC
Zeeshan Khan	Nice bro
Ace Apostol	Wowowow I hope there is a decrease price on th11 and 12 wall
Athena angle	When is this update comeing out
GD _Golden_Dragon	Im so pumped for the update
Ğ”Ğ°Ñ€Ğº ĞœĞ°ÑÑ‚ĞµÑ€ Ğ”Ğ°Ñ€Ğº ĞœĞ°ÑÑ‚ĞµÑ€	ĞŸĞµÑ€Ğ²Ñ‹Ğ¹ Ğ¸Ğ· Ñ€ÑƒÑÑĞºĞ¸Ñ… Ğ ÑƒÑÑĞºĞ¸Ğµ ÑÑ‚Ğ°Ğ²ÑŒÑ‚Ğµ Ğ»ÑƒĞ¹ÑÑ‹
Ø®Ø§Ù„Ø¯ Ø§Ù„Ø­ÙŠØ§Ù„ÙŠ	ØªØ­ÙŠØ§ØªÙŠ Ù„Ø´Ø±ÙƒØ© ÙƒÙ„Ø§Ø´ Ø§ÙˆÙ ÙƒÙ„Ø§Ù†Ø³
Ø­Ù…ÙˆØ¯ÙŠ Ø§Ù„Ù…Ù„Ùƒ	Ù…Ù†Ùˆ Ù…Ø§ÙÙ‡Ù… Ø´ÙŠ Ù„Ø§ÙŠÙƒ Ù‡Ù‡Ù‡Ù‡Ù‡
Bhawarlal Seervi	I have see
ãƒ…ãƒ„ãƒƒSmileã‚·ÃœÏ¡Ù¿ã‚·	1 39 YEEESSSS DDDDDD
sridhar bandlamudi	If you decrease wall cost game will be more nice
the Fastblaster NL	I ve been waiting for this so long
Ø­Ø³Ù† Ø­Ø±Ø¨ÙŠ	Ø§Ù„Ø¹Ø±Ø¨ Ø§Ø«Ø¨ØªÙˆ ÙˆØ¬ÙˆØ¯ÙƒÙ… Ù„Ø§ÙŠÙƒ
Rushi Paithankar	Wow
its HONEY	can u update to free view system
furious gamerz	Nice
Ø§Ù…ÙŠØ± Ø§Ù„Ø¹Ø§Ù„Ù…	Ø³Ø¬Ù„ Ø­Ø¶ÙˆØ±Ùƒ ÙˆØ§ÙØªØ®Ø± Ø§Ù†Ùƒ Ø¹Ø±Ø¨ÙŠ ğŸ‘
cheila precila	ğŸ‘
time is up the end	What do you mean
Omid Haji	Ø´Ùˆ Ù‡Ø°Ø§
Ù‚Ù†Ø§Ø© Ø§Ù„Ø§Ø®Ø¨Ø§Ø± ÙˆØ§Ù„Ø§Ù„Ø¹Ø§Ø¨ ahmad wais	ÙˆØ§Ùˆ Ø¬Ù…ÙŠÙ„
Moris Bhat	If the cost of wall upto level 11 wa reduced then why didn t you guy reduced the cost of level 12 I wa expecting this balance change in this updateğŸ˜®
SSB IS HERE	You made a mistake You show elixir on the golem and witch but it take dark elixir Btw so much is balanced
Vines Of Ayush	Nice
Maximilian the greatest	Very good
King of Games	Update when coming
Happy CHOT	Gold mine lvl 13 omg
Rubaiat Rohan	This balance change is awesome I think I am gon na love the new update
ASMAA samasemo	Ø§Ù„ÙŠ Ù…Ø´ ÙØ§Ù‡Ù… Ø­Ø§Ø¬Ù‡ ÙŠØ¶ØºØ· Ù„Ø§ÙŠÙƒ
PlaY wiTh Joy play with joy	I love this update
jirayu snidvongs	939th comment
Abhay Singh	Witch lover are going to cry a lot of reduction ğŸ˜¢ğŸ˜¢ğŸ˜‚ğŸ˜‚ğŸ˜‚ğŸ˜‚
TMarioC	Tttthhr thhrre THREEEEE INFERNO TOWERS AT TH12
HÃ­mÅ« #007	So We will get update tomorrow ğŸ˜ğŸ˜
Jerin Joseph Jose	ğŸ’—ğŸ’—from India indian hit theğŸ‘
Yash Jadhav	Ohh nice Indian hit like we show the power of Indian s
sean patacsil	This is a very good update
MUST WATCH	Wow to many update
piyush arora	Finally the wait is over
QuakeGamer	It will be good update âœŒ
SÆ¡n HoÃ ng	22 10 update Ã€ ğŸ˜Š
ØµØ§Ø¯Ù‚/ HERO	Ø§ÙƒÙˆÙˆ Ø¹Ø±Ø¨ Ø¨Ù„Ø·ÙŠØ§Ø±Ù‡ğŸ˜‚
Memo Love	Ø¯Ù‡ Ù…Ø´ Ø¨Ù„Ù†Ø³ Ø¯ÙŠ Ù…Ø³Ø®Ø±Ù‡ blance state
best songs	Hit like for Clash of clan
Cuá»™c Sá»‘ng Quanh Ta	Ai viá»‡t nam Ä‘iá»ƒm danh ğŸ˜ğŸ˜ğŸ˜
Inderveer Saggu	There hasn â€™ t been collector update in age
Ayon Hossain Bipu	Anyone from bangladesh
100s subs without any videos?	New collector level for th 10ğŸ˜
John Dave Flores	my witch â˜¹
Milan K	Does that mean that the update is coming tomorrow
vijay mourya	Tornado trap is gon na kill lava loon at th 11 12 and more likely to make minor the strongest unit even stronger then e drag
The game boy	Happy news update forever Hurrah
Random	can you Rebalance clash royal
Mohamed Nour	Ø§Ù†Ø§ Ù…Ø´ ÙØ§Ù‡Ù… Ø­Ø§Ø¬Ù‡
harsh diwakar	Oh yeeeeeeeeaaaaahhhh
Master Ninja	Thank you super cell very cool
Mnbvc Mnbvc	OSIM
InsuriX	Cool ğŸ˜ğŸ‘
# all in	Hit a like for coc
Ø¹Ø¨ÙˆØ¯ Ø§Ù„Ø±ÙØ§Ø¹ÙŠ	ğŸ˜ğŸ˜ğŸ˜ğŸ˜
Movie cuts	excited
Aggelos 3	Yes yes no more many elixir
Ø­Ø³Ù† Ø¹Ù„ÙŠ _ Hassan Ail	ÙˆÙŠÙ†ÙƒÙ… ÙŠØ§ Ø¹Ø±Ø¨
Isaias Bustamante	si maÃ±ana la actu
MEHUL GAMING	Love From India
Ø§Ù…Ø§Ù†ÙŠ Ø§Ù„Ø²Ù‡Ø±Ø§Ù†ÙŠ	Ø§ÙŠÙ† Ø§Ù†ØªÙ… ÙŠ Ø¹Ø±Ø¨ ğŸ‘€
ALEX GAMING	Cool
Mikel_ Dezz	Nice
MK 2700747	Trash
trovovolcan trob	MaÃ±ana e la actualizacion
Filiman Pro	Add polish language
CER	interesante muy interesante
Lauren Vita Goras	mantav ni
Ahmed	Ø§ÙƒÙˆ Ø¹Ø±Ø¨ Ø¨Ø§Ù„ØªØ­Ø¯ÙŠØ« ğŸ˜”ğŸ˜¹
Hiten Gajjar	Thanks for balance update
Shahjahan Khan	Afghan like
volk 2018	ĞœĞ´Ğ° Ğ½Ğ¾Ñ€Ğ¼ Ñ‚Ğ°Ğº ÑĞºĞ¾Ñ€ĞµĞ¹ Ğ¾Ğ±Ğ½Ğ¾Ğ²Ğ°ğŸ‘ğŸ‘
MR.M Ù…Ø³ØªØ± Ù…Ø­Ù…Ø¯ Gamer .	Ø®Ù„ Ù†Ø´ÙˆÙ ÙƒÙ„Ù…Ù‡ Ø§Ù„Ù„Ù‡ ÙƒÙ… Ù„Ø§ÙŠÙƒ Ø¥Ø´ØªØ±Ø§Ùƒ
loord Hunter	R I P
Rogerio silva	Cade o br aeeee
The HoNey	Update come tomorrow
Cevay Halil	Owww yeaahhh
Mohammmed Gamer	Ù„Ø¹Ø¨Ø© ÙØ§Ø´Ù„Ø© ğŸ‘ğŸ»ğŸ‘ğŸ»
MiNA xD	Ø­Ù„Ùˆ Ù‡Ø°Ø§ Ø§Ù„ØªØ­Ø¯ÙŠØ« ÙˆÙ…ÙÙŠØ¯ Ø¬Ø¯Ø§ Ù„Ù„Ø¯Ø¹Ù… I love you COC â™¥ Ø§Ù„Ù„ÙŠ Ù…Ø§ ÙÙ‡Ù… Ø§Ù„ØªØ­Ø¯ÙŠØ« Ù„Ø§ÙŠÙƒ ÙˆÙ‡Ø¹Ø¯Ù„ Ø¨Ù„ØªØ­Ø¯ÙŠØ« ØªØ¹Ø¯ÙŠÙ„ ØªØ®ÙÙŠØ¶ ØªÙƒÙ„ÙØ© ØªØ¯Ø±ÙŠØ¨ Ù„Ø¨Ø¹Ø¶ Ø§Ù„Ø¬Ù†ÙˆØ¯ Ùˆ ØªÙ‚Ù„ÙŠÙ„ Ø§Ù„Ø¯Ø¹Ù… Ø¨Ø§Ù„Ø¬ÙˆØ§Ù‡Ø± Ø¨Ø±Ø¬ Ù†Ø§Ø± Ø«Ø§Ù„Ø« ÙÙŠ Ø§Ù„ØªØ§ÙˆÙ† 12 Ø¶Ø¹ÙÙˆ Ø§Ù„Ø§Ù‚ÙˆØ§Ø³ Ø¶Ø¹ÙÙˆ Ø§Ù„Ø³Ø§Ø­Ø±Ø© ÙˆÙŠØªØ´ Ø²Ø§Ø¯Øª Ù‚ÙˆØ© Ù…Ø¯ÙØ¹ÙŠØ© Ø§Ù„Ù†Ø³Ø± ØªÙ‚Ù„ÙŠÙ„ ÙˆÙ‚Øª Ùˆ ØªÙƒÙ„ÙØ© ØªØ¯Ø±ÙŠØ¨ Ø¢Ù„Ø© Ø§Ù„Ø­ØµØ§Ø± Ù„ÙÙ„ Ø²ÙŠØ§Ø¯Ø© Ù„Ù„Ø§ÙØ®Ø§Ø® Ù„ÙÙ„ Ø²ÙŠØ§Ø¯Ø© Ù„Ù…Ù†Ø§Ø¬Ù… Ø§Ù„Ø°Ù‡Ø¨ Ùˆ Ù…Ø³ØªØ®Ø±Ø¬Ø§Øª Ø§Ù„Ø§ÙƒØ³ÙŠØ± Ø§Ù„ØªØ¹Ø¯ÙŠÙ„ Ø¹Ù„Ù‰ Ù†Ù‚Ø§Ø· Ø§ØµØ§Ø¨Ø© Ø§Ù„Ø¯ÙØ§Ø¹ Ø§Ù„Ø¬ÙˆÙŠ ÙˆØ´ÙƒØ±Ø§ 3
luis vicente domenech jover	Cuando llegara los sucritulos en espaÃ±ol
Jean #NAMASTÃŠ	Finalmente novos nÃ­veis de coletores
Stephan	FINALLY MINES AND PUMPS LEVEL 13
KaptenPanna	22 10 Is the update droppin tomorrow NICE
JIJO S S	Bannd account will back ğŸ˜¢
Status guru	Sab thik hai lakin witche ki hp damage kiu kam kiya ğŸ˜­ğŸ˜­ğŸ˜­
Lacanilao GAMING	What the update 3rd inferno
Soham Purohit	Sumit 007 guessed it right
Salman Ansari	Not too bad for ya
Ahmad Roni.p	wah kenapa jadi Inggris semua ini
Meena Joshi	Hello super cell can we have a new spell like confusion spell which confuse the defence in attacking
ouyes anatefe	Kertmaths no kroman mrore ğŸ˜‘ğŸ˜‘
ayesha fahad	wow
Masri Razali	From Malaysia With ğŸ’–
Yarlei TalÃ£o	amazing
mayank bhai	Not good update
Ù†Ø­Ù† Ù…Ù„ÙˆÙƒ Ø§Ù„Ù…Ø¯Ø±Ø¨ Ø§Ù„Ø§ÙØ¶Ù„	Ø´Ø¨Ø§Ø¨ Ù…Ø§ ÙÙ‡Ù…Øª
ahmed elzamly	Ø§Ø¬Ù…Ù„ Ø§Ø­Ø³Ø§Ø³ ÙÙŠ Ø§Ù„ÙƒÙˆÙ† Ø§Ù†Ùƒ ØªØ¹Ø´Ù‚ ÙƒÙ„Ø§Ø´ ÙˆØ¯Ø§ Ø­Ø§Ù„ÙŠ Ù…Ø¹Ø§Ù‡Ø§ Ø®Ù„ÙŠÙ†ÙŠ Ø§Ø¹ÙŠØ´ Ø§ÙŠØ§Ù… Ù…Ù„ÙŠØ§Ù†Ø§ Ù…ÙˆØ§Ø±Ø¯ ÙˆØ¬ÙˆØ§Ù‡Ø± ğŸ˜
HÃ­mÃ Ã±shÃ¼ ÅšÃ­Ã±ÄŸh	Great ğŸ˜
LEGEND GAMER	Ø¹Ø±Ø¨ÙŠ Ù„Ø§ÙŠÙƒ
Yash Sharma	Y don t u guy remove witch from troop I mean seriously why ğŸ˜ ğŸ˜¡ğŸ˜
Ankit Srivastava	Nice
Much More	Balance not changed i think coc ha changed Can t Wait won t wait
KADEN BARRY	New level for elixer and gold collector those are a pain to upgrade
XI Badsport_-	Why
Mishi Talk you	love you from pakistan supercell
faHad _ksa	ğŸ‡¸ğŸ‡¦ğŸ‡¸ğŸ‡¦ğŸ‡¸ğŸ‡¦ğŸ‡¸ğŸ‡¦ğŸ‡¸ğŸ‡¦ğŸ‡¸ğŸ‡¦ğŸ‡¸ğŸ‡¦ğŸ‡¸ğŸ‡¦Ù„Ø§ÙŠÙƒ ÙŠØ§Ø¹Ø±Ø¨ ğŸ‘â¤
Patrick Ray Mosquite	Sad for Witch slap strategy like me ğŸ˜©ğŸ˜©ğŸ˜©
HOSEN Ali	Ø´Ø¨Ø§Ø¨ ÙØ¯ÙˆÙ‡ Ø§Ù†Ø´Ø§Ù„Ù„Ù‡ Ø§ÙˆØµÙ„ 100Ù…Ø´ØªØ±Ùƒ Ù‡Ø§Ø°Ø§ Ø­Ù„Ù…ÙŠ Ø§Ø°Ø§ ØªÙ‚Ø¯Ø± Ùˆ ÙˆØ§Ø±Ø¯Ù‡ Ø´Ø¨Ø§Ø¨ Ù…Ù† 7Ø­Ø³Ø§Ø¨Ø§Øª
what the fish ?	Lets Steal more gold dude1 1 1 1
SUBIR DAS	BOARING
Subham vedios	I think i have to download coc to day
reema jala	Ù…Ø¹Ù‚ÙˆÙ„ Ø§Ù„Ø³Ø§Ø­Ø±Ø© ÙŠØ®ÙØ¶Ùˆ Ù…Ø³ØªÙˆÙ‡ Ù‚ÙˆØªÙ‡Ø§
GamingOut North	Do di do di doğŸ˜…
Hegz	Okay this update is pretty good
FUNITY FT	nice
Manav gammer	J nu orsomething
Ø³ÙˆØ±ÙƒÙ„ÙŠ Ø¨ÙƒØ±	Ø´Ø³Ø§Ù„ÙÙ‡
NASA Yt	What s Dhat
SB 12	Thanks for reducing gem
Anita Agarwal	Nice
NicolÃ¡s Diez	Tomorrow is the update Wow
ØªØ¹Ø¨Ø§Ù† Ø¸Ø§ÙŠØ¬ Ù…Ø®ØªÙ†Ùƒ ÙƒØ§Ø±Ù‡ Ø§Ù„Ø¯Ù†ÙŠÙ‡ Ù…Ù† ØµØ¯Ùƒ	ÙƒÙ„Ø´ÙŠ Ù…ÙØªÙ‡Ù…Ù†Ø§
Son goku san	Can you reduce the amount in spring trap
å¸¦èµ°ä¸åŠ è¾£	I just wish they will reduce the cost of upgrading wall ğŸ˜¥ğŸ˜¥
Varun varun	Love from india
AIMAN 37	i love clash of clan
Ø§Ø¨Ù† Ø§Ù„Ø¹Ø±Ø§Ù‚	ÙƒÙÙˆÙˆÙˆ
Gaming With SK	Love from indiağŸ˜ğŸ˜
COC. Badshah	Hey supercell plz add Pakistan s flag in clash of clan in next update plz
Sujal Gaykwad	Yes i like these update
à¦¬à¦¾à¦™à§à¦—à§à¦° à¦¬à¦¾à¦™à§à¦—à¦¿	Faltu Update
Thomas Campigotto	WOW
STheSkeleton quello di telegram	Everybody gg for gem donation decreased Giant sad music
Trang Byby Bom	Im in ğŸ‡»ğŸ‡³
Ù…Ù†ÙˆØ¹Ø§Øª ÙŠÙ…Ù†ÙŠÙ‡	Ø§Ù†ÙŠ Ù…Ø§ÙÙ‡Ù…Øª
supercell Awesome	Sup erc cell u ar e g r e a t ho o o o o o o o o o o o o o o o o o o o o
D'LAST DICTATOR	Sir can you tell u date when update coming
nerd 777	Brasil CaraÃ­
hj jalotra	NYC balancing thanx to supercell from whole Indians and youtubers
aditya krishna	Love from India
Gabi_ soccer	a amazing thx
KloschÃ¼ssel Sniper	HOLY MOLY I LOVE YOU
MixÃ¨r ÄªÃ±DiaÃ‘	Yeee update a raha hai
kevin akbar	Ohh noo the witch
Abdurrahman Naseer	O WOW GOOD
nathanielchavez1	Ye thats gon na help alot i bairly have any elixer for loon
Armir Velcani	Like cr
Selot Akash	Very nice update
Ø­Ù…Ù„Ø© Ø§Ù„ÙˆØµÙˆÙ„ Ù„Ù„Ø¹Ø´Ø±Ø© Ø§Ù„Ø§Ù Ù…Ø´ØªØ±Ùƒ	So
Chirila Ruben	Fabulos
Mazaharul Islam	Oh no my clash of clan not Open ğŸ™„ğŸ™„
Nino Isaiah Geronimo	Wow to many troop being balancing
Karan Chilwal	Bad day for WitchesğŸ˜‚
GoldenPrince spkys	X Bow ğŸ˜­ğŸ˜ 
à¦‡à¦¸à¦²à¦¾à¦®à¦¿à¦• à¦—à¦œà¦²	nice
GoBeleck Mobi	Vn Äiá»ƒm Ranh
mayke silva	BOLSONARO2018 ğŸ˜‚ğŸ˜‚ğŸ˜‚
BiG BoSs	This is great but I m mostly excited for Clan War Leagues Who else is excited for Clan War Leagues like down belowğŸ‘‡â˜º
FeuerLord 9	Was heiÃŸt da
Vasava Parthiv	Bhai witch kaa galat haa hit point kam ker diya
GÃ‰LINO DÃ‰LIRO	OMG I like Clash of Clan
General Star	I thought the archer barbarian and goblin will decrease the gem donation
Clash with EUROHUNTER	AWESOME
Endamou Rourou	OMG
Vinsmoke Sanji	go update
Ù…Ø­Ù…Ø¯ Ø§Ù„ØµØ§ÙŠØ¯ÙŠ	Ù…Ù…ÙƒÙ† Ù…Ø³Ø§Ø¹Ø¯Ù‡ ÙŠ Ø³ÙˆØ¨Ø± Ø³ÙŠÙ„ Ø§Ø±ÙŠØ¯ Ø§Ù† ØªÙˆØµÙ„Ùˆ Ù‚Ø±ÙŠØªÙŠ Ø¨Ù…Ø¹Ø±Ù
Touheed Ehmad	Pak player Like thokoğŸ˜‰ğŸ’ªâœŒ
Jasin AJ	artillery buff and additional inferno
ICASAS GAMING	i an so excited supercell pls update now ğŸ˜…ğŸ˜‚
OYUN DÃœNYASI	Gelsin guncelleme supercell
Ahmed Gamer	Ooooo I m soooo happy ğŸ¤©ğŸ¤©ğŸ˜ğŸ˜ğŸ˜ğŸ˜ğŸ˜ğŸ˜ğŸ˜ğŸ˜
Cricket Jagat	When did the update will come
Ù†Ù‚Ø§Ø¡ Ø§Ù„ÙˆØ±Ø¯	Ø´Ø¹Ø¬Ø¨ Ù…Ùˆ Ø¨Ø³ ÙƒÙ„Ø§Ø´ Ø±ÙˆÙŠØ§Ù„ ÙŠØ³ÙˆÙŠÙ† Ø§Ù„Ù‡Ø§ Ù‡Ø¬ÙŠ Ù…Ùˆ ØµØ­ÙŠØ­ Ø¨Ø³ Ù‡Ø³Ù‡ Ø§Ø­Ø³Ù† ÙŠÙƒÙˆÙ„ ÙˆÙŠØ§ÙŠ Ø­Ù‚ Ù„Ø§ÙŠÙƒ
vividz	When
Chaman Arya	à¤®à¥‡à¤°à¤¾ à¤­à¤¾à¤°à¤¤ à¤®à¤¹à¤¾à¤¨ ğŸ‡®ğŸ‡³ Love From India ğŸ’—
AssortedGaming 201	I watched the whole video before commenting ğŸ˜
Ø§Ù…ÙŠÙ† Ø§Ù„Ù†Ù…Ø±	Ù…Ø§ ÙÙ‡Ù…Øª Ø´ÙŠ
Spring Li	Yeet I agree with most of these balance
ê¹€ì„±ë¯¼	why are there so many update in coc now a day
TahtOne Guy	Gem Reduced Gem Redu GEm rE GEM INCREASE gem reduce
Yousef games	IM RAEDY EL UPDATE
ANIKET BANERJEE	It s lot of balancing this month
Meren Imchen	What why witch and x bow dmg reducedğŸ˜­ğŸ˜­ Damn I have to ug storage agn ğŸ˜­
archana pathak	wowww
Interesting Movement	I love you coc
mad phobia	additional inferno tower for th2 is gone protect me from those E dragon and why they dint get damaged reduced or hitpoints ğŸ¤”
Daniel_Gaming	i love fair
Shashank Jerry	I think adding a third inferno on th12 is a flop idea It s not easy to 3star a max th12 with 2 inferno and SC adding a other one wooowwwğŸ˜‚ğŸ˜‚ğŸ˜‚
Ø§Ø­Ù…Ø¯ Ø¹Ø¨Ø¯ Ø§Ù„Ø¹Ø¸ÙŠÙ…	Ø¹Ø§Ø§Ø§Ø§Ø´ ÙˆØ§Ø®ÙŠØ±Ø§Ø§ Ø§Ù„ØªØ­Ø¯ÙŠØ« Ø¬ÙŠÙ‡ ÙŠ Ø¹Ø±Ø¨ğŸ˜ğŸ˜ğŸ˜‚
Dersim Hozat	Who ğŸ˜­ğŸ˜­
kerala god's own country	1st
BLACK MASK007	TQ for new lvl gold mine and elexier collector
Ğ˜ÑÑ‚Ğ¾Ñ€Ğ¸Ğ¸ Ğ¾Ñ‚ ĞÑ€Ñ‚Ğ°	Ğ£Ñ€Ğ° Ğ±Ğ»ÑÑ‚ÑŒ
MrRonski	THIRD INFERNO TOWER FOR TH 12
Ø§Ù†Ø¯Ø±ÙˆÙŠØ¯ Ø§Ù„ØªØ¹Ù„ÙŠÙ…ÙŠ	Ø¢Ù„Ø¹Ø±Ø¨ Ù†Ø±ÙŠØ¯ Ù†Ø´Ù€ÙˆÙ Ù„Ø¢ÙŠÚ¯Ø¢ØªÚ¯Ù…Ù€
Hivane D	WHERE IS THE LIGHTNING SPELL
Robert 03	O o I love this update
gaming with Deepak	I am very very very excited
fares elkasas	Ø§Ù†Ø§ ÙŠÙˆØªÙˆØ¨Ø± Ø¬Ø¯ÙŠØ¯
Ø§Ø­Ù…Ø¯ ÙƒÙŠÙ†Ùƒ	ÙŠØ¹ÙŠØ´ ÙƒÙ„Ø§Ø´
YouTube gaming 44	Woow
Ø¹Ø¨Ø¯Ø§Ù„Ù„Ù‡ Ø§Ù„Ø¯Ø±Ø©	Wooooo sweet
Erotic Videos	ğŸ‡¹ğŸ‡·ğŸ‡¹ğŸ‡·â¤â¤
Steve Stevenson	100 more wall To what town hall Love the sound of the new inferno tower tho and the pump mine drill level Also glad siege machine are going to take le time Thx Supercell
Prabhudayal Sharma	COOL UPDATE EVER FOREVER MY COC TAG PULYV099R
Imi HegedÃ¼s	Haloowen undate pls
Spirit Idaham	Nothing change on hero
Roger M	Who TH 10 in here
Mattyyo im	gg to Supercell
Airil Danish	wow
MOD-Militia	Wow now that s what called a balance
â€¢ Sons of Garmadon â€¢	GEM DONATION DECREASED
Md Alamgir Shaikh	In this update clan war league will come or not Plz tell me coc
Ø®Ø§Ù„Ø¯ A_R	ØµØ±Ø§Ø­Ø© Ù…Ø§ÙØªÙ‡Ù…Øª Ø´ÙŠ Ø¨Ø³ Ù„Ø§ÙŠÙƒ
IQBAL SIDDIQUEE	Love u Clash of Clans and SUPERCELL
Dylan bates101 bates101	Yes
CLASHING WITH HARSH	Amazing update I love this update but many troop hit point are gon na reduce but and gem donation is reduced of many troop
Hero	RIP witchslap
GaMeR RajaT	Is this update coming tomorrow
Chameli Debnath	Wow
xndxYt	ğŸ˜¡
Sate Ayam	Woy kok giat gak ada gak seru
Fjdjdudujej Dndudnjdufjdjf	Ù†Ø±Ø¬Ùˆ Ø§Ù„ØªØ±Ø¬Ù…Ø© Ù…Ù† Ø´Ø±ÙƒØ© Ø³Ø¨Ø± Ø³Ù„
Sujoy Biswas	Coc lover hit like ğŸ‘
Ragiel Febriansyah	perfect
Dipto Paul	When this balancing update will come
Kaul saab	love from India
Rohan Laher	Is this tomorrow
Ğ–ĞµĞ½Ñ Ğ›	Realy And I thought
AYUSH YADAV	LoveğŸ˜˜ğŸ˜˜ğŸ˜˜YouğŸ˜ğŸ˜ğŸ˜ Clash Of Clans ğŸ”¥ğŸ”¥ğŸ”¥ğŸ”¥ğŸ”¥
INDIAN GAMER UDAY	I am so exitedğŸ˜‚ğŸ˜‚ğŸ˜‚
nightmare bonnie	Der x bogen war wirklich zu stark
Random Guy	Wait is there another inferno tower in town hall 12
Ù…Ø­Ù…Ø¯ Ø®Ù„ÙŠÙ„	ÙŠØ¹Ù†ÙŠ Ø¨Ø§Ø¬Ø± ØªØ­Ø¯ÙŠØ«
Kriss O	Yay New level of mine And of course new inferno tower This update sound good But please don t trash a loop Edit WHERE IS THE UPDATE
Ù…ÙŠÙˆØ²Ùƒ Arbek	Ø§Ù†Ø§ Ø±Ø­ Ø§ØªØ±Ùƒ Ø§Ù„Ø¹Ø¨ÙŠ Ù„Ù† Ø¶Ø¹ÙØªÙˆ Ø§Ù„Ø³Ø§Ø­Ø±Ù‡
ChÃ­ Trung DÆ°Æ¡ng	Well get ready to smash the magic hammer on your base and pick a fight in the clan war league
King Of The Gaming	In th 10 dark elixir drill and gold mine and elixir pump can upgrade to lvl 13
Parth Sharma	Nice balance update I love it
Shirish Ghimire	Listen If u wan na give u most suprise and Biggest update than that will be the Reducing cost of wall Or 50percent discount event to upgrade wallsğŸ™
STRIKE	Ğ›Ğ°Ğ¹Ğº ĞºÑ‚Ğ¾ Ñ€ÑƒÑÑĞºĞ¸Ğ¹
GiganJr13	Wow Witch got nerfed big time
Gaurav Gaming Zone	This update will take my progress 2 3 month backward due to new resource lvl in th 10ğŸ˜¢ğŸ˜¢ğŸ˜¢
RISHI SHARMA	Clash of clan lover ğŸ‘‡like
Mr. Thadasi Maeda	bagus lah tingkatin lagi ğŸ˜
Kevin Durant	can t wait to join for CWL ğŸ’ªğŸ’ªğŸ’ª
ML mI	omg
JoÃ£o Paulo	AlguÃ©m do Brasil me explica isso
the dragon warriors	Goood update
Hacker Vardan	Good sir ğŸ‘ğŸ‘ğŸ‘ğŸ‘ğŸ‘
Rahul yadav	thats not fair for those witch
DOMIN CLUSTER	Yay
Ahmed Allamey	ÙƒÙ„Ø§Ø´ Ø§ÙˆÙ ÙƒÙ„Ø§Ù†Ø³
Sanjay Ims	ğŸ‘Œsuper cell
Kevin Valentino	Too late this game already dead
Sahban Khan	C a fun
Christian64	gem donation decreased
Alberto 1344	The witch is horrible now
SebastiÃ¡n	Genial
Sarnab Das	Awesome
Ù†Ù‚Ø·Ù‡ Ø¨ÙŠØ¶Ø§Ø¡	ÙˆØ§Ùˆ Ø§Ù…ÙˆØª Ø¹Ù„Ù€Ù‘Û“ Ø§Ù„ÙƒÙ„Ø§Ø´
The Games Ø§Ù„Ø§Ù„Ø¹Ø§Ø¨	Ù…ÙŠÙ† Ø¹Ø±Ø¨ÙŠ ÙŠØ´ØªØ±Ùƒ ÙˆÙ…Ø±Ø¯ÙˆØ¯Ù‡â¤
Riya Aktar	Nice update tank you super cell from Bangladesh
viper xD	Lmao new inferno tower at th12
Amit Pal Gamer	Awesome update ğŸ‘ğŸ‘ŒğŸ™Œ
Ù…Ø­Ù…Ø¯ Ù†ÙˆØ± Ø§Ù„Ø­Ø§Ø¬ Ø¹Ù„ÙŠ	Ø´Ø¨Ø§Ø¨ Ø¨Ø¹Ù†ÙŠ Ø§Ø¬Ø§ ØªØ­Ø¯ÙŠØ«
Axyell WÃ«qazer	I Love It ğŸ˜
EDUCATION AURA	Love from india
Random G4M3R	When you see there is finally an update
Bekzat Jamalov	Ğ§Ñ‚Ğ¾ Ğ·Ğ°Ğ²Ñ‚Ñ€Ğ° Ğ¾Ğ±Ğ½Ğ¾Ğ²Ğ°
nguyá»…n viá»‡t	deck hieu
Pikos Apikos	Balance of the year
Mamta Agarwal	Literally best way to show it
Ø§Ù„ÙƒØªØ±Ùˆ Ø¯Ø±ÙˆÙŠØ¯	Sumit 007 ka ma chodo
Hemant Kumar	sabse accha update ab tak ka
XtremE16	ğŸ˜‚
Nhick Morato	Halakit
Narendra Bhatnagar	So if this is the october update where atmre the league and other new stuff
Eagle eye	Wow good update
Papon Bir	wow massive changeğŸ˜
LAZYBOY MM14	these are awesome but please reduce the training time for electro dragon
Asamibin Baktiar	ğŸ˜Š
clash Guru Piyush	Love it
RoyalBT1	I Love Playing Clash of Clans
Abhijit Das	Nice update But why reduce witch s hitpoint and damage per second ğŸ˜
Bling Bling Man	It come out tommorow
Clash with Game	Today bring this update
vinc s.	Gem donation decreased
Naveen Sakkuri	Hmm I recently got witch to lvl 2 for witch slap No it s damage and hit point reduced
Sagar Poudel	Why x bow damage decreased why why
Ø³Ø§Ø­Ø± Ø§Ù„Ø¹ÙŠÙˆÙ†	Ù…ÙŠÙ† Ø¨Ù†Øª
Harkaran Ram	Sick
Pro Gaming with Pro Gamer	Love you supercell
MOHMMAD FOR GAMlNG	ğŸ’ªğŸ»ğŸ˜
Ø£Ø³Ø§Ù…Ø© Ø§Ø¨Ùˆ Ù‡ÙŠØ«Ù… Ù„Ø§Ø³Ø¯ Ø§Ù„ØºØ§Ø¶Ø¨	Ù…ÙŠÙ† Ø¹Ø±Ø¨ÙŠ Ù„Ø§ÙŠÙƒ ğŸ‘ğŸ˜
Madhur Goyal	Time to Reinstall
Ø£Ø³Ø¯ Ø§Ù„Ø¹Ø±Ø§Ù‚	Ù…Ù†Ùˆ ÙŠØ¹Ø±ÙÙ†ÙŠ ğŸ˜†â¤ğŸ˜ ÙŠØ­Ø· Ù„Ø§ÙŠÙƒ ğŸ’•ğŸ‘
south america memes	Alguem do Brasil
Biki Sen	Nice
devil	Wow I am exited but u decrised too much trip Hotpoint and damage
dawood aa	hope radicalrosh do video about this update like clash royal I will be soooo glade about that same with you coc fan
Ù…Ø­Ù…ÙˆØ¯ Ø§Ù„Ø­Ù„Ø¨ÙŠ	Ù…ÙŠÙ† ÙØ§Øª Ù…Ù† Ù‚Ø±ÙŠØ© ÙŠØ­Ø· Ù„Ø§ÙŠÙƒ ÙˆØ§Ù„Ø§Ø´ØªØ±Ø§Ùƒ
Detrouty	Very good but can we get more balence for th8 th9and th10 defence
MISUALPA TV	Nice Always love this game
Lyonix	Poor Witch
Abhiyan Dhungel	No I always witch slap in war now what
Omar Issa	Ø´Ø¨Ø§Ø¨ Ø§Ù„Ø¹Ø±Ø¨ Ø­Ø¯ ÙŠÙÙ‡Ù…Ù†ÙŠ Ø´Ùˆ ÙŠØ¹Ù†ÙŠ Ù‡Ø§Ø¶
Tobi Tobias	I want miner buff â¤â¤â¤
Wonderful Ronak	Love from India
TECHNO WORLD	Paise kamane ke liye ye kya ant sant video bnavat ho
Simon Ziegler	New level on mine and collector The thing I ever wished
ARMAN DON	i love coc ğŸ’™ğŸ’™ğŸ’™
Ahmad Hossny	Ø§Ù„Ø¹Ø±Ø¨ÙŠ Ù„Ø§ÙŠÙƒğŸ˜‚ğŸ’ªğŸ’£
Geetanjali Kore	NICE UPDATE ğŸ‘¨ğŸ‘¨
ØµÙƒØ§Ø±Ù‡Ù… ØµÙƒØ§Ø±Ù‡Ù…	Ø´Ù†Ùˆ ÙŠØ¹Ù†ÙŠ
z x	Åu oyun da ormana ingili biÅŸey getirin
Ğ¡ÑƒĞŸĞµĞ  Ğ¡Ñ‚ĞĞ¿Ğ	ĞšĞ›ĞĞ¡Ğ¡
Raju Ansari	Wow
star gaming world	This is the best upgrade of coc when did new clash a Rama episode will be uploaded Plz tell anybody who is agree with me and like this upgrade like ğŸ‘‡ğŸ‘‡ğŸ‘‡ğŸ‘‡ğŸ‘‡ğŸ‘‡
Amit Kumar Sarangi	So witch are getting a huge nerf in this update it seems Well at least the siege balancing wa good to see Those were pretty hard to find n receive forget donating them tbh
Hussain 2016	gamemode 1
Rajan Dahal	We are waiting for this update do it a well a soon possible
SO HO	the game gon na to be more deficult
Mosa Naman	WOOOOOOOOOOOOOW
Ø§Ù„Ù…Ù„Ùƒ Ù…ÙˆØ³Ù‰	Ù…Ø§ÙÙ‡Ù…Øª Ø´ÙŠ Ù‡Ù’ÙÙ‡Ù’Ù‡Ù’ÙÙ€ğŸ˜‚ğŸ˜‚ğŸŒºÙ’Ù€Ù’ÙÙ‡Ù’Ù‡Ù’ÙÙ‡Ù’Ù‡Ù’ÙÙ€ğŸ˜‚ğŸ˜‚ğŸŒºÙ’Ù€Ù’ÙÙ‡Ù’Ù‡Ù’ÙÙ‡
HonesT.D	Finally something new which I love
Biswarup YT	It suck
Haitam07 Hass	Was geht da ab
sonic fire strom	witch nerf
á¹¨á¸°á¼¿LÂ·LÂ·á¹¨ vÍ¢áµp	Ø§Ù„ÙŠ Ø¹Ø±Ø§Ù‚ÙŠ Ù‡Ù†Ø§ Ù„Ø§ÙŠÙƒ ğŸ˜‚ğŸ˜‚
Monster devil	3rd inferno sight that is going to make attack more hard
doston xursanmurodov	Ğ§Ñ‚Ğ¾ Ğ·Ğ° Ğ¿Ñ€Ğ¸ĞºĞ¾Ğ» Ğ¾Ğ±ĞµÑĞ½Ğ¸Ñ‚Ğµ
GAMEonSITANSHU	So Finally the update is on 22
ĞšÑ€ÑƒÑ‚Ğ¾Ğ¹ ĞšĞ°Ğ·Ğ°Ñ…	Nice balance update
King Blandus	Finalmente ğŸ˜
Shahid Dogar	Ø§Ú†Ú¾Ø§ Ù¹Ú¾ÛŒÚ© ÛÙˆÚ¯ÛŒØ§
your comment might not work so please	I left it 4 year ago still like the video
GMD ChocoBlocko9 [60hz]	There is like nothing bad
Araf Tafi	Because of sumit bhai we already knew this before love sumit 007 from Bangladesh
Tontsch Sven	22 10 Tomorrow it s the update
sachin Dhakad	Wow
harith luqman	Went new update release at Malaysia Sorry im so bad at e nglish
Asd alasood94	Ø§Ù„Ù„ÙŠ ÙÙ‡Ù… Ø´ÙŠ ÙŠØ®Ø¨Ø±Ù†Ø§ ğŸ¤”
Muhammad Zuhdi	Halloween
Ø§Ù„Ù…Ø­ØªØ±Ù ÙÙŠ Ø§Ù„Ù…Ø¹Ù„ÙˆÙ…Ø§Øª	Ù‡Ø°Ù‡ ØªØ­Ø¯ÙŠØ« Ø§Ù†Ø§ Ù…Ùˆ ÙØ§Ù‡Ù… Ø´ÙŠØ¡ Ù…ÙŠÙ† Ø¹Ø±Ø¨ÙŠ ÙŠØ±Ø¯ Ø¹Ù„ÙŠØ§
Satyam Soni	BowlersğŸ˜ğŸ˜ğŸ˜ğŸ˜
Jonathan Hudson	3 torres inferno no cv12 vai ficar dificil
Rohit Prasad	So much to balancing when you know that your game is dead
TECHNICAL BHARAT	Love it but super active
VINOD KALLO	when update will come
à¦¸à§ˆà§Ÿà¦¦ à¦°à§à¦®à¦¨	à¦“à§Ÿà¦¾à¦“
Askarsi Dede	When Is The Update
Juan Ignacio Tejero	Lol I think that around 70 of CoC player are IndianğŸ˜‚ğŸ˜‚
Ø³ÙˆØ±ÙŠØ§ Ø§Ù„Ø¹Ø²	Ø§Ù„Ø³Ù„Ø§Ù… ÙˆØ¹Ù„ÙŠÙƒÙ… ØµÙ„Ùˆ Ø¹Ù„Ù‰ Ø§Ù„Ù†Ø¨ÙŠ
DR ANDROID Ø¯ÙƒØªÙˆØ± Ø§Ù„Ø£Ù†Ø¯Ø±ÙˆÙŠØ¯	Ø´ÙƒØ±Ø§ Ø´ÙƒØ±Ø§ Ø´ÙƒØ±Ø§ ÙˆØ¨Ø¯ÙŠ Ù…Ù„ÙŠÙˆÙ† Ù„Ø§ÙŠÙƒ Ø¹Ø´Ø§Ù† ÙŠØ´ÙˆÙÙˆØ§ Ø´ÙƒØ±Ù†Ø§ Ø§Ù„Ù„Ù‡ Ø¹Ù„ÙŠ Ø§ØªØºÙŠØ±Øª
Kavita Bhardhaj	605 to like
Ø³Ø§Ù…Ø± Ø²Ø±ÙŠÙ‚	Ù…ÙŠÙ† Ø¹Ø±Ø¨ÙŠ ÙŠØ­Ø· Ù„Ø§ÙŠÙƒ
Sajjad ali	Witch ka level 2 ka power down Kyu Kiya ğŸ˜¥ğŸ˜¡ğŸ˜ 
Meera Deshpande	India o ready for the update We love coc
Ø¹Ø§Ø´Ù‚ ÙƒÙ„Ø§Ø´	Ø¥Ø°Ø§ Ø§Ù†ØªØ§ Ø¹Ø±Ø¨ÙŠ Ù„Ø§ÙŠÙƒ
Mr. blbol	ÙˆØ§Ø®ÙŠØ±Ø§ Ø§Ø¹Ù„Ù†ÙˆØ§ Ø¹Ø§Ù„ØªØ­Ø¯ÙŠØ«
GAMING WITH MUKUL	TH 9 like thoko
Yunus Pathan	OMG great can u add legend league player personal chat room if not then why
Moh7 S	Ù…ÙÙ€Ù†ÙˆÙ ÙÙÙ‡ÙÛâ€â€Ù…ÙÙ€ Ø´Ù‘Ù€ÙŠÙ€ï®¯ğŸ˜‚ ÙŠÙ€ï®¯Ù„ÙÙŠÙ€ï®¯ Ù…ÙÙ€Ø«Ù‹Ù„ÙÙŠÙ€ï®¯ ÙŠÙ€ï®¯Ø­Ø·ÙŒÙ€ Ù„ÙØ¢ÙŠÙ€ï®¯Ú¯ğŸ˜€
Ğ”ĞµĞ½Ğ¸Ñ ĞšĞ°Ğ½ĞµĞ²	Ğ—Ğ°Ğ²Ñ‚Ñ€Ğ° Ğ¾ Ğ½Ğ¾Ğ²Ğ°
BOLTIC NISCHAL	Maybe training time decrease for lava hound
Prophec Stuffs	Would love if wall upgradation price have been reduced Anyways thanks
isteveindir	TÃ¼rkiye buradami ğŸ‡¹ğŸ‡·
Rajput Gamers	Hit like for this update thanks supercell
Ø´Ø¨Ø­ Ø£Ù„Ø§Ù†Ù…ÙŠ Anime Ghost	Ø§Ù„ÙŠ Ù…Ø§ÙÙ‡Ù… Ø´ÙŠ ÙŠØ¯ÙˆØ³ Ù„Ø§ÙŠÙƒğŸ˜‚ğŸ˜…ğŸ’”
à¤¸à¥à¤œà¤¨ à¤¥à¤¾à¤ªà¤¾ à¤®à¤—à¤°	We need builder hut 6
Pablo PeÃ±a	BRAWL STARS ğŸ˜¡ğŸ˜¡ğŸ˜¡ğŸ˜¡
adib mouhanna	Aeosme
Srijan Kumar	When will clan war league come
imadeyoureadthis 121	When s coming
Ø§Ù…ÙŠÙ† Ø¹Ø¨Ø¯Ø§Ù„Ù‚ÙŠÙˆÙ… Ø§Ù„Ø¹Ù…Ø§Ø³ÙŠØ¨	Finaly
Pritam Guru	Ye update kb aaiga ğŸ˜
Luciano Corvino	Reduce eletro Dragon time training pls
Slo. Expert	Omg why witch ğŸ˜–
VIJAY ANNA FAN	â¤
ProMasonGuy Gaming	Clash of clan should do balance update more often
HoÃ ng Pháº¡m	ğŸ‘
GULFAM GAMER	Hi supercell
MR. sulppe	400
Ayush Upadhyay	I am unhappy with reducing the damage and hot point of witch but with other balance
YARGIÃ‡ TONY	TÃ¼rkiye ğŸ‡¹ğŸ‡·ğŸ‡¹ğŸ‡·ğŸ‡¹ğŸ‡·
S.m Humayra	à¦¸à¦¾à¦²à¦¾à¦°à¦¾ à¦†à¦°à§‹ à¦à¦•à¦Ÿà¦¾ à¦‡à¦¨à¦«à§‡à¦°à¦¨à§‹ à¦Ÿà¦¾à¦“à§Ÿà¦¾à¦° à¦¦à¦¿à§Ÿà§‡à¦›à§‡ à¦…à¦¬à¦¸à§à¦¥à¦¾ à¦¬à§‡à¦—à¦¤à¦¿à¦•
Ahmed Shaikh	hell yeah wow im never ever going to max my trap in my rushed th12ğŸ˜‚ğŸ˜‚ğŸ˜‚ğŸ˜‚ they would have added a pause to a boost in qualuty life change
Kirat Chahal	When this update will take place
Henrique Gabriel	Que daora
Md Parvez	I don t like that game
xgamer 0123	Coc studio I don t want to explain you about your troop but dark troop need dark elixir for upgrade
Dark Gamer	Can t wait for it
Brutal Clashing	Heyyy
LemonSky COC	Wehre are the German Players Hit on Like
Clash With Mayur Parmar	Why reduced witch she needed to buff ğŸ™…ğŸ™…ğŸ™… RIP WITCH
Paris 23	Definitely a lot
Mahadi Shagor	wowwwww
Earthling117	Please bring builder base Clan war It would be fun
Amanul Haque	Wow
coc guru king	Who like clash of clan like kro
john carlo Marquez DROID HACKING	where s the clan war league
à¤¬à¤¿à¤­à¤¾à¤¸ à¤®à¥‹à¤‚à¤¡à¤²	Nice
Youtuber Mehul	Good job supercell
?Mr. ArT!	LOL
Ø¨Ù†ØªÙƒ ÙŠØ§ Ø¹Ø±Ø§Ù‚	Ù‡Ùˆ Ø¹Ù† Ø´Ù†Ùˆ ÙƒØ§Ø¹Ø¯ÙŠÙ† ÙŠØ­Ø¬ÙˆÙ† Ø§Ø­Ø¯ ÙŠÙÙ‡Ù…Ù†ÙŠ
praveen zalaki	1st
10.000 subs with no videos?	Hi guy I hope all of you have a great day
Ù…ÛØ±Ø§Ø¯ Ø§Ù„ÛÙ°Ø±ÙˆÛ§Ø­ Ø¢ï»ŸØ¨ØµÛÛ’Ø±Ø¢ÙˆÙŠ	Ø§Ù„Ù„ÙŠ Ø§ÙØªÙ‡Ù… Ø®Ù„ÙŠ ÙŠÙƒÙˆÙ„ Ø´Ù†Ùˆ Ù…Ø¹Ù†Ø§Ù‡Ø§
Ø§Ù…ÙŠÙ† Ù†Ø¹Ù†Ø§Ù†Ø¨	Ø§Ù„Ø§ÙˆÙ„ ÙÙŠ Ø§Ù„Ø¹Ø±Ø¨ğŸ˜
animasi A3	Indonesia Hadirr
Unstoppable Gamer	Nice I showed everybody in my house because there a big fan of clash of clan too Thank â€™ s for making a video on this really thank you
Legend of fusion Gaming #XD	but i am very shocked for witch hitpoints dicreasing
Anantharaman R	Massu
Mashal Darwish	Love it COC take my all the time â˜¹ğŸ™ğŸ™
à¦•à¦¿à¦‰à¦Ÿ à¦ªà§‡à¦¤à§à¦¨à§€à¦° à¦œà¦¾à¦®à¦¾à¦‡	super most like hit like for coc lover
Yossef Ahmed	Ø§Ù„ØªØ­Ø¯ÙŠØ« Ø¨ÙƒØ±Ù‡ ÙŠØ§Ø´Ø¨Ø§Ø§Ø§Ø¨ ğŸ˜ğŸ‘
Jay and Acronix	Wowww
Nur	New inferno Really
max___ e	Ø§Ø­Ø¯ ÙŠÙØ³Ø± ÙˆØ´ Ù…ÙƒØªÙˆØ¨
Linkman443	The Witch got Nerfed HARD
Apocalypse _March	Very cool Except killing the witch
Ø¹Ø¨ÙˆØ³ÙŠ Ø§Ù„Ø¹Ø±Ø§Ù‚ÙŠ	Ù…ÙŠÙ† Ø¹Ø±Ø¨ÙŠ ÙŠÙÙ‡Ù…Ù†ÙŠ Ø´Ùˆ Ù‡Ø§Ø¯
Ø¢Ù„ÙØ¬Û£Û—ÛÙˆÛ£ÙƒÛ£Û—ÛØ± Jokr	Ø§Ù„ÙŠ Ø§Ù„Ù…ØªØ­Ù…Ø³ Ù„Ø§ÙŠÙƒ ÙˆØ§Ø®ÙŠØ±Ø§ ğŸ˜˜ğŸ˜˜
xxSmartzz	Clash of Clans is very nice game
GENERAL JOHN	nice
Debojyoti Das	I don t like this update ğŸ‘ğŸ‘ğŸ‘ğŸ‘ğŸ‘ğŸ‘ğŸ‘ğŸ‘ğŸ‘ğŸ‘ğŸ‘ğŸ‘
Md Rashid	Anyone from IndiağŸ‘
Taikamuna	Wow that s a lot of balancing
RAJAT MAJUMDER	Too excited about this update
GAMING WITH NAV BHULLAR	Wow
Ali Rambo	Ø§Ù„ÙŠ Ø¹Ø±Ø¨ÙŠ Ù„Ø§ÙŠØ¬ ğŸ˜‚ğŸ˜‚
Fay Clasher's	nice nice nice
The King	Super update
Ù…Ø­Ù…ÙˆØ¯ Ù…Ø­Ù…ÙˆØ¯	Thank you Godhkin ğŸ˜‰
Rahul Giri	cvyylo add me friend
RomÃ¢nu' Geoge	Dang Ok then
GAMEING WITH ARYADEEP	india india
GAMING IS LIFE. SO GAME ON!!	So EVERYTHING IS DECREASED
Techno HD	Ø¨Ø¯Ø¹Øª Ø§Ù…Ùƒ Ø§Ø´ØªØ±Ùƒ
Rex The champion	Mic update coc
KHUSHIT THAKAR.	Why are u decreased witch hitpoints and damage pr sec
Tommy	Will it include the new war league goblin map etc
Nitro	The poor witch ğŸ˜­
Gaming Channel YT	first
Alone Boy	INDIANS like here
Elnur Gamer	ğŸ‘ğŸ‘
Nakib Akter	Golem Training cost decrease ğŸ‘ PEKKA No decreaseğŸ˜³ Wizard No decreaseğŸ˜© Dragon No decreaseğŸ˜­
COC Ledgend bro	Wow nice Ballance
Rakesh Bhadani	Nice video
Flake TOP5	Clash a rama ĞºÑ‚Ğ¾ Ğ½Ğ¸Ğ±ÑƒĞ´ÑŒ Ñ€ÑƒÑÑĞºĞ¸Ğ¹ ĞµÑÑ‚ÑŒ Ñ‚ÑƒÑ‚ Ğ¾Ğ±ÑŒÑÑĞ½Ğ¸Ñ‚Ğµ Ñ‡Ñ‚Ğ¾ Ğ·Ğ° Ğ²Ğ¸Ğ´ĞµĞ¾ Ğ²ÑĞµ Ğ¿Ğ¾ Ğ°Ğ½Ğ³Ğ»Ğ¸Ğ¹ÑĞºĞ¾Ğ¼Ñƒ Ñ Ğ½Ğ¸ ĞºĞ°Ğ¿Ğ»Ğ¸ Ğ½Ğµ Ğ¿Ğ¾Ğ½ÑĞ»
Game Boy	Dont scam LOVE FROM INDIA We know
Ğ”Ğ°Ğ½Ğ¸Ğ» Danil	ĞšÑ€ÑƒÑ‚Ñ‹Ğµ Ğ¾Ğ±Ğ½Ğ¾Ğ²Ğ»ĞµĞ½Ğ¸Ğ¸ Ñ‚Ğ¾Ğ»ÑŒĞºĞ¾ Ñƒ Ğ²Ğ°Ñ Ğ¿Ñ€Ğ¾Ğ´Ğ¾Ğ»Ğ¶Ğ°Ğ¹Ñ‚Ğµ Ğ² Ñ‚Ğ¾Ğ¼ Ğ¶Ğµ Ğ´ÑƒÑ…Ğµ
minion beta	NgÆ°á»i viá»‡t nam
patel power	Nice wHy dAte update coc 25 october
Noah CoC	Bout to level up to th10 lol
Ø¹Ø§Ø´Ù‚ Ø£Ù… Ø§Ù„Ø³ÙˆØ³	Ø­Ø¯Ø§ ÙÙ‡Ù…Ù†Ø§ Ø´ÙŠ ÙŠÙÙ‡Ù…Ù†Ø§ğŸ˜‚ğŸ˜‚ğŸ˜‚
Ğ¦Ğ²ĞµÑ‚Ğ¾ÑĞ»Ğ°Ğ² Ğ“ÑƒĞ³Ğ»Ğ¸Ğ½	Ğ•Ğ¹ Ğ¿Ğ°Ğº Ğ½ÑŠÑ€Ñ„Ğ½Ğ°Ñ…Ñ‚Ğµ ÑƒĞ¸Ñ‡Ğ°
kavisan kulasingam	that a good balance update
surendar singh	Haha
ÃµrbÃ¯t Shamim	So excited for update Love from Bangladesh ğŸ‡§ğŸ‡©ğŸ‡§ğŸ‡©ğŸ‡§ğŸ‡©ğŸ‡§ğŸ‡©ğŸ‡§ğŸ‡©ğŸ˜ waiting
Dimon23rus [ARX]	what about Halloween
Jhon Eane	Omyghod 3infernos
Camilo 0	Esta muy buena
LelekBeatZ 0,1k	Update will come this day
Ù„ÙŠÙ…ÙˆÙ† GAMER	YessssssssssssğŸ˜ğŸ˜ğŸ¤© WoooowğŸ˜˜ğŸ˜
Noor M Ladasabanavar	Love from India
omar omar	Ø´Ø±ÙƒØª Ø³ÙˆØ¨Ø± Ø³ÙŠÙ„ Ù†Ø²Ù„Ùˆ Ø­Ø¯Ø« ØªÙ†ÙŠÙ†
gaming king	nice
Amor Binupatto	Very cool
Arbaz Ali	Wow I can t wait
Ù…Ø­Ù…ÙˆØ¯ Ø§Ù„Ù…ÙŠØ§Ø­ÙŠ	Ø´Ø¨Ø§Ø¨ Ù…Ù…ÙƒÙ† ÙˆØ§Ø­Ø¯ ÙŠØ´Ø±Ø­Ù„ÙŠ Ø´Ù†Ùˆ Ù‡Ø°Ø§
RAYMOND XD	wow nice ğŸ˜®ğŸ™ŒğŸ‘ŒğŸ‘
iValNether 324	Xd
Ahmed Etalya	ÙˆØ§Ùˆ
COC King	Update date
Rayhan Rawnak	love from Bangladesh
Ahmad Ahmad	Oh my god
Indian Vrother	Bullshit Where â€™ s the nerf to air attack at th9
Tub man	Ù‡Ù„ ÙŠÙˆØ¬Ø¯ Ø¹Ø±Ø¨
ØºØ±ÙŠØ¨Ø© ÙŠØ§Ø¯Ù†ÙŠØ§	Each of u life two life one in a dream the other take u to the grave Fernando PessoağŸ’šğŸ’šğŸ’š
alconvigia100	Hola ğŸ˜âœŒï¸
Ø¹Ù„Ø¢ÙˆÙŠ Ù†ÙŠÙ…Ù€Ø¢Ø±	ÙŠØ¹Ø±Ø¨ ÙÙ‡Ù…ÙˆÙ†ÙŠ Ø§ÙŠØ´ Ù‡Ø§Ø°
VB Studios	impressed
Justin T	New level are correct
Z Dreams	Ù†ÙŠÚ¨Ø§ Ø§Ù„Ù‚Ø§ÙÙ„Ø© ÙÙŠ ÙƒÙ„ Ù…ÙƒØ§Ù† ğŸ”¥ğŸ”¥ğŸ”¥
Ğ•Ñ€Ğ³Ğ°Ğ»Ğ¸ ĞĞ±Ğ°Ğ±Ğ°ĞµĞ²	
Udyant Singh	Ooooh very nice
CLASH OF CLANS #INDIA #COC FOREVER	Finally decrease
Alia Bhat	Hi
HÃ¼seyin Dursun	Welcome to play game Clash of Clans ğŸ•¹
Avengers Assemble	Thanks supercell
Zubair Malik	THEY ALSO SHOULD HAVE REDUCED TRAINING TIME
Havoc Kiran	tomorrow update
TALHA HASSAN	anyone from pakistan â¤
Raymond Bauer TÃ˜P	Wut Third inferno
Adel GAMER	Ù…Ù…ÙƒÙ† ØªÙˆØµÙ„ÙˆÙ†ÙŠ Ù„ 1000 Ø§Ù„ÙŠÙˆÙ… ÙƒÙ… ÙˆØ§Ø­Ø¯ ÙƒÙÙˆ â¤
Frank Sinatra	I want the hog to fry
Clashing Papa	Wow
Kyle Rodgers	Ooo so many good thing that are coming
Deep Gope	Nice
Gaming University	Wow
Theo Priftakis Abascal	Cool
Lily Josephine Kujur	Good
Maria	Top obrigada
komik sporcular	Yes
Flying Ryder	PUBG and COC 4life
Rahmat Raha	Town hall 9
Goku El legendario super sayayin	Like
Varun Kumar	GEM DONATION DECREASED As if anybody care
aabid	3 inferno oh my
ZOMBIE â€‹â€‹	Hummer
Ğ•Ñ€Ğ°ÑÑ‹Ğ» ĞœĞµĞ½Ğ´ĞµÑˆ	Ğ—Ğ°ĞµĞ±Ğ¸ÑÑŒ
prisoner of the dab police prison	125
Harsh Rana	Love india
Yash Acharya	I am early Just a random question Who love Eminem
Ø­Ù…ÙˆØ¯ÙŠÛ’ Ø£Ù„Ø¬Ø¨ÙˆØ±ÙŠÛ’	Ø§ÙƒÙˆ Ø¹Ø±Ø¨ Ø¨Ù„ Ù„Ø¹Ø¨Ù‡ ğŸ˜‚
Omkar Bhakare	Sab khel khandoba ho gya
Ù†ÙŠØ±Ùˆ Ù‚ÙŠÙ…Ø±55	Ø´Ø¨Ø§Ø¨ Ø§Ù„Ø¹Ø±Ø¨ÙŠ Ù„Ø§ÙŠÙƒ
ç²˜æ™¯å ¯	WOW SO COOL
Ø§Ù„ØºØ¶Ø¨ Ø§Ù„Ø³ÙˆØ±ÙŠ	Ø´Ù†ÙŠ Ø§Ù„Ø³Ø§Ù„ÙÙ‡
Sahil kumar	love from india
Abstergo TV	Pubg or Coc ğŸ˜
Josua Graf	Nice
Kinger Pro Game hacker	best game ever
Youcef sama	ÙˆØ£Ø®ÙŠØ±Ø§ ØºØ¯Ø§ Ø§Ù„ØªØ­Ø¯ÙŠØ«
Fada Ali	BUNDAN BÄ°R ÅEY ANLAYAN VARSA ANLATABÄ°LÄ°RMÄ°
SaMi thE rUdE boY	CLASH
Ø§Ù„Ø±Ø¦ÙŠØ³ Ø¹Ø¨Ø¯Ùˆ	Ø¹Ø±Ø¨ÙŠ ÙŠØ·ÙŠ Ù„Ø§ÙŠÙƒ
Ro Gaming26	when you release game in romanian language
Ahmed Hussein	Love this game from Iraq ğŸ‡®ğŸ‡¶
Kamal Syria	Ø§ÙŠÙ…Øª ØªØ­Ø¯ÙŠØ«
NEYMAR JR	waiting for update from Bangladesh â™¥
K A	COC khabib fan must watch An Insignificant man movie on YouTube on kejriwal ji PM of India 2019 ğŸ’“ğŸ’“ğŸ’“ğŸ’“ğŸ’“ğŸ’“ğŸ’“
Nightmare YT	Ğ‘Ğ»Ğ¸Ğ½ Ğ½Ğ¾ Ğ¿Ğ¾Ñ‡ĞµĞ¼Ñƒ ÑˆĞ°Ñ€Ñƒ Ğ½Ğµ ÑĞ½Ğ¸Ğ·Ğ¸Ğ»Ğ¸ ÑÑ‚Ğ¾Ğ¸Ğ¼Ğ¾ÑÑ‚ÑŒ Ğ­Ğ»Ğ¸ĞºĞ°
Just Technology	Lol
Lukas geimer	ğŸ‰âš¡ğŸ¤—ğŸ¤—ğŸ¤—
kartiki kashinath	WAITING FOR THIS UPDATE WE WANT NEW TROOPS
Ø±Ø¶ÙˆØ§Ù† ÙƒØ±ÙŠØ´Ù†Ø§	ğŸ‘ğŸ‘ğŸ˜±ğŸ˜±
Prashank Yadav	Witch slap band hoga kya
Ø­Ø³Ø¤ÙˆÙ†ÙŠ Ø§Ù„Ø¹Ø±Ø§Ù‚ÙŠ HD	Ø±Ø¨ÙŠ Ø±Ø³Ø¨ ÙƒÙ„ Ø·Ø§Ù„Ø¨ ÙˆØ·Ø§Ù„Ø¨Ù‡ Ø§Ø´Ø§Ù ØªØ¹Ù„ÙŠÙ‚ÙŠ ÙˆÙ…Ø§Ø´ØªØ±Ùƒ ÙˆØ§Ù„Ù„Ù‡ Ù…ØªØ®Ø³Ø± Ø´ÙŠ Ø§Ø°Ø§ Ø§Ø´ØªØ±Ùƒ
Rony Mundackal	Indians like here
Arya 1932	UPDATE HALLOWEENğŸƒğŸ‘»
Ø£Ù…Ø¨Ø±Ø§Ø·ÙˆØ±ÙŠØ© Ø¹Ø±Ø§Ù‚ÙŠ	ÙƒÙ„ Ø¹Ø±Ø¨ÙŠ Ù„Ø§ÙŠÙƒ
kirby abudanza	Subcire pls
Hello Guys	OH BOI
UJJWAL BRO	NYC guy India hit like button
[oNaczy_] snoez2006	Nice
FireFireFire HD	Is today the Update
khachar paranjay	Nice
Maycon Santos	Brasil cadÃª
AKRAM JAN	Ø§ÙˆÙ„
lecole Ken	C est mon anniversaire aujourd hui vous pouvez me donner un compte clash of clan
Technical Aayush	Nepali
Rem Mepp	El Salvador
Cameron Filson	Ea boy
Th3KillerStyle46	PRIMO
Aayush p84	R I P witch
COC with AYUSH	LOVE FROM INDIA ğŸ˜ğŸ˜ğŸ˜˜ğŸ˜˜ğŸ˜˜
Mirza Duhoki	Not nice clash of clan ğŸ‘
B B Ki Kings	Yaaaahooooooooooo Love coc i like new new new update wowowowowowowow
HADER RAED	ğŸ‘
SSG Alfa	TÃ­o no juego v
Nurlan Qubadzade	É™ladÄ±r qaqa
ARPAN MOHINTA	14 comment from India love to sup are cell
hÃ vÃ¸Ã§ ÄƒvÃ¯vÃ¤Ã±	Wiating Waiting for clan war league
Huynh Lan	Good
vansh singh	Nice
Yz Tv	Bangla language please
ĞĞ½Ğ´Ñ€ĞµĞ¹ ĞœĞ¾Ñ€Ğ¾Ğ·Ğ¾Ğ²	ĞĞ¾Ñ€Ğ¼Ğ°Ğ»ÑŒĞ½Ğ¾
XDongX	Like if Coc CR
Ankit Kaushik	I cant wait for balance changesğŸ¤£ğŸ¤£ğŸ˜‚ğŸ˜‚
Avishek Pandey	Loved itâ¤â¤â¤
all in one channel	Goid update
H-M16	Ø­Ù„Ùˆ
Mr Love	ĞœĞ¾Ğ¹ ĞºĞ°Ğ½Ğ°Ğ» Ğ·Ğ°Ñ†ĞµĞ½Ğ¸
Jozepf	Where are my India Players smash the like button ğŸ˜
Nabil Rahman	Clash of clan is the best of all in online game if think this is right then hit a like ğŸ˜‡ğŸ˜‡ğŸ˜‡
Bollywood BreakFast	Nice
Shubham production	Hi
Karan Sidhu	Hi darian
Ø­Ø³Ù† Ø­Ø³Ù† Ø¨Ø§	Ø£ÙˆÙ„ Ø¹Ø±Ø¨ÙŠ Ù„Ø§ÙŠÙƒ
ponio tonio	Wow
TiMi4	ĞĞ°Ğ°Ğ° Ğ¾Ğ±Ğ½Ğ¾Ğ²Ğ° Ğ·Ğ°Ğ²Ñ‚Ñ€Ğ°
Adolfo Carmona	Nice Vid
Athisriram K	Pubg player hit like
ĞĞ»ĞµĞºÑĞµĞ¹ Ğ‘Ğ¾Ğ±ĞºĞ¾Ğ²	ĞĞ»Ğ´Ñ‹ Ñ‚ÑƒÑ‚
DRAGBA	Ğ¢ĞĞ 
kuljinder singh	Love from india
Technical Clasher	tomorrow
Ù…Ù„Ùƒ Ø§Ù„Ù…Ù„ÙˆÙƒ	ğŸ¥°ğŸ˜˜ğŸ˜˜ğŸ˜ğŸ˜
Legendary Boy	India india
Kavish Yadav	Cool
Gaming with NAFI	1st
Oun Abbas	Thank u supercell
Deepak yadav	Hii supercell how are you reply me
Jelmer Volwater	Nice
NC VINES	Wow
Clash_with_noble	Awesome
ashiqul sarker	wow
Vishal Giri	Hit like clash of clan
Walking Statue	Love from India ğŸ‡®ğŸ‡³
Azza Ghallab	YOUR GOOD
chetan singh	plojoyjlq My tag
Mr LegendaryMan	Yo
Benedek Zoltan	Woooo
ClaZz	ITALY 3
Sebastian Soliz	Llege temprano dame un ğŸ’–
Rahul Chougule	1
Destiny here	Anyone th 10 like thoko
D Trendsetter Gaming	I m gon na love this update
SmartPhone Tech	late
Adreancali	1
Wackobob	Yooo
TECHNICAL SWORD	Sumit 007 ka ma chodo
Devil's Lab	Gem intonation decreased is very good in update a it took Gems
Ù…Ø³Ù„Ø³Ù„Ø§Øª ØªØ±ÙƒÙŠÙ‡	Ù…ÙŠÙ† Ø¹Ø±Ø¨ÙŠ Ù„Ø§ÙŠÙƒ
Vijay Ghoderao	15th
Layva	15
Basim Sahli	Ø©
Titas Bendzius	Early
Indro Don	1st
Julti	Lol
Ø§Ø¨Ùˆ Ù…Ø­Ù…Ø¯ ÙØ­Ø§Ù…	ğŸ˜—ğŸ˜—ğŸ˜ğŸ˜ğŸ˜ğŸ˜ğŸ˜
ã€†MrKutu	COOL
Berkay Bilir	Vay anasÄ±nÄ± gÃ¼zel gÃ¼ncelleme
Ğ”Ğ° Ğ¤Ğ°	1
ÙŠÙˆÙ…ÙŠØ§Øª Ø­Ø³Ù† Ø§Ù„Ø¹Ø±Ø§Ù‚ÙŠ	fntastk
The kadak chora	Nice
sajal dhiman	When update is coming
Unises Agaton	Nice one I hope wall are more expensive ğŸ˜âœŒï¸
Talisman YT	Hey thatÂ´pretty good
Aayush Khadka	second
Thomas BarbÃ©	First
