Happy Power	DUDE TOMORROW IS GOING TO BE MASSIVE StayHappy
just a random person	How did i get the notification just now What the hell
N3ON	Tomorrow will be awesome like your channel ğŸ˜€ StayHappy
TrickZ Blaze	Yes please destroy tilted
Dr.Ew	Dang this video sent to my notification 2 day later and I thought something wa going to happen again
Ka3le	Clickbait your tiltle say tilted gone but is it gone nope new ali a
Huzaifa Khan	UPDATE Tilted ain t gone Epic Games trolled the whole community once again
lll_GO2SL33P_lll	Straight to the point a alwaysğŸ’™
MG Aztik	Actually what s gon na happen is that Readmore
Xotiic	Yep ghoul and the scythe didnt come out fuck man
Unknown Player183	Scythe
Thanos Boi	Happy i think rip tilted mean the building being destroyed by the cube because donald mustard put that tweet before the cube got to tilted
HypeMello	People talking about the visitor burt why doesn t any one talk about the enforcer
TSMeZaFãƒ„	You contradict yourself so much
FoxTrident RANDOMNESS	E
prxzo	I don â€™ t think this update will be the biggest update season two brought like 20 point of interest many gun and heals graphic everything so please stop exaggerating the update it will be a decent sized update not a huge one
Emr3Be4st Fortnite	Nothing happended
Mladen Ä†uriÄ‡	FINALLY TILTED IS GONE
TDG Blue	Good Video extremely excited for tomorrow
Anthony Marlow	Tilted won t be removed tomorrow we still have the dance on top of a clock tower challenge so if it s gone the people who havent done it won t be able to
IKing Grizzly	Tilted is not going to be gone
A Dog	Have you ever thought of the word bikini bottom and sandy cheek
i dont know a good name there was no good name	every time there is an event u say TILTED IS GON NA BE DESTROYED TOMORROW NOT CLICKBAIT
Kraken	Why tilted won â€™ t be destroyed tomorrow we have challenge in tilted if they destroy it all then people who don â€™ t have the challenge done then they won â€™ t be able to and epic won â€™ t do that
Gaming Express 2018	Everyone say that tilted will get destroyed in every season
Fortnite Craig	3 09 To be continued
JakeyGaming	Lmao who are you to judge who ha bad grammar
VÃ˜Å‚Ä	LaST nUmğŸ…±R iS wHer yU HAve tO gO NExT gamE 1 moisty mire 2 WalmArT 3 tiLTde ToWErS 1 111 4 oFf ThE mAP 5 niNJaS StreeM 6 ToMAToE pLAce 7 LObğŸ…±y 8 Anrchie Acer 8 9 10 NorTh KkkorEa
SGT SEPTIC 10 gaming	happypower tilted is staying they just release the dance on a clock tower mission a one of the weekly challenge
Cant change my name until 90 days	Is that a new visitor face
Jorge Resendiz	IDGAF ABOU TITLED BEING DESTROYED BC BROKE AS DEFAULTS LAND THERE AND PRAY FOR A MINIGUN CAUSE SPAM IS ALL THEY KNOW TO DO
RiskyFrisk	Why the heck is this for a Halloween event
PuR3 Geneticboard9	Boi tilted aint gon na be gone lot of people go there so if it get remove no one will play
bob	Like if happy power is gay
Amaris Garcia	who else think ghoul trooper is gon na be released in the morning like skull trooper and ranger
Joggjnb Fhhvhh	You can hear â€œ zero oscillator on â€ Coming from the portal
Gipsar	Now that they might actually remove tilted I don â€™ t want them to
tannia martinez	The tweet of rip tilted wa litteraly released at Sept 6 so what if the portal will bring something out on 6
Wolfie is the best Prime	
Young Dame The Sauce god	Idc about no cube made of lean add double shotty
BlooodSlayer145.	Tilted being destroyed never heard that before
Joe Ortiz	Rip tilted
Raging Gamer	Soooooo hypeddddd
Menames M cameraman	pretty much
Churro	Season 3 is linked with the visitor
Zai TBA/TES	Visitor is from Dark Dimension Then he wa commanding the Cube to destroy the Fornite He camr back and maybe he will destroy our game My theory sometimes right IDK fornitemares visitorishere thecubeisvisitor forniteseason6
Saint Crush	I need to subâ€¦â€¦â€¦
Football Beast	I am so hyped ğŸ˜ğŸ˜ğŸ˜ğŸ˜ğŸ˜ğŸ˜ğŸ˜
Bubba0924	The portal just started making weird noise try putting the sound in a spetrogram StayHappy
xd Kai	what about mobile r we getting 60 fps
Niko O	What if br and stw cross over in the portal and bring husk for fortnitemares
Twitch. TheRazin	Notice me people scrolling through the comment pweaseee
Tre Keys	Rip nickmercs
Anonymous Dude	Im still wondering who dafuq is Ragnarok like he never even make an appearance in the loading screen
CLASHwithIMMORTAL - Clash Royale and More	SAVE THE WORLD CROSSOVER HOLY SHIT
Arinion	Who else started cry when it said rip titled
EasyMoney1500 TM	I made a clan anyone can join go to the video comment and tell me
S8	The rip tilted tweet wa from the beginning from September lmfao this ain â€™ t a leakğŸ˜‚ğŸ˜‚
Got Em With The Ligma	HAPPY WHY ARE YOU NOT ON THE SUPPORT A CREATOR LIST I WANT TO SUPPORT YOU
xd Adrian	What If the thing above Loot Lake open and the visitor come back and destroys Tilted Towers During the rocket event the rift saved tilted but now there s probably nothing that can save it
ATTY	who else dont give a fk bout fortnitemares and just want the reaper axe
Fire Cream	Thomp heheheh WAAAHHHH
R4nd0m P3rs0n	Be ready for epic to add a 10 GB update and then in a couple hour another 5 GB update to fix something smh
suicidarce	cube bringing zombie
King_Renger 03	cube gon na be thanos
AdamHD	IM SO HAPPY
Hawaiian Porkchop	Happy Tilted is getting removed Me The whole map is getting removed
Patrik 494	Is ghoul troper coming back Pls budy tell me answer thanks
SeaBass	I won â€™ t be surprised if your wrong again
DobbyNick	Tilteds not going bc the challenge is to dance on the clocktower
Thicc Ass Pony	Yo my dad is coming back jeez that rift took himğŸ¤£ğŸ˜­
Jared49er	Yo happy when you look the portal it make the visitor noise from the rocket launch
Ultra Gaming	i want to point out when you skydive in the beam it make the visitor voice file play
expert_calibre	I have no money
cooldude 305	Stw is going to be free in 2019 ğŸ˜­ look on the fortnite channel
Jacob Vassallo	Now I see why you were showing the rocket launch all the time and did anyone notice when you glide towards the floating island it make sound similar to the sound the rocket made in a part of the rocket launch
1,000 subscribers with Two videos	I bet every single event ever ha lead up to this just to re introduce fortnite mare
1 sub With no video?	There s zombie in save the world right don t have it so not sure people have been going on about a crossover between stw and br which could also apply with fortnitemares because zombie and Halloween
Rion Robinson	Anybody else gon na talk about the pic of visitor doing wakanda forever
BringOutThebold Boi	Liking all the comment I can find
SMER TIS	It better be the OG bckround
Brandon Soto	If titled isnt gone tomorrow I m reporting for clickbait and unsubbing All your recent video have either been wrong or click bait I m getting sick of it
Keon Edwards	STW Crossover
Decendants G4ming	â€œ Tmrww will be the biggest update in Fortnite history â€ 1 month later â€œ Jesus Christ this is the biggest update ever â€ ğŸ˜‚ğŸ’¯
What Up	I have a inference what if all platform have something to do with this just a thought
Mexicano Beans	Tilted is never going to be destroyed It â€™ s just a bunch of leak They have been tricking u since season 3 Why would we actually believe it now
KingJF85	I m acc hyped
hi shape sup	YESSASSSSSS ASA ASAA
nootaN	I want more water in fortnite just my opinion
eduardiitohh. x	Love ur channle keep it up bro
Uganda Knuckles	YES TILTED IS GETTING REMOVED WOO WOOOO WOOOOOO WOOOOO WOOOO WOOOOOOO WOOOO WOOOOO WOOOOO FINALLY ITS HAPPENING WOOOOOO WOOOO WOOO WOO WOOO WOOO WOOOO
BreexyYT-	With the power of PHILL SWIFT the POWER of FLEX TAPE come upon u to PROTEC TILTED TOWERS
6969 subs with no videos channel	I really don t care
1000 subscribers with no videos	Welp rip I got band practice until 3 30 ğŸ™„ğŸ˜­ğŸ˜‚
C J	Ofc there is a chance that tilted will get destroyed coz the blockbuster skin is tryin to destroy tilted back in s4
Allop Kopin	Can you make longer vids and do you have the shop thing
Holden Willett	No offense but u r kind of booty at fortnite
Hardcore Henry	WHAT U MEAN TILTED GOING BYE BYE FIRST DUSTY GO BYE BYE NOW TILTED GOING BYE BYE
Derek Hammer	gifting
Kermit Is sad	I bet the rocket come back and destroys tilted because it wa trying to destroy tilted
David Matrai	Why doe everyone think Tilted is destroyed when it never ever happens
ItsNotorious	Tomorrow is going to be insane StayHappy
SpRaYzZ 7	I better see that scyth
N5-FIFA	So happy I have the visitor it wa such a grind but it wa worth since a lot of people didn â€™ t like it they didn â€™ t grind for it which is why it â€™ s a semi rare skin ğŸ˜
Johan Andradd	If fortnite remove tilted rip to their game
Liquid_ JamZ	Old mcdonald and kurnel mustard from the board game clue put them together and BOOM DONALD MUSTARD
Unknown	What s FortniteMares Be specific
kwj jones	Hi remember me
G Dust	Hello guy welcome back to your daily dose of fortnite here in the Happy Power Channel
Finnatix â€”	Happy power He try to not make long video Gets into it quickly But most importantly He doesn â€™ t cliccbait
FMEC NeyJrUTube	Why tomorrow i have a soccer game ffs
PS4BLOWS05	Visitor is awesome
Michael Tisdale	Please don t say Tilted is getting destroyed you have said it too much I promise you it won t happen
Robo Gamer	I think that when the cube doe what ever it doe it will send a blast of energy that half of tilted will be dameged by causing it to become Tumbled Towers Buildings affected Most of trump Noms store Long skiny and tall building Basket ball court Buss stop The L building And that tall building in the top right
NightNinjaGamer	Gifting tomorrow
Marilena Garnica	Oh boi I m just hyped for save the world
JTZombiE	Hey happy power before you start a video put a spoiler because I wanted to see if my theory that visitor coming back to the event But it ok
Blight	Husks in battle royale would be interesting
Roblox	1 like and I will eat my toe
Grey 59	Man I Feel Bad For All The Kids That Have To Go To School I Live In Nevada And Nevada Day Is On Friday So Fuck Yea
IxAMxBERSERK 07	U show the same video of you in paradise palm with magnus every vid and that is from season 5 how is it a recent video that â€™ s overly old
AKP09	This i feel like is killing the fun of Fortnite I thought the story line would be way more interesting not just a Halloween Event Just a thought
hayden	Remember when ninja said â€œ I can â€™ t wait for Halloween â€ on his stream after he came back from fortnite office
Fox Family	Please DESTROY TILTED
Alpha Gaming	If tilted go away there finally is gona be a mid game cuz nowdays the game start and end in the 2nd storm stayhappy
Justin Draws	Season 3 meteor hitting tilted Season 4 Missile going for tilted Season 5 Cube destroying tilted Season 6 trying once more to destroy tilted All of them so far have failed to destroy it It â€™ s definitely fake I believe it â€™ s the old factory â€™ s going
Chinese Symbol	The event isn â€™ t the only thing that â€™ s massive
PHARAOH Fortnite	Tomorrow Epic game this update ha been delayed
Bepis man	Happy Power is clickbaiting with this now the tweet wa about fortnite monopoly good thing you got exposed a breaking TOS by reddit
Skiizzle	when are you gon na notice me I comment so much lmao stayhappy
TCK Lenny â€”	DAB ON THEM TRY HARD HATERS
ShadoStryke â€¢	Hey Happy Power I â€™ m 11 year old I â€™ ve been watching you for 3 month now I love your channel and you too no homo you give no bull crap no clickbait content If you ever wan na play my username on epic is xXShadoStrikeXx
You Got Fxnnesed	Sucks that I won t actually get to see it in game just like the rocket
HiruxWorld	Like someone already said The â€œ Rip Tilted â€ is from when the Cube crushed the buidling so pls stop clickbaiting
CraZe wizzy	If tilted is gone I will give very one here 1 00
Gianfranco Iacono	Definitely pretty much a leaked fortniteMares officially
Tsoukas - Fortnite	Fortnitemares challenge give Ghoul trooper
Pixel Kid	I thought the portal event is gon na happen
Angel cavalie MugÃ±y Vertyyy	Ghoul trooper
GodSpeed K	2 46 silence
m1222theGOAT	Got the noti 3hrs later ğŸ§â˜¹ï¸ stayhappy
RED RANGER1345	Tilted GONE hahahahahahahahahahahahahahahahahahahaha it s not
COLBY XU	Who else saw â€œ Tilted GONE â€ and clicked the video
Benji	I don â€™ t even have my fucking ps4 anymore rip in chat for me
Faaiz AliTV	That wa some pointless info man The â€œ rip tilted â€ wa from September 6th where the cube wa destroying that building in tilted
Nate Jewer	I don â€™ t want tilted to go like if you agree
GalaxyRealmz 728	Here â€™ s My Poem Portals Open Thrusters Fly Lines In The Sky Fill Our Eyes Again
Sophie	If they don â€™ t add fly explosive or sniper shootout I hope they die slowly stupid c u n t ss
MADDJROCKS Gaming	September 6th is when the cube ran through the building
Awesome Quesadilla	With the monster part save the world free Am I wrong
Flxsh	can t wait
Thanos eat ur pp	Bet they â€™ re gon na troll u and slowly destroy every other place except tilted
Eddy Romero	After 4 00 tommorw in the morning I can play right when down time end right
Chronically Sun	The visitor ha been waiting
therealfish 209	I think this might lead to battle Royal and save the world cross over
FeAr_OpA	Why doe everyone want to hert tilted
zxinks	September 6 2018 the tweet is old
Teh Official420	Xbox player you ready to not be able to play for the whole day
Danny Mastar	1 Builds new building in tilted 2 Cube destroys it 3 Demolish the rest 4 Tilted removed
RPGamer 12	I know that im getting allot of hate bcuz of this comment but my gf killed herself last night and i cant get over it and when i watch you i can erace it out of my mind for a while STAYHAPPY
Adan Sanchez	Titled can â€™ t be removed because there â€™ s challenge for tilted
Insane Playz	Not all of tilted can be destroyed a the dance on top of a clock tower ha to stay
Stefan Grujicic	pointless video bro
Mcmustache	What I hope they do is give every skin a Halloween costume including default so everyone pay and no pay can participate in the event other than just challenge stayhappy
FloodZero	Visitor might come to the item shop
DaniPunta 04	Nice vid
FearlessJam	New starter pack
Jaxon Mccarthy	Mabey the save the world will be free too
Sir Pogiãƒ„	I heard some really weird sound coming out of the perma rift ğŸ™„ğŸ™„
am defaulty boi	3 04 extremely amazing More like SUPERCALIFRAGILISTUCEXPIALIDOCIOUS
420 IQ	who s most excited about revolver coming back
2k Gold	Your gameplay is fucking dog shit
CRITICAL	So to those who say scythe isn â€™ t coming back cause it say â€œ limited edition â€ in it description are totally wrong The word limited edition mean that it can come back a certain time of the year for example halloween Fortnitemares so it came out last year if it come back this year then we all know that it mean the Christmas skin are coming
DarthLocke 456	When I need vbucks my god bruh in unlucky
James Russo	They wouldn â€™ t remove tilted
1000 subs with no vids challenge	YESSSSSSSSS OMG
Justin Petsinis	Woke up today on my Birthday and I have 2 kidney stone Fun time also great video thank you for posting
xxxtentacion forever	Clickbait got happy power
Rv3c	Maybe they will fix shotgun that would be huge
CowTipper 29	Season 3 in February leading all to season 6 in October We all have to show Fortnite a lot of love and respect for they â€™ re dedication and effort to do something awesome
M-Pulsive Gaming	Cant help but click on your video bro All the info is straight forward Thank you
Dr. Coffee_	Best youtuber for Fortnite info
Omegawolf Beast	My boy visitor is gon na destroy some stuff woo
Bad Gaming	Thanos Tower
PartyGamer 23	I think we â€™ re going back in time when tilted wasn â€™ t in the game yet
Amanda	It â€™ s the end of all day it â€™ s the end of it all it â€™ s the end of the world it â€™ s the end of my wallet
itzyaboijeff602	visitor better fix what he started
Andrew Cahill	Wouldn t it be funny if everywhere on the Fortnite map EXCEPT Tilted Towers get destroyed
Gabriel Santiago	I will be 2 hour late for the event because that â€™ s when I wake up
Pixel	Haha you â€™ ve made a conspiracy about tiled every season since season 3 and nothing happens Just please consider other thing
MxD Pie	No hate but you ve said BIGGEST UPDATE YET Like 5 time
MarveledStar21 MarveledStar21	I don t think Tilted would get removed The community would be outraged You see every streamer going to Tilted
*dabs*	Take a shot every time he say â€œ tomorrow â€ â€œ event â€ or â€œ today â€
Jake The adidas king	Are we going to get trolled AGAIN of tilted getting destroyed
im a minority	Titled tower is being replaced by bilted bower
Michu	Eyy happy this update is going to be nice and im hyped there is probably going to be some nice skin but i dont have v buck rip and yeah a always i dont have v buck but i still stayhappy and tommorow is the day i would want to play with u happy but idk how i mean im not that active on discord idk bit byeee
Zack Attack	StayHappy
Stephen Riggle	I â€™ m just confused a to why this is literally in the middle of the week
Blitz	Oh no ğŸ¤¦â€â™‚ï¸ I â€™ m late again
ZaPa Velocity	Aw the event is happening tomorrow I ran home for nothing
nicholas Tanner	3 4 5 6
NK Skits	Can I support you a a creator
Andrew	TILTED WILL NOT BE DESTROYED AND I HAVE PROOF It s a battle pas challenge to land on the clock tower so they will not remove it until at least season 7
Tomato Solider	1 42 that is a concept art from Reddit if we enable two factor authentication we should get that kind of face visor decor for the visitor skin
Dinesh Sookraj	Nice
Skull kid for smash Aka Blank	I m a simple man If I see The Visitor I click
HunterC16 [ â€¢â€¢]	Guys the starry flight glider in the shop right now ha a picture of tilted with a bunch of portal over it could that be the event tomorrow
Yeet	Scythe
Destroyer Troll	I I w I wa I wa I wa b I wa bo I wa bor I wa bore I wa bored I wa bored s I wa bored so I wa bored so I I wa bored so I d I wa bored so I di I wa bored so I did I wa bored so I did t I wa bored so I did th I wa bored so I did thi I wa bored so I did this I wa bored so I did thi I wa bored so I did th I wa bored so I did t I wa bored so I did I wa bored so I di I wa bored so I d I wa bored so I I wa bored so I wa bored s I wa bored I wa bore I wa bor I wa bo I wa b I wa I wa I w I
HeyMyName Is Space	PRAYFORTILTED
George papapetrou	I will sleep with a smile Wich is unusual because of school I mean what
jackabob 365	Is it RIP or rip maybe tilted will spit in half
Anthony-Adogs Army	Number of time he s said this is the biggest update in his lifetime 50
Shaan HQ	never get a heat and unnoticed
NerdyDirector	The visitor created part of season 4 5 6 and all of this is just a HALLOWEEN EVENT WHAT StayHappy
EnglandIsMyCity	Well if you didn t see the post RIP titled is from 6th September and we re at 23 October not that is some REEEEAAAALLL misleading information
ChelseaFan454	Tilted isn â€™ t going anywhere lmfao fucking headass clickbait
BrandonDaGamer YT	R I P Tilted Towers
emma imbrey	New visitor style skin
ProdigyistheGOAT	Ice cube is a miracle yall spit saliva and i spit lava
FatalPlayzYT	HYPE StayHappy
Caiden Day	Thanks to Happy Power We are all caught up on anything going to Happen StayHappy
LunaLink	Pretty much particular insane massive
z0h3q	I am always happy when i see your Intro stayhappy
Masked Dog	1 02 he spelled been correctly you dumb fuck
Saint Savage	I saw a tweet from fortnite that said that double pump is coming back but fortnite deleted the tweet
Tuguar	I think the main event is today remember today it ha been 2 day since the portal ha been forming it even say it in the file in event it s labelled ROCKET PERMARIFT and it say it s happening at 9PM BST today
Jake Shaw	Epic is always trolling u about tilted being destroyed
David Gonzalez	1 like 1 protection for titled tower
CompareGaming	Fortnite tomorrow â€™ s update
Zer0 Bl4aze	Tommorow a book close And another one begin
Joseph Figueroa	At least this isnt a today event video oh wait it a tomorrow event
Mace HarvilÅ‚	Maybe instead of tilted tower going away it â€™ ll be renamed and redesigned to something that I came up with like â€œ Candy Castle â€ or something like that
Rhys Rhys	StayHappy all day long
Gemini	This shit is going to be disappointing
Huzafa Mughees	Just asking that shall i buy new halloween skin coming for tomm update or wait for fire work team leader to come back bcz im wanting her for long timr
Francesco Merlino	Ok now this is epic
Carlos PolÃ³nia	Visitor is doing wakanda forever
Rookie Gamenator	Tilted can not be destroyed in Fortnite because there are weekly challenge for the battlepass that need you to go to tilted tower
Dat Scary Boi	Husks maybe Save the World crossover Save the World free
Red X	Watch the visitor or something related to the visitor come in the shop
ğğšğ­ğğ¨ğ ğğ®ğ¤ğ	It s gon na be great Let s go StayHappy
mell0	ğŸŒ‘ğŸŒ‘ğŸŒ‘ğŸŒ‘ğŸŒ‘ğŸŒ‘ğŸŒ‘ğŸŒ‘ğŸŒ‘ğŸŒ‘ ğŸŒ‘ğŸŒ“ğŸŒ•ğŸŒ—ğŸŒ‘ğŸŒ‘ğŸŒ“ğŸŒ•ğŸŒ—ğŸŒ‘ ğŸŒ‘ğŸŒ“ğŸŒ•ğŸŒ—ğŸŒ‘ğŸŒ‘ğŸŒ“ğŸŒ•ğŸŒ—ğŸŒ‘ ğŸŒ‘ğŸŒ“ğŸŒ•ğŸŒ—ğŸŒ‘ğŸŒ‘ğŸŒ“ğŸŒ•ğŸŒ—ğŸŒ‘ ğŸŒ‘ğŸŒ“ğŸŒ•ğŸŒ—ğŸŒ‘ğŸŒ‘ğŸŒ“ğŸŒ•ğŸŒ—ğŸŒ‘ ğŸŒ‘ğŸŒ“ğŸŒ•ğŸŒ•ğŸŒ•ğŸŒ•ğŸŒ•ğŸŒ•ğŸŒ—ğŸŒ‘ ğŸŒ‘ğŸŒ“ğŸŒ•ğŸŒ•ğŸŒ•ğŸŒ•ğŸŒ•ğŸŒ•ğŸŒ—ğŸŒ‘ ğŸŒ‘ğŸŒ“ğŸŒ•ğŸŒ—ğŸŒ‘ğŸŒ‘ğŸŒ“ğŸŒ•ğŸŒ—ğŸŒ‘ ğŸŒ‘ğŸŒ“ğŸŒ•ğŸŒ—ğŸŒ‘ğŸŒ‘ğŸŒ“ğŸŒ•ğŸŒ—ğŸŒ‘ ğŸŒ‘ğŸŒ“ğŸŒ•ğŸŒ—ğŸŒ‘ğŸŒ‘ğŸŒ“ğŸŒ•ğŸŒ—ğŸŒ‘ ğŸŒ‘ğŸŒ“ğŸŒ•ğŸŒ—ğŸŒ‘ğŸŒ‘ğŸŒ“ğŸŒ•ğŸŒ—ğŸŒ‘ ğŸŒ‘ğŸŒ‘ğŸŒ‘ğŸŒ‘ğŸŒ‘ğŸŒ‘ğŸŒ‘ğŸŒ‘ğŸŒ‘ğŸŒ‘ ğŸŒ‘ğŸŒ‘ğŸŒ‘ğŸŒ‘ğŸŒ‘ğŸŒ‘ğŸŒ‘ğŸŒ‘ğŸŒ‘ğŸŒ‘ ğŸŒ‘ğŸŒ‘ğŸŒ“ğŸŒ•ğŸŒ•ğŸŒ•ğŸŒ•ğŸŒ•ğŸŒ—ğŸŒ‘ ğŸŒ‘ğŸŒ‘ğŸŒ“ğŸŒ•ğŸŒ•ğŸŒ•ğŸŒ•ğŸŒ•ğŸŒ—ğŸŒ‘ ğŸŒ‘ğŸŒ‘ğŸŒ‘ğŸŒ‘ğŸŒ“ğŸŒ•ğŸŒ—ğŸŒ‘ğŸŒ‘ğŸŒ‘ ğŸŒ‘ğŸŒ‘ğŸŒ‘ğŸŒ‘ğŸŒ“ğŸŒ•ğŸŒ—ğŸŒ‘ğŸŒ‘ğŸŒ‘ ğŸŒ‘ğŸŒ‘ğŸŒ‘ğŸŒ‘ğŸŒ“ğŸŒ•ğŸŒ—ğŸŒ‘ğŸŒ‘ğŸŒ‘ ğŸŒ‘ğŸŒ‘ğŸŒ‘ğŸŒ‘ğŸŒ“ğŸŒ•ğŸŒ—ğŸŒ‘ğŸŒ‘ğŸŒ‘ ğŸŒ‘ğŸŒ‘ğŸŒ‘ğŸŒ‘ğŸŒ“ğŸŒ•ğŸŒ—ğŸŒ‘ğŸŒ‘ğŸŒ‘ ğŸŒ‘ğŸŒ‘ğŸŒ‘ğŸŒ‘ğŸŒ“ğŸŒ•ğŸŒ—ğŸŒ‘ğŸŒ‘ğŸŒ‘ ğŸŒ‘ğŸŒ‘ğŸŒ“ğŸŒ•ğŸŒ•ğŸŒ•ğŸŒ•ğŸŒ•ğŸŒ—ğŸŒ‘ ğŸŒ‘ğŸŒ‘ğŸŒ“ğŸŒ•ğŸŒ•ğŸŒ•ğŸŒ•ğŸŒ•ğŸŒ—ğŸŒ‘ ğŸŒ‘ğŸŒ‘ğŸŒ‘ğŸŒ‘ğŸŒ‘ğŸŒ‘ğŸŒ‘ğŸŒ‘ğŸŒ‘ğŸŒ‘ ğŸŒ‘ğŸŒ‘ğŸŒ‘ğŸŒ‘ğŸŒ‘ğŸŒ‘ğŸŒ‘ğŸŒ‘ğŸŒ‘ğŸŒ‘ ğŸŒ‘ğŸŒ‘ğŸŒ•ğŸŒ‘ğŸŒ‘ğŸŒ‘ğŸŒ‘ğŸŒ•ğŸŒ‘ğŸŒ‘ ğŸŒ‘ğŸŒ‘ğŸŒ•ğŸŒ‘ğŸŒ‘ğŸŒ‘ğŸŒ‘ğŸŒ•ğŸŒ‘ğŸŒ‘ ğŸŒ‘ğŸŒ‘ğŸŒ•ğŸŒ‘ğŸŒ‘ğŸŒ‘ğŸŒ‘ğŸŒ•ğŸŒ‘ğŸŒ‘ ğŸŒ‘ğŸŒ‘ğŸŒ•ğŸŒ‘ğŸŒ‘ğŸŒ‘ğŸŒ‘ğŸŒ•ğŸŒ‘ğŸŒ‘ ğŸŒ‘ğŸŒ‘ğŸŒ‘ğŸŒ‘ğŸŒ‘ğŸŒ‘ğŸŒ‘ğŸŒ‘ğŸŒ‘ğŸŒ‘ ğŸŒ‘ğŸŒ•ğŸŒ‘ğŸŒ‘ğŸŒ‘ğŸŒ‘ğŸŒ‘ğŸŒ‘ğŸŒ•ğŸŒ‘ ğŸŒ‘ğŸŒ‘ğŸŒ•ğŸŒ‘ğŸŒ‘ğŸŒ‘ğŸŒ‘ğŸŒ•ğŸŒ‘ğŸŒ‘ ğŸŒ‘ğŸŒ‘ğŸŒ‘ğŸŒ•ğŸŒ•ğŸŒ•ğŸŒ•ğŸŒ‘ğŸŒ‘ğŸŒ‘ ğŸŒ‘ğŸŒ‘ğŸŒ‘ğŸŒ‘ğŸŒ‘ğŸŒ‘ğŸŒ‘ğŸŒ‘ğŸŒ‘ğŸŒ‘
Pirate Drummer	Hey 3 wa leading to it also Because if the comet
Brady Eaton	Do u get a new visitor face if u do the new 2fa thing
Nello	if smgs are still in the game ill cry
TakoFaik	hype
PioneerHunt24	Fortnitemares trailer where you at
Postboxpat Fan	Stayha stayhappy
James Hanna	Rip I â€™ m 300 v buck away from ghoul
Ariona	Really need to learn to stop repeating your same point over and over again
Lil Beam	U say been like â€˜ ben â€™ not â€˜ bean â€™
Jamie Oshea	i hope husk spawn in on the portal honestly that would be fun or anywhere in the map
Daniel Hernandez	Sorry if I m late I had school
Joe DePaola	Tomorrow is my birthday
Pavel Krutilek	Will be save the world in sale
Goose	Who else is exited
caspar	Btw the gliding glitch at 1 30 in the video can be fixed by pressing your crouch button mid air CTRL It s caused when you hit a Rift to Go while crouching
vortex simmer	Omg I can t wait
Anthony Chotey	I think that tilted tower tweet wa for when the cube wa in tilted
3Block ko	Darkness arrives Something gon na come out of that portal im thinking save the world zombie
Plixy	Hyped for update ğŸ˜ŠğŸ˜„ğŸ˜ƒğŸ˜† StayHappy
Dudes F'n Up!	I CANT WAIT TILL 2MORROW IM FREAKIN HAVING A SIEZURE FACK OH YEA YOU INTRO SONG IS SICK WHO DOES IT A LINK PEACE
derpy thederp	I love tilted NOOOOOOO
xsw2703	I wanted the island to possibly fill the divot up a little bit I absolutely despise that place
Saints Fan	Fuck I hope tilted isnt removed
LioTheLion 001[Xtra]	New map please
Julien Kulcsar	GHOUL BETTER COME OUT
Mr. xarismak21	Your video are insane mannn I love them and i watch every single one but a you said in the previous vids your mic is dying StayHappy
Donald Doink	Tilted is going no where It â€™ s the MOST iconic spot on the map They won â€™ t change it at least for a few season if ever
ariana arriaga	bruh all the do is add shit to the sky and make hole in the ground
3DWaffle	Oh MA god i an so lucky My autumnholiday in School start tomorrow ğŸ‘
iEXPLOZIV	Why is the Visitor Making a X with his hand
Darkened Shadow	it gon na stay because of the challenge dance on top of a watch towtrr
Burrito Master	IM SOOO HYPED
Ben Evans	Biggest update ever were u not there for the tilted update
A fucking faggot	Dude yes I wan na see the visitor return and end his storyline
What's in the Egg?	Maybe the rocket will come back and finally hit tilted tower
DanielPlayz__ Jamjoom	why are you talking about the visitor the visitor wa since season 4 and now we are on season 6 the visitor is dead
mesiroy1234	You make me to stayhppy
SkellyViper	Also when the rocket launch first happened the voice said something like coordinate set and the rocket first opened the rift portal in tilted Maybe the visitor planned the cube doing this to tilted from the start
J Thomas	TiLTeD gOnE fuck off ğŸ˜‚
KingCreeper75	hyyype 1 1
spooky boi	Ur the best yt channel u my fav idc about heart I m just saying
AntBee TheKing	How are u so good with vids StayHappy
Con the man	Thx for not being a crappy clickbaiter
Verdantglobe	I like the idea of having many thing happening but not all at once I want them to spam the event out
ayy snipezzz	Wow in the community post I seen Ghoul Trooper Rerelease where in the vid did you talk about it
LTN Shayaan19	Holy jeper wakz stayhappy
1222 1222	2 20 porno sky whoa StayHappy
Tyrese Soares	Man Happy always Says Tomorrow is Gon na Be The BIGGEST update Then when The update hit It s Only Like 1gb And Im like BRUH
rust lord gameplays	haunter tower 3
Yo hairline Sucks	An update hasn â€™ t been this big since titled wa created a well a the other place
2 Quix	If they realese the ghoul trooper too I hope the OG version look good they already ruined my skull trooper they better not ruin my ghoul trooper
5tann	what videosettings
YSG glitch	If hey don â€™ t bring fuking double pump or pump tac ima be pissed
TooningPanda ,Gaming	I don t think anyone ha thought about this but remember when the rocket wa Going down to tilted and got sucked in by a rift What if the rocket wa Trying to hit tilted Hear me out In season 5 on that loading screen when the enforcer wa at motel with the rift he might be able to control rift therefore that s probably why the rocket kept on going around the map in rift because the enforcer wa stopping the rocket This next rocket launch if there is one Could be the visitor second attempt with the cube to help him
LLJ	Fav YouTuber like if u agree
MurF.	So basically Theyre killing their game
Jacob Lembrecht	It s not just season 4 it s also the meteor from season 3
-KrooKed -	Tilted always win hopefully
Denver DD	No way tilted get destroyed
Monkey gamer6	Down with tilted
Clash Gaming	Hello happy power is there a way I can contact you or send you something there â€™ s something you might wan na see
Mr J	Corrupted Tilted Towers What if all the name place become a corrupted place like the corrupted area with that Halloween theme still
Katan ix	I hope it ha an actual story if it â€™ s all been leading up to a Halloween event â€œ highly doubt it â€ I â€™ m going to be majorly disapointed
Peggs GT	IF they are gona remove tilted YOU KNOW THAT YOU JUST GONA DELETE THE GAME
AceCapXl	This ha to be the best channel on YouTube for fortnite
*sniff*	Whos donald mustard please let me know
Epic Darius	Wait tilted is my favourite locationğŸ˜­ğŸ˜­ğŸ˜­ğŸ˜­ğŸ˜­ğŸ˜­ğŸ˜­This cant happen RIP TILTED
Brucci Wayne Music	You say massive update for almost every update
Sliiifer, The Sky Dragon!	Hey Happy I really hope you see this but I have a theory As of now there Is portal appearing in sky which I think the cube is going to go through here s how I think it s gon na go down If you look at the floating island upside down it look like a volcano hence the reason volcano and stuff were found in the file I think the island is going to flip upside down and the cube is going to detach and go through the portal and with out the cube to help it float the island will fall back down to it original spot but this time upside down and it s going to be a volcano
Helen	Good intro watch a video on my channel if you want a free music to add sound to your video
Lil uzi Verticusss	What time
AdeptuM	STOP FUCKING SAYING TILTED IS GOING TO BE GONE THERE IS STILL CHALLENGES THERE SO FUCKOFF A POI WILL NEVER GO AWAY MID SEASON
GeorgieGaming	I m getting so exited for this event thanks for the info Happy Power
Adan Elahi	Roman reign have cancerğŸ˜¢
PandaOriginals	lol
dfgjkdbfk	penis hoe
meme boi	Watch how the new item get disabled due to a bug
Hi Im Ustion	Watch everything come back
Gamezales YT	It â€™ s like the Star Wars Trilogy
Shayan Suhail	Am I eraly
Jhon wick F	REST IN PASTA Tiltes tower ğŸ˜¢ğŸ˜¢
DBZSpice	Will the pumpkin launcher be permanent or hit for this event
Smugles	Dab
Specter 22	HEY StayHappy
Cyanide	N O T T I L T E D
Holy Cucumber	If tilted is gone that will literally be a game changer No longer will the first circle finish and only 30 people remaining
Kaslanov	Someone please help my solo squad 26 kill game get 10 like Please no one notice meğŸ˜•
Sledheads Wifey	Fuckkkkkk
Duddy PA	Yo happy wassup StayHappy
SoMexican	CAN WE ALL MAKE A VIDEO AND ASSUME SHIT
Sam Gates	This is awesome thanks for the news
Humberto Reza	They finna pull some pet cemetery type shit and make character come back to life with the ray
JHD Gaming	Your channel is growing so fast I wa here since 120k sub
MazenTheBestGaming	I have been subbed for a few month now once I saw the description now I saw slap that subscribe button because I wa subbed I SLAPPED the bell instead ğŸ˜‚
George O	I â€™ m getting stw tomorrow too
Strongster32	Its a shame I wont be there my flight is today
Leo Kilb	Has anyone see the volcano on the visitor arm
Prince Gamer	Happy wat is ir sensitivity on pc
10000 Subscriber With One video	Not Tilted plz
VeryAngryBird	STOP FUCKING SAYING TILTED IS BEING DESTROYED LMAO
Blazing KingGETC	Bet titled won â€™ t disappear lol
devilgamer 72	What time is downtime in Pacific
Just your average toaster	So is there an event today at 4pm est
Daegos	More Clickbait I talk fortnite wa right about you
Liam Crawley	Hi
Jef Van Den Bergh	Make video over all you know off the christmas skin coming back
Miguel Daniel	Bad thing we will have to wait like 6hours to update game
winnie the buff	When ever people hype thing up it is always disappointing
MrOhDocS	Will there be a Halloween starter pack
420StrIkEz	3 10 to be continued
Gaming Master	waiting for Ali a s video
Alexio Abrahams	Your the bomb happy I always watch your vids to keep up with fortnite news keep it coming and always remember stay happy ğŸ˜‹ğŸ¤¯ğŸ‡¿ğŸ‡¦
Zach F	This is all so annoying too much waiting
Bromate	Not sure if this is true but if you look at the starry flight glider in store today in the picture there is a clock tower and a portal a bit like titled and be portal
DESTROYER OF FACTS	Your 1 source for dailly fortnite entertainment
Andrew Madrid	Is ghoul trooper coming back
Zeltuxx 27	When is the event
Nugget	How many time do we have to tell people that tilted is going nowhere
VenomousShack 53	Which nationality are u 0 Russian 1 Australian 2 Chinese 3 North Korean 4 German 5 Canadian 6 Emirati 7 English 8 American 9 Nigerian
Enigma AtTheDoor	Hey happy do you know what time this event will be taking place at if it s a real time event stayhappy
CorgiKing	Well at least I got my final victory at tilted if it s removed
James Davis	Good bye tilted jk I know you still gon na be there ğŸ‘€
RobertSkuli	Can t wait So excited to see the pumpkin launcher D StayHappy
BL4CK N!GHT	Great vid U shud make them alittle bit taller
alfatrol 345	I wa 778 like lol i ruind it 777
Ghashto Dersa	Can t wait for Darkness to finally rise FAN ART Jk
GodRicky	Look at teir 80 of the battlepass I feel like it going to be a skin for fortnitemares 2 18 the tweet match the spray
MC THEGOAT	What is fortnite mare
Gyleeno The Gamer	You are clickbating the title a bit Th title say Tilted Gone while it isn t same with a coule other vids and stop hacking in the game it is against the term of service
Night Beast	All of this happend just because of a regular meteor
Mix-D	Honestly Going To Love Tomorrows Update StayHappy EDIT wait if all of these season have been leading to fortnitemares doe that mean we are moving past the 1st era of Fortnite Kinda sad if so
Potato Cat	How many GB in ps4
Â¡Hugo! - Me gusta la mÃºsica	OK HAPPY SERIOUSLY STOP SAYING AN UPDATE IS MASSIVE PLEASE
AnAutisticCat	BEGONE TILTED SWEATS
Zapped Tyrant	Titled Towers can t be removed a it s required for one of the battle pas challenge
Dexter YT	I love you video and you ğŸ‘ğŸ‘ğŸ‘ğŸ‘ğŸ‘
Cactus Billy	Are we just not gon na talk about the enforcer
Frontal Ninja	whatâ€¦ the title Tilted FINALLY
Namez Jackson	How do I support u I LOVE UR CHANNEL StayHappy
Egg	Happy if you go on fortnites Twitter go to their post on the soaring update On the epic game website which is about the soaring update to all game mode THEN LOOK AT THE GIF AND ON TOMATO TEMPLE THERE IS A HUGE DIRT PATCH stayhappy
Srijan sathish	Tilted will not get destroyed a we know all the challenge can be finished even in last day of the season like that if tilted get destroyed how can we finish the challenge dance on top if clockğŸ¤”ğŸ¤”ğŸ¤”ğŸ¤” tower
Maxfilmsthebest	Hey your such a good YouTube hope you have a great day
xX_Necromancer _Xx	Title say Tilted Gone Instantly click
Dante Spenkelink	Is nt there a event today at 4 est
Gold_Guy 369	End of season 3 to season 6 XD the meteor
Raul Andres	All the hype from Season 4 to 6 is just a halloween event thats pretty dissapointing storyline IMO
Priyanshu Maurz	Hype is real I â€™ m fapping
Craigh	Thanks for the info dude
CRAZY MOTHERFUCKING TROLL	Your a really shitty youtuber tbhğŸ‘
Rhinoluncher	stayunhappy
Shaun O'Donnell	Rocket come back trick or treating in retail will be added and tilted destroyed
Bounc3 Jump	If you wa next to the cube your youtube channel would be called Sad Power
fahim Animations	Are the update usually on Wednesday
Miron 1800	Do you think we â€™ ll see the ghoul trooper in the shop tomorrow after the update like how the skull trooper appeared in the item shop after the update like 2 week ago
Lucy Webb	Hi
umSlade	Happy power and comment are spoiling stuff being leaker mean seeing stuff that are coming new and you guy are spoiling it d stayhappy
Potato Chips	What happened to the video posted before this one ğŸ˜­ğŸ˜¢
andria c:	i bet 10 tilted wont be gone tomorrow
thicc boiii	Helloooo
Chris Don West	Tilted ain t going it s just a meme
Pog	So this is it This is the end
Prismatic	HYPE STAYHAPPY WHATWOULDIDOWITHOUTYOU
Kaido Kirsti	Yeees tilted gone i will be so happy if tilted gone if not im going to melt down some kid in tilted
Fortnite Noob	So hyped Probably will take 2 hour for the update to finish
Skullark Ecko	Not hating but Season 3 metero will destory tilted Season 4 rocket will destory tilted Season 5 cube will destory tilted Season 6 island will destory tilted
Hamdan Alhosani	Perfect Timing
Golden Drop Productions	This is my job telling old title Old Tittle Fortnite tommorows massive update StayHappy Also the season 3 comet relates to season 4 to season 5 to season 6
ANGEL MORALES	StayHappy
kbgaming comics	Best fortnite leaker stayhappy
Obunga Obama	Maybe the cube growth is like the story of gotg
KnickM	Short and sweet â€¼ï¸ğŸ’
Ledion Mucha	I dont know with what more to support you I have clicked the bell icon and i give a like for every video love you keep up the great content ğŸ˜ğŸ˜â¤â¤
x_Sh00k_ x	I m tier 91
nodoka wakabayashi	Dude No clickbait life
KAI	So early I got the original title StayHappy
xSnow	Gifting lol that â€™ s a joke lmao There never releasing Gifting
Mr.Retro Kid	Dammit im gon na be at school tomorrow
Doez	Nooooo Tilted
Junel Gapusan	Just want the Reaper pickaxe lmao
YaÄŸÄ±zhan Ä°nal	Who w here before thumbnail changed
Chang'e	Honestly I m tired of my teammate packing up at Tilted Towers instead of any other location I would celebrate if Tilted get removed StayHappy
XXX TeNtAcTiOn	i left a game just to watch this
Lil B	StayHappy
Thomas Campbell	great vid cant wait for the update
Savage_Wolf YT	The event is in 2 hour for me EDIT 5 min left y all
RuN Nightmare	StayHappy
Forgotten Shadow	CAN T WAIT HYPE Stayhappy
Scythe	Nice video StayHappy
OhGrumpy Michael	You are gon na be wrong about tilted
Minionfartgun _fan	You are amazingâ¤ï¸â¤ï¸â¤ï¸ 3
QadeerYT	No clickbait just quick vids to keep u updated that s why WE like him stayhappy my friend
Jani Benjamin	ğŸ™Œ
Wasabi Fox	Quick question Why would they bring the visitor back when it wa apart of the battle pas And no not the battlepass locker it wa for whoever that bought the battle pas in season 4 were able to do the challenge
Xx storm xX	Hypeeeee is real right now thanks happy power ğŸ˜ğŸ‘ğŸ»
Isaac Serrano	I m early for once
CEEFOUR	Best channel ever StayHappy â¤ï¸
Charbel Hayek	HYPEEEEEEEEEEEEE
itz BraZo	What time is the update
Alex Rivera	Stop hyping u up man ğŸ˜•
Saviorrr	Can t wait StayHappy
Linah Vlogs	StayHappy I can not wait for tomorrow
Jorge Hernandez	Dear epic please vault smgs
Piques Cousin	happysquad notificationsquad stayhappy
Rboert Trebor	Imagine if the voyager did something to go back in time and reset the map
BubbleGun 888	Hi
Badgerscool73 Life	Yes ITS FINALLY GONE Hopefully you know how that town annoyed me since i wa playing from the beggining of season 2 HOPEFULLY
Blank McBlankface	First
ZerÃ¸x	HAPPYPOWERTHEBEST
ULTIMATE LeJ3n021	there is still that one challenge that includes tilted though so it will still be here
Destroyer	Finally no tilted
Shane Gonese	LISTEN
Firestic 27	Time to delete more stuff Hahahahahaha
Dudecat	NOOOOOOOOOOOOOOOOOOOOOOOOOOOOOOOOOOOOONOT TILTED ğŸ˜±ğŸ˜±ğŸ˜±ğŸ˜­ğŸ˜­ğŸ˜­ğŸ˜­ğŸ˜­ğŸ˜­ğŸ˜­ğŸ˜­ğŸ˜­ğŸ˜­ğŸ˜­
FlipGURGS	StayHappy
Aaron Greenberg	I m super sick rn and probably staying home again Time to play Fortnightmares tomorrow
Tarik	What Is that quality
Super Pants	R I P Tilted Towers
Dario Arias	I â€™ m in shool watching
edmoister	The â€œ Rip Tilted â€ is from when the Cube crushed the buidling
Cryptic Sniper	Early
Cousin Gaming	Happy power I would put your pyramid V and your inventory Y it â€™ s just some better keybinds if you want to use them a no other keybinds use them
Contortio thy 4th	I wonder if all those people that wanted titled gone will be pleased
xd FinesseMonkey	If they add more of that ugly as blockbuster skin then I â€™ ll quit fortnite
Funids Son	Hi stayhappy
Nidhal Mehfooz	who else like the video before watching because u know that the video is going to be awesome StayHappy
Kareem Wes	This will be great then
ebaccanari	hey happy power do you think ghoul trooper and scythe will come back
Sally Purple	I hope it happens at 4 pm for me tomorrow because I have school
Process of Elimination	No Scythe for noobs
Sunglasses Tricker34	I think the scythe will be upgradble if the ghoul tropper gon na come back
Scotty Mathues	FIRST SKSKS
SgL Adventures	stayhappy hey I would like to help you protect ur content from other using it and not giving u credit I tagged u on a ig post that wa using ur video without giving u credit
Sukhpreet Sarai	Yooo
DV PLAYZ	Whens the cube event going to happen
A cat	Well I guess rip tilted but I guess yeet
Eemil Erola	Whats same about a squirrel and a piano Squirrel start with s
D 4 R K	So early the title wa Fortnite tommorows big update
A3bood 82	Happy power you â€™ re my favâ¤ï¸route YouTuber
ãƒ„Unfunny	This got into my sub box now
XenoidXZ	But the tilted tower tweet wa on 6 September 2018 it wa when the cube entered Tilted and destroyed the Strip Mall
â˜‡â˜‡Fluffy pikachuâ˜‡â˜‡	Can t wait to I love your vids
Elite	No view oof
Corsa Miko	Is tilted really gon na be gone stayhappy
Y0SH1 DesTroyer	Yay
Alex 123452 carroll	Hiii
LegendHunter	Hey Happy What stage is the Rift right now It look very weird StayHappy
tazegamer 05	When the update come the ghoul trooper will more likely be in the shop
dEfAuLtZ g0D	When you clearly dont care about the update but you still watch the vid
T e l l m e w h y I m w a i t I n g 18	Calling it now we â€™ re getting bamboozled also wow I didn â€™ t know that the clicking so fast it wa private thing wa true cu when I clicked it went to a black screen with warning an the title didn â€™ t load
Vader	NOTI SQUAD AGAIN StayHappy
Alfie Morton	Thanks For The Update Love Your Content StayHappy ğŸ”¥ğŸ”¥ğŸ”¥
Archill	rip my money lol
The Snipez	360p never looked so good
Illy Kaly	He keep it short And explains everything That s why we like him stayhappy
AeroDeBoi	I am early let me tell a joke HappyPower is bad at fortnite stayhappy
lone wolf 200868	It would be AWESOME if Happy Power heart my comment
leroyVDãƒ„	360p sqaud
iYrndonj -	Clicked on this so fast
Temp Celular	Let me guess it gon na be delayed
Gelekte Tunes	Love your contenttt
Intense Atom	Best fortnite news guy
Arin_Ross	This might sound crazy but I wa born on my birthday
Crystal	Great vid and cant wait for tommorow stayhappy
Extreme Reviews	1st comment
Atomic Fortnite	i play fortnite i get no dubz im also a youtuber and i get no sub when i play i cant get a kill and i like my own comment because no one will and i will beg untill somebody will
Arez Mangoor	Love ya
Burnt Kebab	Positivity positivity positivity
Kiing	Thanks for the update every day happy We love you StayHappy
Misson:Classified	Ok guy is happy power the best youtuber I vote yes stayhappy
Sara Wilson	Blockbuster in the thumbnail Wakanda Forever
Robert Thurman	stayhappy
White Devil	Hey happy Stay happy
MANSTER	are telted well be go
Exotic Senior	Gifting system is taking to long anyway nice video
Gfcvgffvb Lopo	Why tomorrow why
TSA Addicted	Yay
zrotheking12 100	First boy
fortnite cube	Early stayhappy â¤
UnknownDZN	I remember you from gta 5 and now your here
Chad Adaza	Early stayhappy noonecaresifyourefirst
Xmas_seek â€˜	Happy always early love ur vids man
mohamad zaatari	Hii
Ronin	I can â€™ t wait
Jake Driscoll	It sound like you are daily dose of internet at the beginning no offense stayhappy
Ottobite	heart this if you don t you don t care about me
Johan Matthew Davis	How to start an Internet Fight 1 Write something online in any public app 2 Wait patiently
COZYALYX	it â€™ s about to get spooky StayHappy ğŸƒâ¤ï¸
NotRandomFortnite	Me early
Lazar Beam	Officially 1st to speak
EaZe_kinglelep	Guess what Read more
The Games	Yes
MxC GUNN3R	Not first
Toasty Channel	First like
Aimanop	Sup happy
Dead Pool	RIP tilted
zelix lol	oooooooooooooo
Dark Legend	StayHappy love your vids ğŸ˜
john101isBOSS112	My cockğŸ‘ğŸ‘„ğŸ‘
SSA	Hi it me agen Love you and your Chanel stayhappy
OverTaker #1	Rip tilted
Slankã€½an	Can â€™ t wait
xd Morpp	Tilted noo
Mohammad Alnasif	I love this video
Fortknight	First
EgonYT	I â€™ ll be here every time happy fortnitemares
heroees	Oof
Altan Dag	hey happy power ğŸ˜
Beni	happy yooo
Comxndo	happy is a great content creator ğŸ’™ if anyone see this I hope you achieve your dream The one thing I â€™ ve always wanted to do is be proud of what i have done That â€™ s why I â€™ m trying to become a successful youtuber
laurens van egmond	Happy powerrrrrrrr
rhysupinhere	first
fortnite pro	First i love you re vids
ree despacito	lmao 32 ppl cant be first
Kurtongo Paul	ğŸ”¥
Parrio 72	Love your vids
Mr Mac	I cant wait
Keaton Pascoe	Hello every one if this get 1200 like I will tattoo happy power on my arm
Tamko	1
Guillermo garcia	NO TILTED oof
Oh Meow Meow	It â€™ s not a big a the happy gang though StayHappy
WallBangBanana YT	HOLY SHIEEEEET
Dehydrationz	Here for another amazing video ğŸ–¤ğŸ”¥
Hanone111 Fortnite	First
ISZ_FiZz	Hi happy power love your content StayHappy
Caiden	First one here
BTL_ Zhiyar	Lol it â€™ s private for me cause I clicked it too fast
minecraft master	Let â€™ s go who doesn â€™ t like a good update
Mako	If there â€™ s no Tilted I will quit fortnite yes I â€™ m a tilted sweat
Kiran Byrdsong	7th comment
Churzy	Happy Power Wont Pin This
Jojo Nilsson	First
Zizooo710 tt v	Noti sqaud like if your in the noti sqaud
TheMadhouse69	Hi
Rin	I am happy and I have power
Yeeterson Peeterson	Yay another happy video
Fletcher Bargman	Again
Harry Redsell	First
Cat Guy	Fifth
King  Rillyza	Great video
Bl00dfilled	First like
Mike Nanokeesic	Hi Happy StayHappy
Crystals adopted son tootall	First
lanki	stayhappy
ItzMoose Bruh	First
qx _ALLAN123	Not tilted
Goonertillidie16	Ok
Hayden Workman	Ayyyyy love you happy
Yoshi Dabs	Yes I love your channel XDDDDDD
starwars starwars	1st like
Furious Bro	Hey person scrolling through the commentsğŸ˜™
JuanSolo	FINALLY it hit my subox
Klarisa Cami	1st
CraigBoi 101	Tilted
Baby Sinclair	HappyPower
bLaZe Cxsmos	First the video is private lol
Ivan Caratachea	Big oof big oof
10,000 Subscribers With Two Videos?	WHICH STREAMER ARE YOU 1 STREAMER 342 2 STREAMER 231 3 STREAMER 572 4 STREAMER 629 5 STREAMER 241 6 STREAMER 666 7 STREAMER 134 8 STREAMER 189 9 STREAMER 69 10 STREAMER 423
Coolninja Flop	I don â€™ t know what to comment
BeastMaster64 BeastMaster64	Wow
NRS_GhostPlays	1st
gpranithreddy Reddy	Stayhappy
Gaming Reborn Steve/SR19742011	StayHappy
Leprikon	Whaaaaaaaat
OGC Waves	First
Rayan Adel	Can you heat
Zulache	First
Angel Z	First
Jeppe Dahl	First
Fortnite Gaming XD	Fitst
Riley Taylor	1
omenxiii.	Nice Video My dude
Trash at everything. : God	Let â€™ s go
v3 Tempo	Stay happy
aboodi masoud	first
Landen !	First
kjegod	Ye Boi
Vize DoomZ	First
China Man	Good video
MTsage	Like for scythe
Ali-A	1st
ãƒ„YoLo Lol	Hey
Watnan Bear	First
Pinhead543	It but my box
CloudyCloudz -	OMG
XxMilk_Da_CowxX	1
Not Zhn	private g4ng
10,000 subscribers with two videos challenge!?	What is green and can fly Grass I lied about the flying part
