박기훈내가 진정한 연다 김블루 우뚝 팬	츄츄 아이즈원 츄 파이팅!!!!!♥!♥!♥!♥!♥
kampgruppe pieper	wonyoung. minju visual no joke 😵
설븜[나는야 설븜]	저 아이즈원 살레와 광고 나왔어요!
옌슐린	ㅋ 어이없네 워너원고 한 다면서 지금 안한다고 하면서 아이즈원츄 만든거임? 그리고 왜 대체 아이즈원은 2년 6개월임? 일본인 두 명 밖에 없는뎈ㅋㅋ
Shah Zelyn	Please put eng sub @mnet
Dying for Blackpink	After watching all produce 48 eps until the final I had trouble stanning IZ*ONE after seeing the final line up but I’m thinking about stanning them💗
Prestin from Pladis	Hiichan, take my heart!
Tiên Trần Thị	hate
YTB메테오	난 11시면 자야하는데 ㅠ
샤이닝휘	티저 찍는게 똑같을 줄이야ㅋㅋㄱ
J. Maccari	idk why but wonyoung doesn't look very pretty here... maybe hair color?
`이별	누가 원영이 눈썹 좀 칠해주세요 ...
애니톨Anytalls	I MISS SITAO MIU
Jamantice :3	ESSE TEMPO TODO EU PENSANDO QUE SE PRONUNCIAVA "AIZON", QUANDO NA VERDADE É " AIZ WAN"
Su Jin Lim	채연이 머리색깔 예쁘다^^점프도 제일 높게 뛰었네ㅋㅋㅋ사랑스러운 깃털채연^^~
広瀬すず	日本人どこだああああ
쁘닌[큐티뽀작]	안유진이 최고다  춤.보컬.비주얼 다 최고
알리나카	so eggxited
Valentina González	OMG Youtube is back!!
a떼모야	왜 국가제한을 걸어 놓는거죠...
ˇ얜샛빵빵	헝헝 방영시간이 늦어성 ㅜㅜ 다시보기로 꼭 챙겨바야겠어요 ㅜㅜ ♡
팡 팡	마지막에 히토미 넘넘 귀여운거 아니야ㅠㅠㅠㅠㅠㅜ
Young Aragaki	ㄷㄷㄷ... 안유진 , 최예나 ,나코 뺴고 다 별로네
김가은	00:24... 사쿠라 지못미...ㅋㅋㅋ 한국인 없나요~?
예슬아잉	웰케 기여워.. 히토미쨩.♡
kayo nice	I'm sorry but i just focused on Chaeyeon's beauty voice "Apeuro jal butakhae" 😂💗
날아라에비츄	꼭 본방사수 해야겟ㅁㅇ 넹~~♥♥
이너스이펙트	I'm looking forward to it. My brother loves you very much!😍😍
Zatoshi	Hyewonnnnn so cute <3
Kayra Lopez	Hichammmmnmmmmm
IHBEU	HITOMI'S WINK AT THE END! AAAAWHHGDJKKLOIFF FANGIRLING
Sara Fadime	Sakuraaaa 😍😍😍❤️❤️❤️
83dealova	Please give uri Nako-chan a looooottt of loveeeeeeeeee 💕💕💕💕  Aww hii-chan winkkkk😍
Nhung Subin	Nako chan.. So cute.😍.. ILOVEU.... 😘😘😘💓💓💓
워녕이	히힣흐흫ㅎㅎ홓홍홍홍ㅎㅎㅎ하하핳호호후후히힣
[김채원 사랑단]쌈끼	내 지갑 가져갈래?...
콩마마	원영이는 흑발이 이쁜데..
Jianne Youn	Sakura get off
희설	11명도 많았는데 12명은 진짜 많구나..ㄷㄷ
coshee 7321	워너원고랑 비슷한건가보네요
#챈돌프[세븐틴]	워너원 제작진들이 얘네 리얼리티로 갈아탔다는데ㅋㅋㅋㅋㅋㅋㅋ큐ㅠㅠㅠㅠㅜㅜㅠ 워너원이랑 얘넨 뭔 죄야
이트화	0:24초에 사쿠라 뛴거봐 ㅋㅋ 엄청귀엽네요!! 꼭봐야지!!
Vera Chou	I can't recognize wooyoung . Need a minute to recognize her
X Ghostring	Wtf happen to jan woonyung eyebrow... Who shave it?
덕세	와 진짜 채연언니 너무 예쁘다...ㅠㅜㅜㅜㅜㅠ
push mo yan teh	Sakura baby please...💕💕
김성훈	히토미 카와이 대폭발
블럽크아캐	빨리데뷔할날오ㅇ면조켓다ㅠ 마지막히토미졸귀야ㅠㅠ
이아	꼭 봐야죠♡
채아TV	나이때 수학여행ㅌㅌ
Alfiyah Atika	Hiichan 😍😍😄
Prisilia Ariani	Nako always cute😚😚😚😚 Yuri looks more beautifull here, but Wonyoung looks different without enough make up.
markiepie	my lovely 99 line girls standing to each other i can't ask for anything elseee!
im ur future army 101	IZ*ONE FIGHTING!!!!!     -Your Fan From Philippines❤❤
dd dd	히토미♡♡♡
Thu Minh	💗 min joo so lovely
비상	장원영 무슨일이야..? 얼굴이..
방탄보라해	히토미 ♡♡♡    원영이♡♡♡
Who's That Bitch?!!!	Eunbi 😍
Natthakan Saechao	SAKURA🌸
もち もち	ユリかわいい！！！！💓💓
Ray Jung	Im guessing 48 fans in Japan will tune in this reality show. Theyve never seen any of 48 members private life. ^^
lab fakey	Wonyoung is so tall 😳
예지	채연이 진짜 높이 뛴다😍😍 채연아 보고시프다!!!
lovelysunkyu	으히히히 빵토미 ㅋㅋㅋ
Esty Wijaya	Sub bahasa 🙏🏻🙏🏻☺️
missuna EXO-L	What's wrong with Jang Won Young Face???
bara	Who's the girl at 0:06, why they didn't do her eyebrows?
Rood Chrishi	Lee chaeyeon you go girl 💚
Todd park	기다리고있어
Random Shitz	Hiichan kawaii 😍😘
あい	なんて言ってるのか全くわからんけど可愛いからOKです👍
Azyan Izzati	what happens to you wooyoung?? ur face is swollen.. take caree
진9친92슬2	홍다희 놓치지 않을꼬예요~ ^~^
wns1119	히토미의 저 볼은 정말 아이돌 그 누구에게서도 볼 수 없었던 빵떡미...
Eaglewatch	댓글이 전부 외국인이네 ㅋㅋ 이 와중에 히토미 핵귀엽
moon moon	애들얼굴이 왜저래?
민지	헐 채연이 염색했구나...... 진짜 찰떡이다 존예탱
Born to be free	처음에 원 외친 사람 누구임
Gimash Hyolyna	HONESTLY I CANT WAITTTTTT 💖💖 CANT WAIT TO SEE HITOMI WITH HER CHUBBY CHEEKS HEHEHEE MWAH🙈❤💓💓
찡꼬[워너원]	0:06 0:09
뚀뚀「아이즈원 & 남주혁」	진짜 시간뭔대
사랑프릴	마지막에 히토미 언니...♡
taekookie果果、	Hitomo Love uuuuuu
_ Ryan	Hitomi so cute😭😭
Ulfah Nur Ilhami	😍😍😍
Dea Khansa	Chaeyeon being the center!!!!!
Alexandra Graciela	No Hiichan, no life!
Sherlee Kwong	Hitomi°°°°°♡♡♡♡♡♡
M R	기다렸다!!!
권영도	아이즈원언니들 이뿌당♡♡♡
ˇ음악-youtube	10월25일 목요일 내 생일
치유	0:06 누구예요?!
RD Channel	Please sai kasih sub eng
채널 바꿈	기대된다ㅏㅏㅏㅏ
twicepink_ army	Wonyoung without Eyebrowss!!???
Melly Hong	I'm obssessed with Chaeyeon's hair color 😍
아냥냥	조유리는 일본극우 아재들이 우글거리는 악수회 간거 사과안하나? 계속 할머니뱃지 안하는걸 보니  이용만한건가? 데뷔하고 일본공연갈때 꼭 뱃지 달고가길 바란다~
bwi	nako looks good with that new hair 💗💗
Moe BeeTee	subtitle please 😅😭😭
ULUN_꾸룬 G	금요일로 날짜 바꾸어주면 참 고맙겠어
Capt J	이거 기다리다 뒈지는줄.. 뭐이래 오래걸리나.. 다른시즌에 비해 별로 활동도 안하는거 같구만.. 광고도 겨우 몇개찍고.... 히토미 유리 은비 혜원이를 납치할까 하다가 말고 있다....ㅋㅋㅋㅋ 꾸라 찐따 하는짓이....ㅎㅎ
ヤクルトちゃん	へウォンンンンンンンンンンンンンンンンンンンンンン💗💗💗💗💗💗
Tasya Suryana	they are become more fat
sbb22	International fans can be very toxic. Back in 2000 when H.O.T announce their break-up all the H.O.T fans when crazy and trashed SM ent. lol I was very young when I saw it on tv.
놈놈놈	Hitomi~!!!! so cute!
chulha	강짱~♡
Thất ca	Choi Yena i like you
윤 윤	너무 예쁘다 ㅜㅜㅜㅜ ㅜ 꼭 봐야돼 이건 ㅠㅠㅠ 마지막 히토미 너무 귀엽다 흑흑 사랑해
Lèo Thị Chố Chang	*Debut xog xinh z mấy đứa:))*
Aeri ssi	Wonyoung's visual? what happened?   sakura's derp omygosh hahahahahahahahah
Jane Díaz	EunBi is so ungly
bluesking0209	어색 어색하다....딱하지만...
김쥬도리	장원영 다리... 진짜 길어 대박 아직 15살인데
fox prince	hitomi is so ugly
Ship Real Ship Yuuna	to new fans of Miyawaki Sakura, now y'all already saw how Saku-chan looks like when running😂
Dumpling s_n_s_d	YES FINALLY ♡♡♡♡FIGHTING IZONE♥
[army]다루	왜 하필 11시냥..
Nirvana	💖
Tuyết Nhi Trần	hiii-chan is trying to 'kill' me...T_T How can she be that cute?!
Ej Yiee	Finally
라연낭자	오늘이 25일이었으면...ㅠㅠ
성애젤리	빵토미졸탱ㅠㅠ 존귀야ㅠㅠ
S͙u͙g͙a͙ S͎w͎e͎e͎t͎s͎	Eunbi really out here looking like Irene
lovelydoyeon	wonyoung looks different. did she get plastic surgery or something?
Wanderlust Summer	Sakura unique running
Jimin's lost JAMS stolen by Namjoon	Sakura's derp face! Lol
YO W	Ending pose so cute🤣
Fitria Wulanda	lol sakura shot wkwkwkwkwkwk
ᅳ새로고침중	aisitelu
히힝뚜바뚜바	못 봐요...금요일이면 볼 수 있는데 금요일 로 맞꿔줘요 목요일이면 내일 학교가야 되는데 어떻게 봐요ᆢ 금요일로 맞꿔주세요!
조상운	반드시볼테야
ッ짱하	우리 유지니 ㅜㅜㅜㅜㅜㅜㅜ사랑해
Jedos Lee	원영아....화장하자
tyty	HIIICHAAAANNNN~~~
Ngọc Hoài	Flop
chickensoshitwice	Can't wait!!!!
조현재	원영이 생얼?
¿링녤요정¡{쟨셸언니꺼}	놓치지 않을거양
꽃나비	은비 예쁘다ㅠ
고양이번역기	히토미 빵 반죽 발효된거 보소 부풀어 올랐네
또띠아ˇ	마지막에 히토미 커엽 ㅜㅜㅜㅜㅜㅜ    ❤🌺
shinpeidaten	CHUは、キスの意味と、「〜中」の意味のダブルミーニングってことか。よくできてるw
KOMYUDA꼬뮤다コミュダ	히토미🤣씹덕사
지큐zique	이제 프듀대신 11시에 볼거 생겼당ㅎㅎㅎ 마지막에 히토미 귀여워ㅠ
실버	마지막에 히토미 졸귀... 😄😄
th em	원영이 쌩얼이 뭐가심하다는거야 느그 좃쿠라년 방사능숏다리 상하체일대일 오다리 대가리크기나 신경써라 원영이옆에서 개처발려서 며칠째 저걸루 ㅂㄷㅂㄷ대는거냐 ㅋㅋㅋㅋ
Kallys Awesome	I'M SISTER SHAKING
하아할일없다	장원영 쌩얼.....
Sigmund Freud	SAKURA LMAO
kookie _	Yuri I waiting you
ROSETRANQ	Hichan~
Rebe Ramírez	YAAAYYY
오오	애들을 왜이렇게 촌스럽게 염색을시켰니.... 검은머리가 훨씬 이쁜듯...
BANGTAN N	IZ*ONE FIGHTING !!
Amirul	Nako Hitomi😍😍😍😍😍😍😍😍😍😍😍😍😍😍😍😍😍😍😍😍😍😍😍😍😍😍😍😍😍😍😍😍😍😍😍😍😍😍😍😍💕💕💕💕💕💕💕💕💕💕💕💕💕💕💕💕 wow wow wow wow!!!!
flora orellana	0:03 Irenne are you?
Wizone GE	본방사수하겠습니다. ㅋ
933roastduck	Sakura Chan! I love all the members in Izone. Omg.
Merra Clarisse Marino	*CHU??!!!* WTF Mnet. That's kriesha chu's signature greeting. First, Cross Gene's Handsign and now, *this!!* Please be more creative for *iZone 💗*  Stop  this shameful act. You're being cheap Mnet. iZone should get what they deserve not just some borrowed ideas. *Please be more effortful for these lovely girls*
SiYu#思優	ひーちゃぁぁぁぁぁぁあん😭😭😭😭😭😭😭😭😭😭😭😭😭😭😳😳😭😭😭😭😭可愛すぎかっ
조까	빨리 보구싶다 얘두라
무아이즈원 히토미 [뿌야]	히토미 넌 역시 4랑스럽다... 프듀 초부터 널 좋아했던 나로써 너무 자랑스럽다!
Babydeega 182	Wonyoungieeee!!!!! 😍😘😘😘
tifanny choo	00:25 omg sakura 😂
김효준	10월 25일 꼭 본방사수!!!!!
æm	Won young
kimbluepan 1	IZONE 사랑해요~~
더오분만	사쿠라 위주만 편집해라
WID*ONE IZ*ONE1호 팬	히토미 마지막에 심장 타격 몬뎅ㅜㅜ
Dojun Yuh	원영이 얼굴 이상한데? ㅜㅜ 빵토미는 넘 가와이네
Hong Xiem Nguyen	Chaeyeon ❤️❤️❤️
Ceacillia	I LUV U YURI, YENA, EUNBI, CHAEYEON💕💕💕💕💕
리석기	중간에 갑자기 똥내가 윽
[ 12쨜 ]ˇ 지윤	좀만 더 일찍했으면 계속 보는뎅 ㅠ
TaeGil Kang	꾸라는 꾸라다 ㅋㅋ
woojin-ah's chamsae	Hitomiii
Niall Hazz	damn hitomi at the last 😍
미만O.T	와 저건봐야돼ㅇㅈ하는사람 !
싱클레어	하아...꾸라 점프마저 인싸자세인건가.... ㅠㅠ 대다나다
오로라녜히	0:24 꾸라  ㅋㅌㅌㅌㅋㅋ 우사인 꾸라
ジェニファー野津	hitomi wink wink!
anggita arrahma	Hitomi pipinya ucul bgt 😍😍
Lingga BLINK BLINK	oh my god Hiichan T.T
이상훈	오~ 본방사수~^^
로로TV	율옌 케미 빨리 보고싶다!!!!
띵콩[아이즈원]	당연히 봐야지...ㅜ  진짜 아이즈원 영원해효오...👉👈
Fredie Tin	SAKURA❤
초이	보정의문제냐 화장의문제냐 아님 둘다 문제인거냐 애들이 하나같이 토인으로 나왔네
Sakura's Donut.-.	What are they saying?
nisnisa 0515	나와나의이야기아이즈원츄❤ FIGHTING!!!🔥
きょろ	IZ*ONE사랑해요♥
나연	마지막 히토미 넘 귀여워ㅠㅠㅠㅜ
m L	Yena pretty❤❤🤣
Safinah Mohamad	Hyewonn!!!! Minju!!!!
뿝붑	원영이 눈썹더그려죠...
  ஂ 믐쀼	헉ㄱ...목요일.....악ㄱㄱㄱ 금요일에 하면 매주 볼수있는데ㅜㅜ목요일이라니ㅠ..그래도 뵈야될건 봐야하니까 하핳..(못보면 어쩌지)
Bambino Hisoka	I can't wait for there music video specialy Sakura Chaeyeon Hichan Nako Wonyoung 🤗🤗🤗
황인도	빵토미 완전 귀여워 ❤️
Mariko Hino	Wonyoung.... I didn't recognize her at first
문호영	왜 하필이면 도시어부 하고 동 시간대 하는지 참 해투 보다 시청률 더 나오기는 하겠다
Pham Cuong	The last part. OMG. Hiichan is so cute :)))). I can watch the last part 24/7 <3
dokyun kim	0:27 ㅋㅋㅋ 빵토미 넘 귀요미
사랑톰	일본어에 너라는 발음이 없는데 나코 너무 잘한다!!
bamn	I love the last part... hitomiii😍
yui	Whattaa wink...
Desmond Lim	Hii chan.................
Rky 365	Ahhhhhhh sooo exciting 😻😍😘💖💖💖
뜌루	꼭 볼꺼에요!!!!!
denise `	IZONE STANS LET ME HEAR YOU SCREEEEAAAAAAM
tolibenel good	Ada di tvn gak?????????
혜밍	아이즈원♥♥♥
Daniel D	Hee jjang~🍓 Hee jjang~😘
Toejoeh Benoa	Wow...Now I will have something to watch again from MNet..the continue of IZONE reality show...love it so much...Love you Sakura
정재빈재원	마지막에 히토미졸귀ㅋㅋㅋㅋㅋㅋㅋㅋㅋ
은하를짜냥해	헐 꼭 봐야겠다ㅜ 금요일 이면 더 좋을텐데...그래도 봐야지ㅋㅋ
워너원에반함	아휴
Hà My	아이즈원 추 파이팅 !!!!!!  원영이,사쿠라 언니, 유리 언니, 에나 언니, 유진 언니, 나코 언니, 은비 언니, 헤원 언니, 히토미 언니, 채원 언니, 민주 언니,채엔 언니 너무 사랑해 ❤️❤️❤️❤️ IZ*ONE hwaiting !!!
물파스	나도 모르게 웃고 있었다..
코코나나	거의 쌩얼도 이쁘네~~~ 악플신경쓰지말고 화이팅!
Suga is tsundere and Taehyung knows it	Nako is sooo cute
SoNise Quaker	Hitomi...my ghad...chuu
seko Paulus	yenyul debut
Musmina Mala	Chaeyeon  is so gorgeous  in color red
Kookie 97	Nako💞💞
뚜셜	여자아이돌 좋아하는거 첨이야😍아이즈원 화이팅❤꽃길만 걷자🌸🌹
최대원	왜 하필 11시??
이준	나코 잠깐 나왔는데 행복해진다.
덜후	오오 드뎌 나오는건가 ㅎㅎ
Ethan PARK	또 밤 11시?
준立派	히 토 미 🍓
Lee Sang	More Chaekura moments Kkuchaeng!
fan fun	eunbi looks like irene
Twice Stan 100%	Wonyoung and Sakura 💓
갓수	안유진이 제일예쁘네 진짜 정소민 닮았어 ㅋㅋ
nino nino	0:01 さくらたん💕
양연정	The Beatles
라이어리유리	뭔가 채연이는 생얼이 너무 예쁜데....  생얼도 화장해도 넘 예쁘공, 멤버 모두 미용실(?!)바꾸면안되나.... 갠적으로 머리스타일이 좀...ㅜ 25일부터 본방사수 할게용~♡♡
김토끼[아이즈원팬튜브]	함께주실꺼죠? 당욘하지ㅠ 우리즈원 오늘도 너무이쁘구 히토미너무귀엽다ㅠ❤❤
밤하늘별빛	본방사수다 어떠한 리얼리티보다 기대된다!
lotlot	oh my gosh i've been pronouncing their name wrong this whole time aHHH
Andrea Ante	Oh yeah this is it! finally IZ*ONE tv is finally here! can't wait to watch it and their debut too this is the start of their journey but at the same time of Sakura's run part and jump shot sje always makes me laugh XD
ゆわ	ウォニョン茶髪…
je jenay	My daughter Jang Wonyoung fighting!💕
퀸은비	은비야 기다릴께❣❣
I Love Weki Meki	SAKURA-CHAN YOU MAKE ME LAUGH.... Oh yea..Sakura Just don't run😅😂(Only Real Fans Know This) Sakura's Jump 😂 HIICHAN IS KILLING ME!!!!
유기상	장원영 다리길이 실화냐????
정찬문	키만 아니여도...
hwanbi환비	놓치지 않을꺼에요
Nurul annisa maydina	Sakura i love you so much for fingting izone so much always be my i Miss you so much
Irish Ann Baula	Nabuki 😊
I'm a lOop uWu	badly want to pinch Hitomi’s cheeks
EXO EXO	wonyoung kenapa keliatan beda 😂😂
kai ruu	they should appear on running man :D
락매니아	와 그럼 25일부터 매주 목요일마다 원영이를 볼 수 있는건가? 야호~ 기분 최고다~!
Henry Salinas	Buddy support izone
JAEMISSEO	IZ*ONE CHU, IZ NEED CHU
davina ardelia	YENA EUNBI & SAKURA
Minh Hue Nguyen	*CHOI YENA CHUU ~~*
耳たぶ	日本語字幕とは言わないからせめて英語字幕つけてくれ…わからなすぎて辛い…
동화	애들 미용실 바꿨으면.... 머리 색이나 스타일이 너무 안어울림...
방탄좋아	기대할게요ㅎ
예뻐닝	울 나코 꾸라 봐야지 ~❤️
Jinlu Llamosa	Wonyoung baby <3
land_liyin	Official fromis_9 watch this videoo!!
Micheal Cho	와 개미쳐따 .ㄷㄷ
Jung Chanyeol	Salfok ke Sakura 😂😂
Elai ᄋᄉᄋ stans everything GG	Oh my god it sounds like IZ WANT YOU!  THATS SO SMART I LUV THIS SHOW ALREADY
장원영만바라봐	아 이때 시험 첫날...씨
Asagiri Kohiruimaki	Omg won young se mira muy diferente sin maquillaje jaja aun que eso no quita su belleza💕, es la misma chica super adorable♡ que conocí en Produce48💓 c'=
화목	배경음악 앞으로 잘 부탁해는 새로 녹음한건가..? 빨리 보고싶다ㅠㅠ
크지않은 뵹아리	금요일날학교가야하는데 나는 학교를포기하고 아이즈원을선택해야겠다.여러분들 우리모두 본방사수할꺼라고 약속할꺼죠!?!
Choi Nana	I LOVE THEM OMG
mo may	Yena so adorable
HANDE핹디	아ㅜㅜㅜ 왜 평일에 하는거죠??ㅜㅜ
싴탱	I MISS YOU IZONE!!! FIGHTING!N ❤❤❤❤
Maite Vargas	OMG OUR BABYS ARE COMING BYE I DIED
Anime music	My babies😍😍😍
[ IZ_ONE ]냠뜌	네에ㅠㅠ 같이 할거에요ㅠㅠㅠㅠ💙❤❤❤❤❤❤
gold key	WARNING_2!!! Behold yourself cause whenever Sakura running or jumping, she will become unrecognizable creature😂😂😂💖💖💖..
보하	왜 허필 목요일이여 ... 드것둥 11시 ㅜ ㅜ
Pi Kumi WIZ*ONE	Chaeyeon!!! Nako!!! Sakura!!! Hitomi!!! ٩(●^—^●)۶ ♡♥ daisuki~ kawaii~ My kokoro!!!
예나 팬아이즈원	아이즈원~~~
AliasFlower	YES THANK YOU MNET
훈자	예나 너무 귀엽자나 ㅋㅋㅋㅋ
Aventador K	ㅋㅋ 귀요미들
Corayma Uchiha	💎💎💎💎💎💎💎💎💎💎💎💎💎NAKOOOOOO I LOVE YOU ARE BEUTIFUL 😘😘😘😘💖💖💖💖💞💞👑👑👑👑💎💎💎💎💎💎💎💎💎💎💎💎💎
riezhal over	Mnet love hitomi-chan.
gotwa229	I know these people can sing & dance, but besides acting terribly cute/kawaii/gweeyeopda, have they actually done anything yet since their last televised performance on 31 August 2018?
BrightWarmWater	Minju you got me! Someone else?
홍길동	그때까지 어떻게 참지😢😢
shella seven	sakura i fall in love with you😍😍😍
밍제젤	8시에 했으면
Kura Pika	RIP WonYoung's eyebrows :(
몽환적인새벽	왜.....왜 목요일인거야!!!ㅜㅜㅜㅜㅜㅜㅜㅜ
Andriele Saiuri	😍😍😍
Jelly toot	❤️ YuRi ❤️
워너블[지슬이]	오 내가 현체가는날에 방송을한다니 너무좋다!!
Mariana Oliveira	Is this a reality show with them?
Royal Kitty	Wonyoung leg longer than Izone contract..
oh hi mark	*here's to two years and six months we'll be spending together* 💕💕
Jacque IML	Chaeyeon 😭😭😭❤❤ ¡fighting!
its rei	stop it, get some help 😭
padang pandanaran	new hair colour = ready for debut
BTS Y GFRIEND	❤❤❤💖
KPOP MFF HEART	So excited for this... I hope they will let this program in TVN
fashionmwah	CHAEYEON!!!!!!!! 🌟🌟🌟🌟🌟🌟 We can’t wait for you to shine shine shine so brightly!!!
Sheyla Milagros Yaya Torres	I can't wait.  Yujin I love you. 💜💜💜💜💜💜
부산촌놈	Omg I can’t wait......
EXO- MAZING	LOL AT 0:12 FACE OF WONYOUNG. THERES SOMETHING AWKWARD
lia c:	YENAAAAA💘💘💘
Momo In Jokbal Land	Can u hear me crying?
Kate Córdova	Wonyoung is so cute and pretty!!! ❤
Rosie Park	I'm glad to see hitomi at the end I'm happy to see other girls get noticed everyone is always sakura vs wonyoung but I love *ALL* members of izone
Nate Archiebald	Japan line is love! ❤️
mark jovin m	so where can i watch any suggest website that subs?
rabbitful	ITS HAPPENING FELLAS WE FINALLY HAVE A REALITY
bakayut0	Hii-chan♡
자샐{아이코닉}	당연히 본방사수징♡
Pradita Ananda	Woonyoung’s long legs.. whoaaa
Pyscho _13	CHAEYEONNNNN HWAITING
INTANPLS	Hiichan wink aahh kiyowooo 😍
kim hwanweon	아씨 겁나귀엽네 ㅋㅋㅋ
Little P	Hii channnnn
Yoo Marck	waaah IZ&ONE <3
亮	yujin~~~~~~~
Fangirl for Life	사쿠라 너모 엽포? Is this right? 😂
Puga Puff	Wonyoung ❤️❤️❤️
우라메시유스케	헉헉 시부레꺼,, 아이즈원,, 나코상,,, 꼬옥,, 본방사,,,ㅅ,... 수
Kenmark Ollano	Hiichan doing Hiichan things lol
sodu peach	hiichan has the cutest cheek uwu such a cutie
Clariz Tzu	When Starship girls are so tall 😢😢😢
이덕희	아~~~기대된다 다들 너무너무 좋아^^ 부디 활짝핀 꽂길만 가길 바래봅니다^^아이즈원 화이팅!!!!!^^
M*31 Lover's	Hitomi so cute...!
Worren Crofitin	hitomi😁
서승욱	Me to  i'll never let this program
옆좌석	아 채연 너무 귀여워 ㅠㅠㅠ💕💕
Pen Pineapple	They all died they're hair
若蓁 黃	Yuri😍😍😍 fighting！！！！！
GJ HAHN	채연 양 서전트.... 덩크도 가능 할 듯
Kim Susan	CHAEYEON'S HAIR SO PRETTY
Alice Lee	나코 ㅠㅠ 귀여워
Chara	hiichan are so cute and so does saku chan!!
유리나	아 귀여워 내새꾸들...
Free tibet china No.189	사쿠라 씹 마지막 점프 뭐냐ㅋㅋㅋㅋㅋ 찐
Diman Nurjaman	NAKO WITH KOREAN MAKE UP = COOL & SEXY
nadia putri	Hitomi😂😂😂
Leony Sonalia	HIICHAN IS KILLING ME
Jiraporn Namprasit	lmao I clicked this so fast
Anon Ymous	HITOMIIIIIIIIIIIIIIIIIIIIIIIIII~
193989탱구	와씽 혜워니 츄ㅠㅠㅠㅠㅠㅠㅠㅠㅠㅠㅠㅠㅠㅠ오지고 지리고 렛잇고ㅠㅠㅠㅠㅠㅠㅠ리얼리티만 기다렸다ㅠㅠㅠㅠㅠㅠ혜워나 데뷔길만 걷자ㅠㅠㅠㅠㅠㅠ
Alvin Putra	sakurachandabes
Han	젊음!이 매력이네
digby18 Foo	💗Sakura🌸!
SK Yoon	히토미 켜라
leeChaeyeon cosgafa	Saranghaeyo lee chaeyeon 😍
。ゆず	ひぃちゃ🌱🌱
맗K1	앞으로 목요일은 시간 비워둬야겠구만
Julya Ulfah	Chaekura eunbi💕
덕심은있고요양심은없습니다	채연이 빨리 보구 싶당 ㅠㅠㅠㅠㅠ♥♥
캐럿TV	아이즈원
Malik Abdul Haris	Ngapa dah
fai ff	sakura💓
Jelly Bean	Hiichannnnn
cikicik	lee chaeyeon please be funny
Vallencius Gavriel	Anyone think that hitomi have a similar face with logan paul if she is smiling? 😂
イェナ＊まちゅ	楽しみぃぃぃぃぃ そして最後のひーちゃんの破壊力ぅぅぅぅぅ
윤탱	히이이이이이이이이이이이짜아아아아아앙
Klouddhe B	This is not the line-up I expected to be
Ethrain Doom	subs pls
_예림	아히토미ㅜㅜ너무귀여워ㅜㅜ
Justine Mervic Andres	UGH HITOMI KASHDKAJSHDKASJDHAK I LOVE YOUUUU
Siti Alliyah	I CANT WAIT IVE WAITED FOR SOOOO LONG OMG IM SO EXCITED!!!!!!!!
SAYTHENAME SEVENTEEN	hitomi's cheek omg she's so cute😍
Pamela Gaile Corsame	HIIICHAN'S CHEEKS SAVED ME
하옘밈_07[세븐틴/워너원/잡덕]	금요일도아니고 목요일 ,, 학교가야되는데 늦게까지 되려나 ?
Lim JunYan814	Hitomi Da Best ah xD...
Sayella	Wonyoung's makeup is too plain. Contrary to her fresh aura she looks a bit older in this.
Missay	CAN'T WAIT
녤다	많이 봐주세요ㅠㅠㅠㅠ
Munzi Phn	Everyone look so great when jumping pose but sakura.... Lol
Kyle Lee	한 6회 정도로 연장하자 4회가 뭐냐?
。さぐちゃん	ひぃちゃんの髪色めっちゃ違和感笑
nyleig	Hiichan at the end.....😍😍😍😍
woozi's thighs	please have this in tvn
배트맨	타니구치 메구 : 에~~~~!? 중계하러가야띠!
KR IS	OMG!!! CHAEYEON HAIR 😍😍😍
GTS阿米鳥	❤️🧡💛💚💙💜
Jynel Wide	chaeyeon's hair.. love it. so cute
에핑사랑할수없는마음1도없어	꼭 본방사수!
Yuuka N	Hitomi💕 Hyewon💕
Park Chanyeol	HII CHAN IMUT BANGET DAHH😍
Jin-Hwan Kim	히...히토미 귀여웠다.
taengoo ly	Can't waittt😆 i love crackheads😂
유림	사쿠라 ❤️
YS Park	히토미 졸라귀여웤ㅋㅋㅋㅋㅋㅋㅋ 노찌지아눌꺼에요
이지호	원영이 내꺼야~
루피원츄	진짜 심쿵♥
Ame	No makeup?
dong-jin Choi	OK! 꼭 볼께
Lunime Misaki	항상 세가언니 곝에 있을게요! (ฅ’ω’ฅ)♥
·유진· ·도비·	빨리와♡♡
Pokecather	It is great how the vlive they streamed in japan and why they were actually there was actually for this. I CANT WAIT!!   FIGHTING IZ*ONE
[ Y E R I M ]예림	11시아니였으면 봤을텐데.. 쩝
G. A. Manoreh	hitomi 😍
js prom	hmmm... chu... minjoo do you have something to do with this?
Ray Park	팬클럽명은 ONE CHU <3 로 결정??!
George Ravelly	Hitomi kawaii é muito difícil suportar, é um ataque ao coração de qualquer um kkkk, muita fofura
AA Arizala	cutieeeeee😍😍😍😍
SEA48 SouthEastAsia48	I want chuu~~~~~  oh god hahahahah Lol its is a reference to Heavy Rotation lyrics????  Omg Sakuraaaaaaa hahahahahahhaah
Luthfi Mahdiantama	my berry ending fairy!!!
Immature Fans Basher I Love Underrated Group	CHU~ HYEWONIE😘
-Jeon Hyosung-	Wonyoung looks like apink naeun
Catrina Essey	You can tell wonyoung is still young for her body, it still hasn’t developed its shape yet
Saskia Putri	cant wait for the variety show!!!
Ran Ran	what happend to wonyoung face?
No	Minjoo’s visuals snapped
沙村	ミンジュめちゃめちゃ可愛いな
cookieforkookie	Hyewonie~ ♡ヾ(≧ ω ≦)ゞ
Shazni Sabata	Won young's eyebrows... 😂 😂 😂
Hayeoni :3	*HITOMI SHOT MY HEART! AAAAAAAAAAAA HELP ME!!!!!!!* ❤❤❤❤
박홍관	빵토미 ㅎㅎ
account 99	yena and hyewon so cute😍😍😍
Wemerson Bandeira	Ahhhhh Hitomi so cute..ahhhhhhh IZONE COMEBACK
Nicole Alvarez Cerdas	Sub eng please, international fans want to understand too... 🙏
ᄋᄉᄋdbslzm	캬 빵토미잉이아
Theetat Chuaychoosub	cute
#설온#	당연히 봐여죠!!!
Dayana Salcedo	😍❤️ Can't wait
WIZ*ONE	izone super cute!~~~^.^
나코나코니	아이즈원 사랑해 ❣
อยู่ทุกด้อม	즈 💓 *Minjoo* love u fighting💓👑
K-STAR_222	very very very cute!~~~~^.^
Pana Pany	wonyoung is so pretty no wonder koreans loves her
love potion	リアリティ楽しみ～
이당당	..워너원고 아이즈원츄?
Shining Bright	That "chuu" 😘😘
MÜDÂ	What is Chu..???
eungyo LEE	한국팬이면 👇
Rumeysa Yılmaz	Hichan kawai!
ˇ사이다	기대할게~
ΛRMY x OИCE x BLIИK x REVELUV	*Nako is so small she barely even got off the ground*
NAKO NAKO NAKO YA	CHAEYEONNNNNNNNNNN!!!
milkywaynmb	리얼리티 드뎌 하는구나~
풍부한뇌세포	워너원 고에 이어서 아이즈원 츄인가....
Laga Bagas	Love chaeyeon,minjoo,eunbi so much😍😙
Aisyah Tria	hitomi at the end makes me dead
유진이만	앜ㅋㅋㅋㅋㅋㅋㅋㅋ귀여워 미친거 아니냐고
Avril Medel	yena and yuri ❤💞
그냥저냥	왜 생얼인거지?ㅋㅋㅋ
Rina's TV	Chae😍 eun😍 na😍
성윤김	안유진 넘좋다ㅎ
Linh Nguyễn	Hitomi so cute
Sierol Geynier	Sakura, so adorable
IZ*ONE is love but NAMU is life	my kids, my girls my daughters ❤️
김만섭	SK-II피테라에센스 3대모델 히토미 각인가요... -놓치지 않을거에요라니-
이사나	팬클럽 이름 원츄 하면 되겠네 ㅋ
이초밥	Wonyoung♡ ^_^
사람쥐	나코 존예
Kevin Handy	MEDIC MEDIC !!!! I Forgot to breath
be be	가와이네~
1118 willow	앚둥이 ㅋㅋㅋㅋㅋㅋㅋㅋㅋㅋ 그냥 새로운 단어를 만들어 보는게 어떨지..  안그래도 트와이스랑 비교 당할텐데 사소한부분부터 차이를 두는게 아이즈원 한테 좋을듯
이대우	기대만땅땅땅!본방사수 할게♥
Cube Trash	ahh hitomi so adorable ;;
쏟아나라 !- P P U Y E O N _	아 금요일도 아니고 왜 목요일 이냐 ...
Phượng ARMY	Chaeyeon
지연`	ㅜㅜㅜㅜㅜㅜㅠㅠ좋야
_07보댤	헐.. 당연히 함께할께요ㅠㅠ 아이즈원 사랑해요!♡
annie jonson	日本人🇯🇵いない？ 雰囲気！雰囲気で理解しよう😅 Sakura🌸Nako🍒Hitomi🍓figting💪
HiMiN히민	츄~~
mochimin	IM SO EXCITED AHHHH
samsia semy	00:29  Wait.. what was that... 😍😍😍😍
Anisa Rahmafalak	Izone chu is like wannaone go or okay wanna one?
Jovita Annadhirah	Hitomi ending scene melt my heart ❤️ I love her chubby so much 😍😍 HITOMI, FIGHTING!!
Chamida Nurhayati	Sakura ❤
Renaldhi Umar	kwon eunbi, miyawaki sakura, choi yena, kim minju good
King Daniel	Izone💕
YouTube라율	아이즈원 이뽀다!❤🧡💛💚💙💜💖😀
Dhika Ahmad Aulia	Hitomi at the end are adorable af
Ruby Manoban	0:08 literally look like yuqi Gidle
Flower Sweet	That Sakura's meme at 00:24 haha. I can't wait to see her sleeping face too lol
Yumeko Kami	EUNBI ♡♡
Dark Eyes	Sakura cute♥️♥️♥️
TWICE AND YOU ARE SUCH A MASTERPIECE	0:23 look at sakura's face..............................
뿌링클 먹고싶다	사랑행 아이즈원 꽃길만 걷자 리얼리티 개꿀잼 일듯
aya 160313	ウォニョンちゃんが茶髪になってる😮奈子ちゃんにも言えることだけど、黒髪が似合う子は染めるともったいないなーって思ってしまう。茶髪でも可愛いけど、うん🤔
Maulidiana Rahmani	Sakura face 😂😂😂😂😂 can't wait moment of sakura x chaeyeon. Chaekura💗💗💗 hotaru couple💗💗💗
Rabbit MN	😍
Diamond Buddy	I keep thinking wtf is Chaewon doing there
Catherine Shih	HIICHAN IS THE CUTEST CUTEST MOCHI EVER
하루벌어 하루사는 직장인ᅳᅳ	빵토미 때문에 본다 ㅋ
Alrrruun Oda	When sakura runs.
Yhel tornetembser	CHAEYEON......FIGHTING😘😘
Latief Adam Busyairi	can't wait seriously.. hope they make this longer than previous idol.. from what i remember ioi just has 2 or 3 episode for their reality show
みい	かわいい😍😍 응원할께요 応援してます
정윤석	아이즈원 너무 좋아요♥♥♥♥♥♥♥♥♥♥♥♥♥♥♥♥♥♥♥♥
유정	Chaewon!!! Eunbi❤️❤️❤️  보고싶었어 앙즈들 ㅠㅠ
kitty isti	Just pause 0:26 😂😂        Ps: I can't wait to see a meme or video using Sakura's face 😂😂
Roselle Nuñez	the only kang i hate lol
COCO OCOC	OMG IZ*ONE
Gelo	I always cringe when I see Sakura prepares to run
shofie naila	chaeyeon jump was so tall
kurumi itsuka	i can't wait!!!!! i'm sooooooo excited. IZ*ONE debut 10/28/2018 <3
no choi yena_ no life ya'll!	SHETTTTTT WTF ITS HERE DSHETT JSIWKEJRUEH PUTANGINAAAAA
maisrh hns	i cant wait to see japanese line improve in korean
조개꺼북	어머!이건 꼭 봐야해!!
half moon	HIICHAN
tanu ta	本田仁美ちゃん雪見だいふくのようだな
Gel xx TwicePink	OMG 😍😍😍
Yudistira P	Kang hyewon😍
ひらうき	えー！！！なに！嬉しすぎる！！！
さとうゆう	日本語訳ください～
ぽ	Nako!!!!!!!!!!! So cute!!!!!!!
kkeiwaii	I MISSED MY EUNBI AND CHAEWOON : ((
이우재	본!방!사!수!할께용ㅎㅎ
서강희	대참사..
별이바라기	채연😍
わーちゃー	待ちきれない〜！
yui ohtsuki	Cant wait to see more chaewon minju and dahee 😂
Gwee Min Shan	Looking forward to it!
q6s8u0 q0	background or location is look a like song Love whisper of GFriend ?
Nurul huda Linnas	Chu is kiss in Japanese. Aww, they're Going show a lot of cuteness ini this show😘
Armin Tenishia	As always won young my big cupcake ~💛😍😍💛
Yujin Wonyoung kan	Oh shitttttttttt
Tennie Jammie	Hong Dahee's adorable cheeks!
dd9	0:23 꾸라야 항상 아낀다
Liboj Ernandez	IZ*ONE CHU 😍
예쭈	기대된당
Ringa Linga	아 너무 기대돼애ㅐ애ㅐ애ㅐ애ㅐ에애ㅐ애ㅐㅇ   ㅜㅜㅜㅜㅜㅜㅜㅜ 애들아 ㅜㅜㅜㅜㅜㅜㅜㅜㅜㅜㅜㅜㅜㅜㅜㅜㅜㅜ
ゆいな	咲良ちゃん〜😘💓 사쿠라〜😘💗
유지나	기대된다!!! 리얼리티까지 언제까지 기다려ㅠㅠㅠㅠㅠㅠㅠㅠ
노경민	Nako~~~~
젠츄리챙	어디서 방송해요?
달인	꼭봐야지
んぴ	0:24 사쿠라ㅋㅋㅋㅋㅋㅋ
Akeisha Arabella	HITOMI IS SUCH A CUTIE I C ANT EVERYONE PLEASE STEP ON ME
Eteh Papoy	KEMBARAN QQQ
kalecumber	i know it’s annoying to complain but YMC why tf we didn’t have this for I.O.I??
Thae Thet Hnin	can someone translate????
김기환	히토미 볼 터지겠다 아주좋아 ㅋㅋㅋㅋ
김도연	기다리고 있을게 ㅠㅠㅠㅠㅠㅠ❣❣❣❣
Jay Torres	Hi chan
2YJ Wonsi	마지막에 빵토미 귀엽당
tv청유월	꼭 봐야긋다
Jihoon Park	I can already tell how things will go with Sakura HAHAHA Luv IZ*ONE
꽃쏭이	내샹일10월25일인데!!!아이즈원팬임
Lin hoon	💓💓💓💓
Sakky	ねえ、予告で既にかわいい｡･ﾟ･(ﾉ∀`)･ﾟ･｡
Caitlin Pascasio	THEY'RE SO CUTE AAA I LOVE ALL OF THEM SO MUCH 💖💖💖 especially hiichan at the end haha
Ama Salma	Sakura, just... dont jump
라라라알	히토미 미친거아니야!!!!!!!너무 귀엽잖아 진짜ㅠㅠㅠㅠ아이돌중에 제일 귀여운거는 빵토미
넹츄곤듀	11시...?
まるい	엥 장원영 맞어? 화장빨이었나..?
HAEchanniee	Hii chan kiyowongg ㅠㅠ
Asti Noor Hot!	Sub English please! 😭
Sleepy Girl	Yujin is so beautiful ❤️
きあ	ひーちゃん黒髪の方が似合ってる、！
세민	놓치지 않고싶어 ㅠㅠㅠ 제발
Deyuna Rusmiland	Never have been so excited to reality show until Izone's reality show
taehyung xoxo	can't wait JDAKEKSOK
채하	11시 라니.. 재방으로 봐야겠네ㅠㅠ
러에	목요일 ㅠㅠㅠ 일찍 자야하는데 ㅠㅠ
Y H	💖💖
Zomii Jeon	I'm very excited 😃💗✨
원치훈	기다렸다고ㅠㅠ 드디어..!!
Toni Uy	CHAEYEONNNN!!!!!!!
GirlGroups are my religion	I wish they will add subtitles, please mnet (We need subtitles 😢) IZ*ONE CHU fighting👍
Mars Mars	13일 어떻게 기다리니 ㅠㅠ
pp	꾸라야 점프만 했는데 웃기다
Jisung Hyung101	Iz*one will debut this october? Then wanna will disband this october already? ㅠㅜ😢💔
Natasia Priscilia	Hiichaannn 😭😭😭
eunchaekura nim	r.i.p replay button
현성	'이' 한애 이름 뭐임? 개빻앗네
Del	This is just a teaser and they are already do an iconic meme. Please girls :D
ra Li	I’m really looking forward to IZONE’s reality show‼︎
Ermisha	ok hitomi- thats so cute u w u
이동심	히토미♥♥♥♥♥♥♥♥♥♥
yujin love	yujin！！！！fighting💗💗💗💗
k56 non	日本語の字幕つけて欲しいなあ
light pnda	Hyewonnn
nol	AAAAAAH THEYRE SO CUTE
愛実	ひーちゃん！最後やばいよぉー！
aaaaaaadelknight	where, where are the subtitles ??
지미헌터	알람 맞춰야지 지금 예약도 안걸리고 까먹겠다
Zo Mii	IZ*ONE Chu😍😍 I will waiting for my girl Fighting~^_^💖💖💖💖 Love Yena so much😘😘❤️❤️
Song Yoojung	Chaeyeon
あおうさぎ	ひーちゃんウインク可愛すぎる🤦‍♂️💞
WoNuChEesBuRgEr #sveme2k18	The same date as TVn???
bad weed	아 또 생방으로 보고 재방으로 보고 움짤도 보고 하이라이트도 보고 숙제 늘어났다 ㅠㅠ
이름알수없쇼	초딩이라 본방은 못본지만  재방이는 볼껍미다!! 제 손목 걸고!
Gay for IZ*ONE	Yaaaas at last ❤ hiichan my bias is so cute 😍😍
Jimmy Choi	*Sakura !!!!!!!!!!!!!!!  9.8m/s^2*
Ny Nguyễn	Chaeyeon❤️❤️❤️
Kevin Lee	완전기대
ONCE FOREVER	SOOOO EXCITED FOR THIS 😍😍😍
fairy tail	I'M FUCKING EXCITED Y'ALL
Pui Sone	HIICHAN OMGGG SO CUTEEE
noreul fatheen	Hiichan so cuteee
tk. Han	히토미는 나코보다도 귀여운데, 성격은 애교 부리고 그러는게 잘 안맞는거 같아. 은근 진지하고 성실한 타입
J _	YUJIN IS BEST☝️💗
Wiz*one Ahn yujin	I love yujin and all iz*one 💜😘
S L	CHAEYEON 👑
サランヘヨTWICE	日本人 やっぱり  少ないですね……😭😭😭
Azrul Ahloi	woonyoung eyebrow was so thin.
やぶぁぃ	最後のひーちゃんかわいすぎ♡
Briguy1027	LOL, I had to watch the video at least 5 times to see everything :)  They have so many members but when they are all together your eyes go everywhere!
whap noodles Bloom curry	I love my favorite new IZ*ONE ❤️👌🤗
sheena 13	♡
도레미제라블	꾸라야.. 벌써 재밌다😄😄😄😄😄
원도경	안돼 목요일 이라니!!!
bj kwon	놓치지 않을거예요 !!!!!!!!!!!
Drugs I Love	0:09 YIKES! 🤢 🤮
BLINK ꒰fanboy꒱	Chaewon is so cute 💙
염지훈	기대 많이 하고 있어요. ㅎ
Sowonchie06	0:08 - I thought Yena was Yuqi. Lol
kirin chan giraffe	Finally. I can't wait
TV흑표범	꼭 본다~ 원츄
crazy asmr	기대 됀다♥♥
Yabuki Nako's slave for eternity	What happened with Wonyoung's eyebrow? Lmao
とろーる	10月25日11時Mnetでみれるのか？
TheOneAndOnlyAsh	guees im being gay to hitomi😍😂
Da Daniel	Hitomi save the teaser
なは	なこ 奈子 Nako 나코💕
Hyun 3399	Sakura what happen to your face
Sedo Kim	LEE CHAEYEONNN
Jo Lesile	아 그냥 다음주에 방송해줘
Annisaa Puspitasari	Figthing!!! 💜💜💜💜💜
우해성	😘😘😘
Lily M	Chaeyeon’s hair is very nice I can’t wait till  the show starts
최현	드디어 공개 되나요 ㅠ
모찌 모찌	드디어 하는군ㅎㅎ
get wonder	FIIINNNAALLLLYYYY!! ❤❤ CANTTT WAITTT!!!
taeyeon ss	Yena so adorable
G.R Son	아이즈원츄.아이즈원츄.아이즈원츄.아이즈원츄.아이즈원츄.아이즈원츄.아이즈원츄.아이즈원츄.아이즈원츄.아이즈원츄.아이즈원츄.아이즈원츄.아이즈원츄.아이즈원츄.아이즈원츄.아이즈원츄.아이즈원츄.아이즈원츄.아이즈원츄.아이즈원츄.아이즈원츄.아이즈원츄.아이즈원츄.아이즈원츄.아이즈원츄.아이즈원츄.아이즈원츄.아이즈원츄.아이즈원츄.아이즈원츄.아이즈원츄.아이즈원츄.아이즈원츄.아이즈원츄.아이즈원츄.아이즈원츄.아이즈원츄.아이즈원츄.아이즈원츄.아이즈원츄.아이즈원츄.아이즈원츄.아이즈원츄.아이즈원츄.아이즈원츄.아이즈원츄.아이즈원츄.아이즈원츄.아이즈원츄.아이즈원츄.아이즈원츄.아이즈원츄.아이즈원츄.아이즈원츄.아이즈원츄.아이즈원츄.아이즈원츄.아이즈원츄.아이즈원츄.아이즈원츄.아이즈원츄.아이즈원츄.아이즈원츄.아이즈원츄.아이즈원츄.아이즈원츄.아이즈원츄.아이즈원츄.아이즈원츄.아이즈원츄.아이즈원츄.아이즈원츄.아이즈원츄.아이즈원츄.아이즈원츄.아이즈원츄.아이즈원츄.아이즈원츄.아이즈원츄.아이즈원츄.아이즈원츄.아이즈원츄.아이즈원츄.아이즈원츄.아이즈원츄.아이즈원츄.아이즈원츄.아이즈원츄.아이즈원츄.아이즈원츄.아이즈원츄.아이즈원츄.아이즈원츄.아이즈원츄.아이즈원츄.아이즈원츄.아이즈원츄.아이즈원츄.아이즈원츄.아이즈원츄.아이즈원츄.아이즈원츄.아이즈원츄.아이즈원츄.아이즈원츄.아이즈원츄.아이즈원츄.아이즈원츄.아이즈원츄.아이즈원츄.아이즈원츄.아이즈원츄.아이즈원츄.아이즈원츄.아이즈원츄.아이즈원츄.아이즈원츄.아이즈원츄.아이즈원츄.아이즈원츄.아이즈원츄.아이즈원츄.아이즈원츄.아이즈원츄.아이즈원츄.아이즈원츄.아이즈원츄.아이즈원츄.아이즈원츄.아이즈원츄.아이즈원츄.아이즈원츄.아이즈원츄.아이즈원츄.아이즈원츄.아이즈원츄.아이즈원츄.아이즈원츄.아이즈원츄.아이즈원츄.아이즈원츄.아이즈원츄.아이즈원츄.아이즈원츄.아이즈원츄.아이즈원츄.아이즈원츄.아이즈원츄.아이즈원츄.아이즈원츄.아이즈원츄.아이즈원츄.아이즈원츄.아이즈원츄.아이즈원츄.아이즈원츄.아이즈원츄.아이즈원츄.아이즈원츄.아이즈원츄.아이즈원츄.아이즈원츄.아이즈원츄.아이즈원츄.아이즈원츄.아이즈원츄.아이즈원츄.아이즈원츄.아이즈원츄.아이즈원츄.아이즈원츄.아이즈원츄.아이즈원츄.아이즈원츄.아이즈원츄.아이즈원츄.아이즈원츄.아이즈원츄.아이즈원츄.아이즈원츄.아이즈원츄.아이즈원츄.아이즈원츄.아이즈원츄.아이즈원츄.아이즈원츄.아이즈원츄.아이즈원츄.아이즈원츄.아이즈원츄.아이즈원츄.아이즈원츄.아이즈원츄.아이즈원츄.아이즈원츄.아이즈원츄.아이즈원츄.아이즈원츄.아이즈원츄.아이즈원츄.아이즈원츄.아이즈원츄.아이즈원츄.아이즈원츄.아이즈원츄.아이즈원츄.아이즈원츄.아이즈원츄.아이즈원츄.아이즈원츄.아이즈원츄.아이즈원츄.ㅍ
Fifah Wan	Love all izone member... Love them so much.. Huhu
Bing Bing	Haha,  sakura face while jumping up to the sky
토비4	ㅋㅋㅋ 꾸라
김민재	Hitomi ❤️❤️❤️
이삭	아직 2주나...
아핀아이린	Sakura...you make me laugh (😂😂😂). Can't wait to see you my princess ~😘 IZ*ONE Chu (FIGHTING)~ 아이즈원 화이팅 ~~!!!! 사랑해요 ~😍
사이다	이쁜애 12명♥♥♥
2NE1 is a WINNER that has an ARMY of VIP WANNABLE	Sakura at the end is the BEST😂😂❤❤❤🌸🌸🌸
Nur 2001	No hate spread love 😘 #iz*one😍
Ho Lee	오냐오냐 꼭 보마 ㅎㅎ
Ha Nguyen	MISS U, CHAEYEON T_T
Lon Cho	Jang Won Young Hwaiting 😙❤
Hongxiem Nguyen	chaeyeon's body is very nice <3
Joanne Tan	hyewon ahhhhhh~~~~~ CHU<3333
Boeun Seol	빵토미 왜이리 귀여운지..ㅠㅠ
Twice IZ*ONE	I was waiting for so long
Ayuni Adila	This is Sakura face 0:24 if you let her jump😂😂
kiel sasamira	I can't wait this
esalyz	Eunbi✨💘
두릅	꺄아악
Ppd NK	sakura run!!!
Gear Secando	I LOVE CHU ICHONE
Fadila yuliarti	IZ*ONE CHU😘
truekpops.	Yujin, Sakura,Nako,Wonyoung,Minju,Yurihave brown hair Chaewon,Hitomi,Hyewon have reddish hair Yena has Ash blond hair Chaeyeon got purple and Eunbi still with her Black hair ,okay this is making me more curious 😆
Sergi Akbar	Hiichan in the end.....so cuteee omh
전재형	izone reality♡♡♡♡♡
미야와키무궁화•현대히토미	키타!
리랑_옌_	우왕♡기대된당ㅠㅠ♡♡
yuki Y	What's this? Is this an "IZONE reality" program they said before?
commercialfree	excited for this. hiichan at the end is so cute. nice job MNET
Ester Florano	Yuri .. 💕💖
딜섬'	아 너무 이뻐요ㅠㅠ 나코❤❤❤❤❤❤❤❤❤❤
후훗	원영이 쌩얼ㅋㅋ커엽
GUMI chan	izoneリアリティ番組楽しみ〜✨ さくら、ウォニョン  、なこちゃん💖
ら ぶさ く	SAKURA I LOVE YOU ♡
FullSunTV	ASDF SAKURA IN THE FREEZE FRAME
Jakkree Sriwicha	สาคู~~~~
BEAR POLAR	Why Miyawaki Sakura is Miyawaki Sakura not Lee Kkura and why Lee Chaeyeon is Miyawaki Chaeyeon? She's Lee Chaeyeon! Plz don't change her name. I like that because I don't  want people to say she's like she belongs to someone. She's just her. I hope the Chaekura shipper if change her name change the name Sakura too. it is fair.
공룡	빵토미 이쁜다 ㅋ
ป๊อป'ปป หีขึ้นรา	Wonyoung and hitomi so cuteeee❤😍
Wannable	They're so cute <3
พลอยลี่ _RmP	IZ*ONE 😘😍❤👏🎉
iuxbkman	OMYGHAD ITS HAPPENING!
ABC 123	드디어 하는구나
Huh YunJin	Lee Chaeyeon's hair color tho 💛
Angela Abdulmajid	Sakura miyawaki
Feby Diah	aaaaaaa cant wait for the izone reality show!!! AIZUWAN REALITY AIZUWAN REALITY AIZUWAN REALITY!!!!! <3<3<3<3<3<3<3<3<3<3
Maylaf Fayza	Sakura san🖤🖤
Enitsuj Raniaj	HYEWON KANGCHAAAAN <3
おた	なんのティザー何ですか？
아이즈원12명꽃길만겄자	오아이즈원이다
Jes Inas	WHO LOVE SAKURA?  ME...
Jun Lee	장원영 눈썹 실화냐? 메이크업 미친거 아님? 저상태로 방송 내보냄?
itsalfred Time	IZONEEE FIGHTINGGGG!!!!
Jane W	0:24 Others' jumps look cool, pretty, shy, energetic...meanwhile Sakura looks dorky. 💕
Adam Kovic's Manscaper	R.I.P JUMPSHOT 😂
JumPer VampWolf	Sakuratan🌸🌸🌸
Kaye Jean	How many episode this gonna be?
HAWK信者もずく共和国	HiChan!
loonas nct	STAN LOONA
일본사는여자	원영이 흑발 돌려줘ㅠㅠ
식e	완전기대♥..♥
성하	25일이라.... 첫방하고 며칠뒤 데뷔곡 발표하고 정식데뷔 하는거구나...... .
hamstertreeAegi	Wheres my eunbiii
Pingu	미친다
Febry Maulana	Hii-chaaaannnn~ 😍😍😍
fatin yusof	NAAAAKO NAAAKO NAKOOOOO🎶🎶🎶
박모월	우와아아아아!!!!
유진파안	드디어 나왔다...
Amiratul Syifa	Omg cant waittt 😍😍
Fany Karina	I'm excited to see Yena and Yujin cuteness
Sand Game	カンちゃん カンちゃん カンちゃん カンちゃん カンちゃん😍
Zelika Rizky	AAAAAAAAA CAN'T WAITTTTT
Viri Hdz	Sakura !!!!!! 🌸🌸🌸🌸🌸🌸
PAO48 Production.	Baby hiichannn
마요	이뿌ㅜㅜ
Niel Kang	Sakura 🌸
KSJ	Yenaaaaaaa cuteee
BananaBread ACExChoice	HIICHAN OMG AJDBEJDKR I- I THINK. WAIT NO IM SURE IM GAY FOR HER SJDJEJRJJE UGHH I LOVEE YOU HITOMIIII 💛💛💛💛
ithebig S	Hiichan at the end~ im dead.
[WIZ*ONE]잘생긴왕자님	Sakura's face at the end 😂😂😂😂😂😂😂😂😂😂😂😂😂😂
Shiro Kuma	Eeeeeeeeeeeeeee~~~~!!!😍
Harukichi Hayashida	I feel attacked
이승현	*Korean power & japenese power❤*
남김랑영	으아아ㅏㅇ아ㅏ아아아아아 아직도 많이남앗자너
Nacko TS	드디어 리얼리티 날짜가 잡혔구나 빨리 보고 싶다~
yuris tiffany	HYEWON ❤️
taeyoon kim	Sakura 😂😂😂😂😂
Phát Chung Vĩnh	Hiichan so cute
santo santo	sakura memeing the whole 30 sec videos
Noor Ameera	Just how freaking long is Won young legs omg
Huxleyy	I can’t waittt 💞
pooh ntt	Hiichan love u ❤️❤️
La vi en Rose	Finally.. Yg ditunggu2.. 😭😭
Tommy Indra	HITOMI MY HEART CAN'T TAKE IT
angel perez	Hermosas ❤👏😍
พลิน สายปาระ	IZ*ONE❤
Chiyori's Chicken and Octopus	Flying Sakuraaaaaaaa
Shimazaki Cy	Omg omg thank you for the teaser but I can't wait anymore
nga chu	期待してる
Novika Rozali	아악 히토미 너무 귀여워서 기절 ㅠㅠ
Tozy Ulshif	Hyewon chuu is my life now
YEN YUL	uuuu yuri💋💋
1Z*0NE .etc	Sakura is lol..😂😂😂 Iz*one made my day again..
Dyah Angga Rini	LOVE ahn yujin..😍😍😍
Monita Supraharani	Hiichan 🍓😍😍
shanti kusuma dewi	My baby chaeyeon..... Fighting!!
Hoangduong mong	Hiichan ending so cute
Yves Saint Laurent	STAN LOONA CHUU
Arisa Aroha	*sees Hitomi* MY HEART
에이핑크사랑tv	헐 ㅜㅜ 기대된다
seed pumpkin	Hi~chan 🍓
Gfriend Yeojachigu	IZ*ONE Chu very very cute ♥♥♥
forever joy	LEE  CHAEYEON 😍😍
Lav.Ongniel	u CHUUU ヽ(*´з｀*)ﾉ Love you iz*one（*＾3＾）/～♡
ゆじ	yuri~❤️！
Potayo algija Hoppus	Fighting iz*one we love you very much😘😘😘😍😍
jjkmaqic	can't wait for it to air!!!
saranghe choijiwoo	오~~ 나이쓰 아이즈원~~~ 10월 25일 첫방 !!!
あま	Hitomi is too cute❣️❣️❣️🌈 Just like this group will be able to have fan !!!!💫🌼😍
邱冠蓁	0:24 Hichan OSAKA Glico😂😂😂 Sakura running is still funny lol
bad queen	lee chaeyeon love youuu ❤❤
ricsobo	Love from Brasil!
ˇ뚜밤	❤❣
OB1Jellopy	i think i love HITOMI more and more , fall in love~ HITOMI 💗  however, i still love YENA 😘  IZ*ONE CHU~
eunhae1419	sakura nako hitomi ♥️
p w c y s t u d y	히토미 😭💓💓
Kant Limpitaks	อมกกก น่ารักเว่ออออ
RAR 29	IZ*ONE CHU, IZ*ONE mu mana?  😂😂
tiffa - ARMY	CUTEEE
desty Rismayanti	Can’t mnet stop make sakura run? Hahaha But i can’t wait for this 😁😁
Leez Omar	Yes! I'm excited for this to be aired soon!
BTS JUNGKOXXX jung	I love I*ZONE 😍😍😍😍😍
ezzy estrella	I love you guys
Pannita Kwangnok	히짱ㅠㅠㅠ
彩果の宝石	最後のひぃちゃん鬼かわいい
Kim Dong In	Add engsub please ):
Reqzo	fighting
크	팬덤명 나왔네 ㅋㅋㅋㅋㅋㅋㅋㅋㅋㅋㅋ 아이원츄 !!!!!!!!!
Achanation 48	Ganbatte IZ*ONE... Especially Ahn Yujin..  Fighting..
T.S lukesm1976	Hitomi🍓😍💓💓LOVE❤️❤️
kek	I melted. Hiichan is so cute omg 😍😍
Phat Sea	Yujinnieeeee 🍋🍇❤
amellia ayu	Hitomi omgghh
WIZ* ONCE	Minmin's mind *I miss kriesha Chu*
syirafm	izone fighting!! wonyoung have a really nice body. Im jealous!!
keioboy sakurai	Wow. Hitomi's line and wink at the end made me like the teaser XD
Bimbim Toledo	Is chu thr title of their debut song?
쪽박사장	미쳐따
danu alkansa	Time to Save money for their album
채연이마음의호롤롤로로	채연이 머리 개이쁘다ㄷㄷ 아 그냥 이쁘다..
Earl Ezpeleta	Wonyoung looks different with that makeup, still pretty though
Dessrina Ismi	I can't wait really!!!
shiセキ	さくらたん🌸のジャンプ、笑った😍
DASOM CHANNEL	FINALLY.......❤❤❤❤
ho	Lee chaeyeoon😍 lets go girls this will be a bop!! 🎉 Omg hiichan at the end 🤩🖤
Amisa Ahmad	Cant wait for the variety show and iz*one debut! Love all of you 😘😘😘
ᄋ ᄋ	IZONE CHU 😘 か IZONE 中 ？ 日本語にあてはめたのかなww  楽しみが増えた〜〜！💗  本放死守！！！
문	i'm ready to see hyewon being her 4d self
BTS _Love	さくちゃん🌸♥️♥️
Teteng	Really excited for this.. Hoping for a hundred episode of this..💕💕♥  I can't take off the smile on my face.  HELPPP~~!  😂
Danni Thach	Omg so Izone stan Loona and their bias is Chuu wow taste
봄버튼	일본에서 요거 찍은거구나!
Rra Rari	顔面工事済みの方がいらっしゃいますね
Twice Izone	https://youtu.be/TldYfmeRh1s
jisoos christ	WERE NOT JOBLESS ANYMORE
설화	nako♡♡♡
Cheka Qobliansyah	Can't wait to see happy virus yena 💙💙ㅋㅋㅋㅋㅋ
mos moss	Nako so cute😍
cloud	that hitomi attack at the end >//////////<
วันนี้เเทยอน ไปLAหรือยัง	Hyewon😍😍😍💗💖💗💖💗💖💗💖💗💖💗
yoni ms	Waaaaaoooooo....thanks mnet, love my baby chaeyeon 😍
문스타팬	SO EXCITED 😍😍😍
ENO* ZI	막짤 꾸라 ㅋㅋㅋㅋㅋㅋㅋ
icci zind	Wonyounggggggg 😍
erenette	RIP ME.
Dudu Blanc	All of them why so cute...😍😍😘
lee happy	sakura😂😂😂she is so funny
CHAEYEONGIE	Chaeyeon my baby~ 😍😍💕
Cherrizone	Sakura's ending shot lol
Jena Mostajo	Hitomi as ending fairy 😍😍😍
はるみラブ	Love U all💕💕💕💕💕
Lutfi Khairi	Hiichan 😘😘😘😘😘
BTS Euphoria	hiichan wink in the end, made me scream xD soooo cute!!!!!!!!!!!!!!!!!!!!!!
Mina Nana Nako Saku Miu	nako nako so cute
프로악플러	나이으스슷ㅇ
WMMR1989 1989	Wonyoung!!! ><
Almond Gaming Indonesia	Kapan sih
밸브	히토미 '이'만 햇는데 귀여운거 실화냐
vkook trash	IZONE CHU LETS GO GAYS
ぴっぴ	사랑해요～💗！！！
so expensive	*IM READY*
Far East Mention Mannequins Español	Finally!!! I can't wait!!! ♥
ッStanHotaru	Miyawaki Chaeyeon 😍😍
Tasya Karunia	OMG IM SHOOK SO EXCITED
director.Lee	90's 감성 무엇;;
손나은	김채원, 저 양갈래 머리 박제 시키고 싶다 완전 취저임 (ㅠ_ㅠ)
May May	หื้อออออออ ใจไม่ไหวแล้ว
Na ya	Eunbi bi bi jangg
林波斯	oh my!! They are so cute!!!😍😍💕 By the way~~~ 00:24 Sakura's dorky face😂😂😂
bianca cahutay	OMFG  BABIEESSSS 😭😍💕💞💝💗💖
張萬鈞	Wonyoung 😍
Little Unknow	CAN'T WAIT OH MY GOD!!!!! 😱
ky lim	Sakura!!!!!,😍😍😍😍😍
ナツ.	Mnet私の家では見られなくて悲しいですㅠㅠ 日本から応援してます〜🇯🇵 아이즈원의 여러분을 사랑해요 ❤️
ShanaroTV	I can't wait!!!!
ㄱㄱㅇ	얘들아 가즈아ㅏㅏㅏㅏ
クリクリマクリ	リアリティ絶対みるよ  🌧💖🎶  イェナたまだいすし *\(^o^)/*
MissJiAh	*Hyewon Fighting* 🐹❤️
チョコパイ	Eunbi Eunbi Eunbi Eunbi Eunbi Eunbi Eunbi
violet Wang	Sakura🌸
T.E. YUN	나코 너 하는거 너무 귀엽다 우리즈원 대박나자!!!
끈끈이	네 함께할께요. 본방사수 ㅎ
Zoe Yip	Hiichan at the end!!!!!!!OMG!!!!
Rizky K	히 짱 츄 💕
Khofifah Indah	Kkura😍❤
wizone	REALITY FINALLY COMING
rios siros	원영이 눈썹 누가 밀어버렸냐???
Shayla	omg hyewon
Anti IZ*ONE	Dislike...
Flower knight_2209	HITOMI!!!!!!!!
Chan Sreyneang	I'm so excited to watch IZ*ONE CHU can't wait
수박여름엔	놓치지 않을게 ~
Patricia Kim	HIICHAN AT THE END UGGGGHHHHH 😍😍😍😍😍😍
Ducky Yena	OMGGG I'M SO EXCITED😍 CAN'T WAIT❣
Saki D.O	can't waittt 😭😭😭
徐晨阳	안유진 화이팅❤️❤️
Komik Geje Gintama	Izone fighting 💪💞
tomtommy	hiichan ㅠㅠ
도미에	헉헉 파오후 쿰쳑쿰쳑 기대감이 폭발한다 하악하악
YEPTOYS Channel	Cant waitttttttt
the Sky	Yesssssss 👏👏👏👏
ᄇᄆᄌᄌ	하나같이다예쁘냐 특히사쿠라
QIO MA	Sakura so cute😂😂❤️❤️
gelatttin	FIGHTING GIRLS!!!!!!!!!
박김	신난당 ㅎㅎㅎ 드디어하는구나
Won Yuna	IZ*ONE CHU ☺️💗  I can't wait for ite💗
Monica gbrn	YASSSSSS!!!!
なこ	Hiiiiii----chaaaannnn♡
hani dey	CANT WAITTT
ʆɩŋŋ cɾaʑʏ	AAAAAA
widiya nurhasanah	I cant wait
zeemayufan z33	IZ*ONE CHU, can't wait!! O.m.g i'm so excited 😆😆
keyin li	Sakura~
나리수야	ㅁㅊㅁㅊㅁㅊㅁㅊㅁㅊㅁㅊㅁㅊㅁㅊㅊㅁ미쳤다
mazinger dude	이게 나라다
alen0069	엌 저번에 일본가서 히토미네 동네갔을때 찍었나보군요 ㅋㅋㅋ 근데 밤에 잠못잤나 좀 부은듯한 ㅋ
Agung Fidi	Finallyy yeyyyy😭😭😭😭
크크크크킄	목요일밤 11시 개꿀이다 시간대ㅋㅋ
전두찬	막판 히토미 미쳤다 ㅠㅠㅠㅠ
Ginny V	Haha Sakura jump meme =)))))))))))
꾸라쿵	Sakura don't run, just don't run 😅😂😂😂
Ashleyy C	i was so excited seeing this, that  tears when out... just seeing this.... thank you iz*one😢
jonh shina	oh my god good good
홍순규	화이팅~~
Cool1 Awesome2	Sakura being a meme again😂
weera warakul	ฮี่จังงงงงงง
orenjis	Finally!!!
wow huyan	Sakura😘😘😘
무 무	워녕아 사랑해 ㅋㅋ
chanoknan somsamrankun	my babies i'm crying T_T can't wait for it y_y
kx S	When Kkura run or jump never fail to make me laugh 😂 I'm not anti-fans 😉
주사랑	OMg!!!😭😭😭❤️❤️❤️❤️❤️
Brazilian Feather	LEE CHAEYEON!!!!!!!
Carpe Diem	pff😒😒😒😒😒😒😒😒😒😒
Podopineapple	Hitomiiiiiii daheeeeyaaaaaaa i love youuuuuu 💞💞💞💞💞💞💞💞💞💞💞
Manisha Panigrahi	Chaeyeon
Yui Zoldyck	Fighting!! Ganbare!! Iz*one❤️❤️❤️❤️
Fiki Aang Sunjaya	Yes! Finally 🤗
사과귤	YENA💕💕💕
Stay With IOI 11	FINALLY THIS WHAT I NEED THANK YOU VERY MUCH
MaruChan 39	OMG 😱 😱 OMG 😱....izone CHU 😍... hahahah 0:24 Sakura derp face made my day 😆
Tae uk Kim	크으~ 이거지~!!!! 기다렸사옵니다! 앚둥이들! ㅋㅋㅋㅋㅋ
장원영_heart	Finally😭😭😭 legit tears😭😭😭
박혜진	사쿠라 ㅋㅋㅋㅋㅋ
TW Jong	仁美😍😍😍
gay for IZ*ONE	I-IZONE C-CHU?
david7 D	히토미 막판 심쿵~
cheol yi cho	드뎌.. 나오는구나. 히토미 귀여워.
김비블썸프	헐 대박 떴다 떴어 ㅜㅠㅠㅠㅠㅠㅠㅠ 얘들아사랑해♡♡♡♡
Ngọc Thuy	Sakura at the ending 😂 idk her 😂
Katelyn Son	♥️♥️♥️♥️
Du Portnoy	Order more popcorn..... Lets get it.  😎😎😎😎😎
watasiwa bebe	I'm not ready 😭😭😭😭 my girls finally 😭😭😭😭
토토김	아 예고 올리니까 25일 전까지 세 배로 시간 느리게 가자너 ㅠㅠㅠㅠ
오잉	빨리해주라ㅠㅠㅠㅠㅠㅠ
39saku_ fuyan	sakura
Dian Kumalasari	Hiichan at the end is so lovelyyy
Rena G	Sakura chan <3
The Musician Me	Oh God! Hiichan is killing me!!! And guess who's replaying this for the rest of the day?!
Aldrin Only	Sakura’s derp face while jumping. 😂😂😂
W Nadhila	0:24 oh sakura
Mike O'Sullivan	Chuuuuu
Janey Jane	I'm so excited😍😍😍
IZONE chaeoni	izone❤️❤️❤️❤️❤️
Rahma Watanabe	Sakuraa 😂
_Niq_ 2401	IZ*ONE CHU 😙😙😙 I can't wait for it tho 💕 (25/10/18)  Fighting IZ*ONE 💕
IMK	I CANNOT WAIT
dc 1004	대박 ㅠㅜㅠㅠ애들아ㅠㅠㅜ
Felia Agatha	Oke i can't wait for their debut!❤️
허밍	20181025 2300
Sharpay Kim	YEAY WE ARE NOT JOBLESS ANYMORE
고든프리먼	너!! 낄낄빠빠 해라
肉丸	張元英眉毛是發生甚麼事
Kriztan San Jose	Now here I am hoping they'd do a Korean version of Heavy Rotation, the show title is probably from Heavy Rotation's lyrics "I want you"
Ranggadhan	gue kira teaser debut :((
Tranh Doan	I cryyyyyyy
굿그린	소리벗고 암튼질러ㅓㅓㅓㅓㅓㅓㅓㅓㅓㅓ
HelpMePlz	떳다--
jins blowkisses	KWON
Yuki Nagato	키타아아아아아아ㅏ아아아아아KITA WWWWWWWWWWWWWWWWWWW  キタキタキタキタ
이대휘	可愛すぎてしんどい笑
Tjo	드디오 아이즈원의 리얼리티쇼!
SPeCialXPan3	ひいちゃん大好き😊
Chaepuggie -Ah	IZ ONEE I'M BRASILIAN
Donh Wonh	....why am i so excited for this.... now time to re-watch more produce 48...till they debut    i cant wait
YURU H	아직도 멀었자나 ㅜ.ㅜ
AlifahRamadhani Alifah	Love youu korea👀❤❤
Juulia Saarinen	0:00
장원영팬채널	미친 ㅠㅠㅜ사랑해요
Raiko Kang	*IZONEEEEE*
김태수	사쿠라♥♥♥♥♥♥♥♥♥
jiwoo ming	OMG I CANT WAIT
Sra. choon-hee	Love
