Trung Hoang	miá»n Báº¯c ngta gá»i lÃ  viruss Ä‘ag nhÃ¨
Tháº¯ng Hoang	virus cáº£ video chá»‰ cÃ³ vÃ£i cáº£ ná»“i :))
NNK OFFICIAL	Viruss nhÃ¬n gáº§y quÃ¡!
Bill :v	Äáº¡n vá»›i ná»“i bay lung tung :3
Phyyy	1 mÃ¬nh PhÆ°Æ¡ng Ly ngá»§ chung vá»›i 5 Ã´ng....
Tung Phan	Just vÄƒn láº¯m =))))
News4Game	RÆ°á»£u gÃ¬ Ä‘Ã¢y má»i ngÆ°á»i  ???
su hao	Äoáº¡n cuá»‘i video em thays nÃ³ bÃ¬nh yÃªn vÃ  dá»… chiá»‡u sao áº¥y
VIP Boy	4:23 Sáº¿p Tee gáº¯t vcl ^^
The Darkslayer	gáº§y tháº¿ uá»‘ng nhiá»u váº­y cÃ³ á»•n ko anh uá»‘ng cÃ¡i nÃ y nhiá»u ko tá»‘t Ä‘Ã¢u a
Era Barrela	Tee say xong cute vcl ğŸ˜‚
community BIGO	MÃ©o hiá»ƒu máº¥y Ã´g uá»‘ng rÆ°á»£u gÃ¬ chÆ¡i toÃ n ly to váº­y 100% k say.hay uá»‘ng sochu
Nguyá»…n ChÃ­ HÃ¹ng	Ã´ng vÃ£i láº¯m tháº¿ :))
Duy Tan Vo	MÃ©, Ã´ng Tee cÃ³ khi nÃ o cháº¥p háº¿t Gaming House cá»§a a Rá»›t k ta =))
DÆ°Æ¡ng SÃ³i	Vl Ã´ng kia riá»‡u vÃ o lá»i ra sá»£ tháº­t ğŸ˜‚
Ke Tama	Xem videi nÃ y t láº¡i nghÄ© Ä‘áº¿n má»™t bá»™ phim cÃ³ tÃªn lÃ : 2 chÃ ng trai may máº¯n vÃ  cÃ´ gÃ¡i ngÃ¢y thÆ¡ :))))
TrÆ°á»Ÿng Nguyá»…n	anh viruss cáº£ ngÆ°á»i cÃ³ 5 que cá»§i mÃ  báº¯t uá»‘ng nhÆ° tháº¿ Ã 
rock star	Thanh niÃªn tee say xong láº§y quÃ¡ :v
LÆ°á»ng Äá»©c Háº£i	Cho m há»i rÆ°á»£u mn uá»‘ng lÃ  rÆ°á»£u gi váº­y ?
Nguyen Duy	BÃ¡ láº§y ğŸ˜’
Ã”ng Ná»™i TFT	tá»™ii Ã´ng viruss vÄ‘ ğŸ˜†ğŸ˜†
TomTom Tom	Tháº­t ra uá»‘ng rÆ°á»£u khÃ´ng ngÆ°á»i lÃ¡i tháº¿ nÃ y gáº¯t láº¯m.
à¼„PhÃšc VÄƒNà¿[BeN Tá»“] Mobile	Tee nÃ³i nhÆ° chá»§ video Ã­ rÃ²i :))
lÃª tuyÃªn hoÃ ng	vui nhá»‰ , tá»± nhiÃªn cÅ©ng muá»‘n nháº­u phÃ¡t :) <3 !!!  p/s : Anh viruss gáº§y kinh khá»§ng , Gym gá»§ng Ä‘i a Æ¡i
Sougisha 792	Táº­p gym cÃ¹ng xeme kÃ¬a a =)))))
Tuáº¥n Kulbill	Viruss dáº¡o nÃ y á»‘m quÃ¡ cá»‘ gáº¯ng Äƒn uá»‘ng vs táº­p gym Ä‘i nhaa
k t	Ã´ng justatee nÃ³i nhiá»u vÃ£i cáº£ Ä‘áº¡n
Thá»‹nh HoÃ ng	Bá»‹ kÃ­ch vcl
thanhsuong nguyen	a gáº§y quÃ¡ kÃ¬a Äƒn uá»‘ng Ä‘á»u Ä‘á»™ y
Quyá»n cuá»‘n	trÃ´ng kiá»ƒu kia lÃ  bt rÆ°á»£u nháº¹ tÃªnh r
Gamer Funny	Thá»­ thÃ¡ch tÄƒng cÃ¢n Ä‘i Viruss
Nguyen Trong Hau Gaming	HÃ³ng chÃº LÃ¢m bÃ i má»›i ğŸ¤£
Yolo Polo	VÃ£i cáº£ ná»“i áº¡ :V cÃ¢u tá»§ khi say
CÃ´ng tÃ¬nh Äá»—	gáº§y quÃ¡ a Æ¡i.. cáº©n tháº­n sk nhÃ©
Gia Lam	giá»¯ giá»ng anh Æ¡i
Kenzo _Tiger	BÃ  phÆ°Æ¡ng ly uá»‘ng rÆ°á»£u nhÆ° uá»‘ng nÆ°á»›c tháº¿ kiağŸ˜±ğŸ˜±
DesTroy TV	Tháº±ng Ä‘iÃªn nÃ³i Ä‘Ãºng rá»“i.. k bh Ä‘c nÃ³i share Ä‘á»ƒ uá»‘ng nhÃ©
an Ä‘oÃ n ngá»c	Ã  Ã´ng mÃ  trong mv áº¥y lÃ  Ã´ng nÆ°á»›c ngoÃ i
Bowser Chan	Ã‰p rÆ°á»£u gáº¯t VC
ThÆ°Æ¡ng Nguyá»…n	PhÆ°Æ¡ng ly Ä‘Ã¢u r ??
Best Music & VSCO Formulas	. Máº¥y Ã´ng Ã´m nhau ngá»§ kÃ¬a :v
Duk Sun	ThÃ­ch nháº¥t lÃºc Justatee kÃªu Ä‘á»«ng máº·c cáº£ vs khÃ¡n giáº£
ÄoÃ n BÃ¡ Minh	Justa Tee bá»­a coi khÃ´ng cay ko ghá» Ä‘Ãºng Ã­t nÃ³i ... nháº­u vÃ´ nÃ³i Ä‘Ãºng nhiá»u :))))))
HÃ n Linhhh	ChÃº Váº¡n Ä‘Ã³ng MV tháº±ng Ä‘iÃªn Ã  :v
Luong Nguyen	Ko nÃªn quay cáº£nh uá»‘ng rÆ°á»£u, sá»£ bá»n tráº» nÃ³ nghá»‹ch theo.
thai nguyen	MÃ¡ Ã´ng virus vá»›i Ã´ng Ä‘á»™i nÃ³n láº§y vc
FRIZZY HAIRY	NhÃ¬n viruss á»‘m vÃ£i ná»“i ra MÃ¡ Ã”ng coi lÃªn cÃ¢n dÃ¹m tui lÃ m nghá» cho sung coi nÃ o :)))
Äá»— Duy Äá»©c	GhÃ©t nháº¥t thá»ƒ loáº¡i báº¡n ko biáº¿t uá»‘ng ma Ã©p gáº·p t cho sáº¥m máº·t
Tráº§n Tiáº¿n TÃ¢m	Viruss lÃ¡t rÆ°Æ¡Ì£u :))
TÃ¹ng LÃª	T nháº¥m Ä‘Ã£ say r mÃ  jus chs háº³n 2 Äƒn 1 :))
Thiá»‡n ThÃ nh	rÆ°á»£u hÃ n quá»‘c uá»‘ng ko cay nhÆ° rÆ°á»£u vn Ã 
tao thÃ­ch tÃªn ngáº¯n nhÆ°g tÃªn nÃ³ cá»© dÃ i	e thuá»™c cáº£ bÃ i tk Ä‘iÃªn r kakakak
CÃ´n Aladin	Anh tee láº§y vÃ£i cáº£ ná»“i nha giá» mÃ­ biáº¿t
SÆ¡n YT Gaming	Anh justatee Ä‘ang rÆ°á»£u nÃ³i chá»© k pháº£i tá»± nÃ³i
Äá»©c Trung Tráº§n	Gáº§y quÃ¡ rá»“i anh Æ¡i, giá»¯ gin sá»©c khá»e a nha
marmotdragon	NÃ¡t =)))))
Mr.Stoner	" VÃ£i cáº£ ná»“i áº¡" :)))
ÄÃ´ng Pan	A hoÃ ng nhÃ³m mÃ¡u O thÃ¬ pháº£iğŸ˜‚ğŸ˜‚ğŸ˜‚ğŸ˜‚
DoÃ£n ChÃ­ BÃ¬nh	ThÃ­ch nháº¥t nháº­u vs gÃ¡i:say dá»… Ä‘c chá»‹ch
LUÃ‚N NGUYá»„N	Ã”ng viruss uá»‘ng ghÃª tháº­t
Hoang Nguyen	how to dáº¡y con =))))))))))))
Anh Dv	Viruss da bá»c xÆ°Æ¡ng ah
Nguyá»…n DÅ©ng Sá»¹ FC	Tao tháº¥y tháº±ng say lÃ  tháº±ng Ã¡o Ä‘en, bÃ¢y giá» nháº­u cÃ²n Ã©p, máº·t thÃ¬ vÃªnh vÃªnh,
Rinmoto Akyramoto003	Uá»‘ng xe khÃ´ng Ä‘Æ°á»£c lÃ¡i bia
Morrin Channel	NhÃ¬n máº·t Viruss tá»™i vÃ£i cáº£ Ä‘áº¡n
Thanh Nguyen	cÃ´ng nháº­n ngÆ°á»i cÃ³ gia Ä‘Ã¬nh chÃ­n cháº¯n thiá»‡t
Heyy Lovee._.	Anh á»‘m quÃ¡aa rá»“i, giá»¯ gÃ¬n sá»©c khoáº» nha anh.
NamSTM Fc	Chac 3 4 chÃ©n thÃ´i:-):-):-)
Cuong Ho	NhÃ¬n máº¥y báº¡n tháº¥y zui ghÃª. Xá»‰n vÃ o tá»± nhiÃªn luÃ´n ğŸ¤£
Lala ÄoÃ n	virrus gáº§y gÃª
Mai Son	ChÃº láº¡i k ná»ƒ anh ğŸ¤£ğŸ˜‚
Thu Hoai Tran	Láº¡y Ã´ng Tee :))))
Há»“ng xáº¡o loz	Ã”ng Ã¡o xanh nhÆ° Ã´ng Ä‘iÃªn
Háº£i Hot Channel	Uá»‘ng riá»‡u tráº¯ng lÃ  pháº£i chai CoCa Ä‘Ã¢y Äƒn thua gÃ¬
black blue	Anh gáº§y quÃ¡
kamaitachi rei	Chao Ã´i, hÃ´ 100% thÃ¬ nháº¥p mÃ´i, ngÆ°á»i k hÃ´ j thÃ¬ uá»‘ng háº¿t.
NNFS	Ai tháº¥y Viruss thÆ°Æ¡ng vcl k =))))
DuyThanh To	GhÃ©t nháº¥t máº¥y tháº±ng Ä‘i Ä‘Ã¢u cÅ©ng Ä‘eo cÃ¡i tÃºi,xong ngá»“i Äƒn cÅ©ng Ã´m cÃ¡i tÃºi Ä‘Ã©o pit cÃ³ cÃ¡i máº¹ j ko mn nhá»‰ :)))
Kháº¯c Nguyá»…n	NhÃ¬n anh vr trÃ´ng hiá»n lÃ nh nhÃ¬n cÃ³ cáº£m tÃ¬nh ghÃª
Thanh Bui	Káº¿t em gÃ¡i quÃ¡
Háº¡nh Herry Official	Anh Viuss gáº§y quÃ¡ a Æ¡i, tÄƒng cÃ¢n Ä‘i cho Ä‘áº¹p hÆ¡n áº¡
Trang Pham	Äm tháº±ng hoÃ ng nhÆ° da bá»c Æ°Æ¡ng Ã½
ÃŸee TV	Ai tháº¥y virus giá»‘ng hÆ°Æ¡u cao cá»• khÃ´nggg
Bumble Bee	ThÃ­ch PhÆ°Æ¡ng Ly vÃ£i
tu anh	cá»© â€œvÃ£i cáº£ ná»“iâ€ ??? -.-
Hung Tran	Li thá»© 14 nháº¥p nháº¥p thÃ´i, khÃ´ng tÃ­nh nhÃ© :)))
Do trinh	Thnh niÃªn Tee uá»‘ng tÃ½ rÆ°á»£u vÃ o triáº¿t lÃ½ vl :))
Phi	CÃ³ 14 chÃ©n thÃ´i Ã¡
Ká»³ VÅ©	Bá» giÃºp cÃ¡i tÃºi ra cho bá»›t swag cÃ¡i Tee Æ¡i...Äƒn uá»‘ng mÃ  Ä‘eo cÃ¡i Ä‘Ã³ ko tháº¥y gÆ°á»£ng gáº¡o Ã ?
linh nguyenmanh	PhÆ°Æ¡ng Ly Ä‘áº¹p gÃ¡i láº¡i cÃ²n uá»‘ng giá»i nhá»‰
BÃ¹i Thá»‹ Biá»ƒn	vá»£ ly uÃ´ng giá»i tháº¿ nhÆ°ng xinh váº«n chá»§ yáº¿u :3
Do Manh Cuong	rÆ°á»£u sochu Ã  :))
Free Max	Ã´ng tee nÃ y hay Ã©p vs má»i ae uá»‘ng lÃ  ko Ä‘c Ä‘Ã¢u nhÃ©, rÆ°á»£u bia ai uá»‘ng Ä‘c thÃ¬ uá»‘ng Ä‘á»«ng Ã©p nhau nÃ³ máº¥t vui :)) vui thÃ¬ cÃ¹ng nhau uá»‘ng nÃ³ má»›i thoáº£i mÃ¡i
LÆ°Æ¡ng Viáº¿t Quang	Tee chuáº©n lÃ½ uá»‘ng rÆ°á»£u rá»“i.PhÆ°Æ¡ng Ly má»›i vÃ o quáº¥t máº¥y chÃ©n liá»n cÅ©ng gáº¯t lÃ m Viruss hoáº£ng ğŸ˜‚
Tuáº¥n VÅ©	HÃ i vÃ£i.kkkk láº§n sau Ã´ng HoÃ ng chuyá»ƒn ngay rÆ°á»£u náº·ng hÆ¡n Ä‘á»ƒ Ä‘á»¡ pháº£i uá»‘ng nhiá»u. Sáº¥p máº·t ngay tá»« máº¥y chÃ©n Ä‘áº§u luÃ´n kkk
MÃ n ÄÃªm XÃ£ Tan	E nÃ³i tháº­t,  uá»‘ng thua cáº£ con gÃ¡i,  a hoÃ ng kÃ¬ qÃ¡ Ã h nghen ğŸ˜ŠğŸ˜ŠğŸ˜Š
Háº£i Tráº§n	E cÅ©ng kh biáº¿t uá»‘ng giá»‘ng ah, e uá»‘ng máº¥y ly lÃ  máº·t Ä‘á» nhÆ° trÃ¡i á»›t lun :)) cÃ³ ai khÃ´ng biáº¿t nháº­u khÃ´ng kkk
nam lÃª	NhÃ¬n tháº­t lÃ  vui
Kt Jun	Tá»¥i nÃ y cháº£ bao h cÃ³ tÃ¬nh báº¡n chÃ¢n tháº£nhh. ToÃ n lá»£i dá»¥ng rá»“i tÆ°Æ¡ng tÃ¡c cáº£ thÃ´i. LÃ m cÃ¡i lá»“n ji cÅ©ng Ä‘Äƒng
ke La	Uá»‘ng váº­y cháº¥p trc 1 cá»‘c :))
MaÌ£nh TuÃ¢Ìn TrÃ¢Ì€n	VÃ£i cáº£ ná»“i áº¡, vÃ£i cáº£ ......
Nam Tenshi	ToÃ n ná»“i vá»›i Ä‘áº¡n ((= CÆ¡ mÃ  nhÃ¬n a gáº§y quÃ¡... Nhá»› táº©m bá»• nha a :3
Nguyá»…n ThÃ¹y Dung	-a viruss mÃ  táº­p gym tÄƒng cÃ¢n... cháº¯c Ä‘áº¹p trai láº¯m Ä‘áº¥y ğŸ˜ŠğŸ˜ŠğŸ˜Ša áº¥y gáº§y quÃ¡ Ã  :))) chá»‹ PhÆ°Æ¡ng Ly â¤ï¸â¤ï¸â¤ï¸idol cá»§a lÃ²ng má»‹!!! Ä‘Ãºng xinh luÃ´n...nÃ©t Ä‘áº¹p áº¥y :3 chu cha... Æ° hÆ° hÆ° á»§ng há»™ chá»‹ Ly Ä‘Ã³ng phim ğŸ˜ŠğŸ˜ŠğŸ˜Š
Lá»±c Nguyá»…n	Sau Ä‘Ã³ say cáº£ cháº¥y :)(
KiY PDA	khi nÃ o vá» tui cho uá»‘ng ko quÃ¡ 1 cá»‘c ğŸ˜ğŸ˜
Tráº§n 627dz	NÃ¡tttt :))
ThÃ¡i HoÃ ng	Jay Tee chuáº¿nh choÃ¡ng láº¯m r. NhÆ°ng váº«n cá»‘ tá» ra lÃ  mÃ¬nh á»•n ğŸ˜Œ
James Vlogs	Ai sub chÃ©o kh
Huy Ahihi	combo ná»“i liÃªu boom Ä‘áº¡n
TM C	Anh quay cÃ³ ngá»“i chung ko váº­y
Khai Duc	xem tá»« Ä‘áº§u Ä‘áº¿n gáº§n cuá»‘i nhÆ° lÃ  1 buá»•i nc bÃ¬nh thÆ°á»ng khÃ´ng cho mÃ¬nh cÃ³ áº¥n tÆ°á»£ng gÃ¬... nhÆ°ng xem Ä‘áº¿n khÃºc cuá»‘i má»i ngÆ°á»i náº±m lÃª láº¿t tiáº¿ng nháº¡c vang lÃªn thÃ¬ lÃºc Ä‘Ã³ khi nhÃ¬n VR.. mÃ¬nh cáº£m tháº¥y Ä‘Æ°á»£c sá»± cÃ´ Ä‘Æ¡n cá»§a anh nhÆ° anh chia sáº» Ä‘áº¿n láº·ng ngÆ°á»i vÃ  ná»•i cáº£ da gÃ ..  vÃ  nháº­n ra ngay sau Ä‘Ã³ má»i cá»‘ gáº¯ng cá»§a anh Ä‘Ã£ gáº·t hÃ¡i Ä‘Æ°á»£c thÃ nh cÃ´ng vá»›i sáº£n pháº©m Ä‘áº§u tay, vÃ  cÃ³ nhá»¯ng ngÆ°á»i báº¡n bÃªn cáº¡nh! chÃºc má»«ng anh vÃ  mong anh cÃ³ sá»©c khoáº» Ä‘á»ƒ tiáº¿p tá»¥c lÃ m viá»‡c!!
Äáº¡t Donald	VÃ£i cáº£ Ä‘áº¡n ))) VÃ£i ná»“i áº¡k ^^ --- thÃ¡nh VÃ£i + thÃ¡nh nháº­u nÃ³i nhiá»u justatee
dalsi pl	a viruss gáº§y tháº¿ nhá»??nhÃ¬n mÃ  xÃ³t giÃ¹m ghÃª
Duc Quach	Anh vr buÃ´n Ä‘an vá»›i ná»“i Ã  ae. Hay cÃ³ hÃ£ng ná»“i Ä‘áº§u tÆ° viedeo váº­y ğŸ˜‚ğŸ˜‚ğŸ˜‚ğŸ˜‚
Long LÃª ThÃ nh	Ly xinh wa
TÃº Nguyá»…n	yÃªu a justatee ghÃª, láº§n Ä‘áº§u Ä‘Æ°á»£c xem 2 a uá»‘ng r
Movie Channel	ThÃ¡nh vÄƒn uá»‘ng rÆ°á»£u Justatee :v
Toan DÆ°Æ¡ng	NÃ¡t
trithuc nguyen	anh viuss gáº§y vÃ£i cáº£ Ä‘Ã¡i rÃ¡ng Äƒn nhÃ¬u lÃªn vs táº­p gym nha anh
VINH NGUYEN	ko pháº£i riá»‡u lÃ  nÆ°á»›c.tháº±ng lá»«a Ä‘áº£o,Äá»ŠT Máº¸ MÃ€Y.BÃ” tiÃªn nhÃ¢n mÃ y.;KÃŠNH YOUTUBE Cá»¦A MÃŒNH LÃ€ VINH Äáº¸P TRAI NHA AE VÃ€O á»¦NG Há»˜.OK MAN
CÃ´ bÃ© quÃ ng khÄƒn Ä‘á»	vÃƒi cáº£ ná»“i áº¡ ğŸ˜„
Anh TÃº LÃª	VÄƒn vá»Ÿ vlin =))
G Toilatrinh	Ui Tee uá»‘ng ghÃª vl Vr chá»¥i thÃ´i ğŸ‘ğŸ‘
Tiáº¿n HoÃ ng Tráº§n	Justatee vÄƒn vÃ£i =))))
trang Nguyá»…n	ÄÃ³i thá»‘i háº¿t cáº£ má»“m ra. Vl Ã´ng Tee
Thu PhÆ°Æ¡ng	*_BÃ  Ly xinh gheee :3_*
DÆ°a ARMY	Anh Viruss dáº¡o gáº§n Ä‘Ã¢y anh á»‘m quÃ¡, nhá»› Äƒn nhiá»u vs láº¡i giá»¯ gÃ¬n sá»©c khá»e nha anh. á»m váº­y em lo láº¯m
Anh Long Nguyá»…n	MÃ¬nh ko biáº¿t Ã´ng Ã¡o Ä‘en lÃ  ai. NhÆ°ng mÃ  mÃ¬nh ngá»“i nháº­u mÃ¬nh ko thÃ­ch kiá»ƒu ngÆ°á»i cá»© xem ly rÆ°á»£u lÃ  quan trá»ng nháº¥t. Rá»“i so Ä‘o, báº¯t báº» ngÆ°á»i ta. MÃ¬nh ko pháº£i fan viruss ... NhÆ°ng cáº£m tháº¥y máº¥t vui
Khá»Ÿi Viá»‡t	Anh tee nÃ³i chuyá»‡n nge thÃ­ch tháº­t
My Boss	Máº¥y chÃ©n Ä‘áº§u uá»‘ng cá»© cáº§m cÃ¡i bÃ¡t
Trouble Maker	"Biáº¿t lÃ m con khá»‰ ko?" =))))).
Tung Lee	Ã´ng virus gáº§y chá»‰ sau Lynk Lee  nhÃ¬n sá»£ vl, vá»— bÃ©o Ä‘i a Æ¡i
chiáº¿n nguyá»…n	Trong bÃ n nháº­u. Jus lÃ  ng u Ä‘c vÃ  cÃ ng u cÃ ng nÃ¡t ğŸ˜¬ğŸ˜¬ Vr lÃ  ng biáº¿t u vÃ  giáº£ vá» say k u Ä‘c. VÃ  Ä‘áº¿n khi tá»›i táº§m . CÃ ng u cÃ ng vÃ o ğŸ¤£ğŸ¤£ Ly lÃ  thÃ¡nh diá»‡t má»“i Tháº±ng Ä‘iÃªn lÃ  thÃ¡nh nÃ© trÃ¡nh nháº¥p mÃ´i ğŸ˜†ğŸ˜†
Leuleuleuleu Leuleu	TÃªn Ä‘oáº¡n nháº¡c Ä‘áº§u lÃ  gÃ¬ váº­y áº¡ ? MÃ¬nh cáº£m Æ¡n hihi
Hoang Nguyen Minh	Ah Æ¡i.cÃ¡c ah cj uá»‘ng rÆ°á»£u hÃ n hay sao váº­y áº¡.
ToÃ n Nguyá»…n	Viirus say nÃ³i nhiá»u vÃ£i
ÄÃ o Thanh TÃ¹ng	Quáº£ áº£nh nÃ¡t rÆ°á»£u ğŸ˜†ğŸ˜†ğŸ˜† NhÃ¬n chá»‹ Ly náº±m tháº§n thÃ¡i vl ğŸ˜†ğŸ˜†ğŸ˜†
Nháº­t Nguyá»…n	Xin link nháº¡c vs mnq Æ¡i!!
NYL YEAH	Best Tee
Nhung NgÃ´	Ã´ng tee say
ThÃ nh Nguyá»…n	Hai Ã´ng Kia Ã´m nhau ngá»§ :))
Tiá»ƒu ngÆ° nhi Hs	CÃ²n sá»©c khoáº» má»›i kiáº¿m tiá»n Ä‘c nhe Ã´ng. Ã”ng bÃ  Ã´ng cÅ©ng trÃ´ng Ã´ng tá»‘t Ä‘áº¹p vÃ  vui váº» láº¯m nhÃ¡.
PII LYRICS	3:06 báº¯t Ä‘áº§u tháº¥m láº§n 2 Ã´ng báº¯t Ä‘áº§u xá»• lá»i :v
SWAG CAT	"VÃ£i cáº£ ná»“i áº¡"
hung nguyen	2 chÃ©n cuá»‘i nháº¥p kiÃ aaaa
nbees	tÃ¡n PhÆ°Æ¡ng Ly Ä‘i a :D
Garena LiÃªn QuÃ¢n Mobile	RÆ°á»£u nÃ y nháº¹ thÃ´i, rÆ°á»£u Ä‘áº¿ á»Ÿ quÃª xem 2 chÃ©n nÃ¡t há»ng
áº¾ch Phá»Ÿn	VÃ£i cáº£ vÄƒn rÆ°á»£u
Tháº£o LÃª	VÃ£i cáº£ ná»“i áº¡ !!!
Hoa Nguyen	Ã”ng Viruss yáº¿u tháº¿ Ä‘á» máº·t nhanh hÆ¡n Just
ÄÆ°á»ng HÃ­p	Just nÃ³i hay nÃ¨ Virussss cá»© vÃ£i cáº£ ná»“i,vÃ£i cáº£ Ä‘áº¡n :))))
CÆ°á»ng BÃ¡ch Vlogs	Uá»‘ng song rá»“i 3:1
X Gá»i Yamix lÃ  Háº§u Ca	PL xÄ©n roi láº¡i chiáº¿m lay Linh Hon di
Hiá»n Nguyá»…n	Zui quÃ¡ xÃ¡ mÃ . Má»i ngÆ°á»i tiáº¿p tá»¥c á»§ng há»™ 3 anh chá»‹ nÃ o. MÃ  anh VRus hÆ¡i gáº§y, anh Æ¡i Äƒn uá»‘ng nhiá»u vÃ o anh nhÃ©
Lee Baro	VAÌƒI CAÌ‰ NÃ”Ì€I =)))))
HÆ°ng BÃ¹i Anh	VÃ£i cáº£ tee phong cÃ¡ch bá»£m nháº­u vÃ£i :)))
VÄƒn Äá»“ng	Ä‘á»ƒ nghá»‹ youtube cÃ³ nÃºt haha :))
Quang ÄÃ´ng VÅ©	VÃ£i cáº£ ná»“i aaaaaaáº¡
Trang HoÃ ng Linh	ai biáº¿t nháº¡c ná»n Ä‘áº§u video lÃ  gÃ¬ khÃ´ngg
sÆ¡n hÃ 	Jus Ä‘Ãºng chuáº©n cÃ¡ch uá»‘ng rÆ°á»£u vÃ  nÃ³i chuyá»‡n trong bÃ n rÆ°á»£u cá»§a ngÆ°á»i miá»n báº¯c :))))
DrKenD Lee	Ly dá»… thÆ°Æ¡ng quÃ¡ ğŸ˜ğŸ˜ğŸ˜
TÃ¹ng Aka	Chá»‰ cÃ³ vÃ£i cáº£ ná»“i hÃ¡ hÃ¡
Lighting Zed	nÃ³i nhiá»u mÃ  to vkl
Kunka ND	Ã´i lily uÃ´Ìng maÌ Æ°Ì‰ng lÃªn xinh vaÌƒi :D
Báº£o Nguyá»…n Há»“ng	CÃ´ng nháº­n Ã´ng just bá»‹ tháº§n rÆ°á»£u nháº­p nÃ³i vá»›i nhÃ¢y vcl
Toan Vu	Má»i bá»£m rÆ°á»£u thÃ¬ anh cÅ©ng pháº£i bá»£m cÃ¹ng chá»©. Cá»© uá»‘ng cho gá»¥c luÃ´n thÃ¬ thÃ´i. NhÃ¬n buá»“n quÃ¡ anh :(
Quangduong Chu	Muá»‘n xem láº¡i cáº£ cÃ¡i talk show kiá»ƒu gÃ¬ bg ???
Sam Sam	Äoáº¡n cuá»‘i táº¥t cáº£ náº±m ngá»§ trÃ´ng dá»… thÆ°Æ¡ng tháº¿ trá»i . TrÃ´ng nhÆ° há» lÃ  ngÆ°á»i má»™t nhÃ  váº­y Ä‘Ã³ hiu hiu
Anh Vuong	Tee hay quÃ¡ tee Æ¡i . Báº£ Ly thÃ¬ yÃªu quÃ¡ trá»iiiii
Máº¡nh HÃ¹ng	Justatee number one.
Quá»‘c HoÃ ng	PhÆ°Æ¡ng LyğŸ’œ
Quá»³nh Hoa LÃª DÆ°Æ¡ng	"tÃ´i sáº½ che chá»Ÿ cho Ã´ng"ğŸ˜‚
HA CHEESH	A tee gáº¯tğŸ˜‚
Gaming Experience	Ã”ng Tee Ã©p rÆ°á»£u cháº¥t quÃ¡ =))))))
Pháº¡m Äá»©c Viá»‡t	Hahah
HoÃ ng DH	TrÃ´ng viruss buá»“n cÆ°á»i vÃ£i Ä‘áº¡n ğŸ˜‚ CÃ³ mÃ  viruss giá»‘ng mÃ¬nh uá»‘ng rÆ°á»£u tÃ½ lÃ  Ä‘á» máº·t ğŸ˜„
ThÃ nh ÄÃ m	thÃ´i cháº¿t Viruss rá»“i >"< vÃ o trÃ²ng rá»“i :v :v
HÃ²a Nguyá»…n Trá»ng	hÃ¬nh nhÆ° uá»‘ng rÆ°á»£u yun chu cá»§a hÃ n pháº£i ko cÃ¡c thÃ½m
Kiá»u Quang SÆ¡n	318 tá»« â€œvÃ£i cáº£â€
Tronie	Sao gáº§y quÃ¡ váº­y anh? Giá»¯ sk a Æ¡i
NgocLanVy Phan	tnhien nhÃ¬n cáº£nh tÆ°á»£ng cáº£ Ä‘Ã¡m báº¡n tá»¥ há»p Äƒn nháº­u xong lÄƒn ra ngá»§ v vui gÃª :v
Linh Pháº¡m	Vui nhá». So funny
DÆ°Æ¡ng Thanh	vÃ£i cáº£
Nguyá»…n vÄƒn TÃ i Official	Russ nhÃ¬n gáº§y quÃ¡
TÃ¢n Há»“	Cho tui há»i quan há»‡ viruss vá»›i tee nhÆ° nÃ o mÃ  quen nhau váº­y anh em.
Hai Anh Bui	triáº¿t lÃ½ bÃ n nháº­u: Tháº±ng nÃ o uá»‘ng rÆ°á»£u má»›i lÃ  Ä‘Ã n Ã´ng :))
FANS GOKU VN	ÄÃ n Ã´ng cÃ³ 1 sá»‘ ngÆ°á»i uá»‘ng vÃ o thÃ¬ Ä‘áº­p phÃ¡,cÃ²n 1 sá»‘ ngÆ°á»i uá»‘ng vÃ o thÃ¬ ngá»“i tÃ¢m sá»± vÃ  tÃ¬nh ae Ä‘i lÃªn
nghia nguyen duy	CÃ¡i nÃ y gá»i lÃ  uá»‘ng rÆ°á»£u cÃ³ bÃ i, vr cÃ²n pháº£i luyá»‡n nhiá»u.hj hj hj....
PTL Gameplay Channel	chá»‹ Ly xinh gÃ¡i bá»‹ cáº­n Ã  ??
Huy NgÃ´	Say quÃ¡ rá»“i anh Æ¡i
BÃ n Thá» Váº¯ng Em	PhÆ°Æ¡ng Ly láº¡c loÃ i :)))
Giang Tá»‘ng	RÆ°á»£u nÃ y nháº¹
Van Hung	Viruss bá» thá»i gian Ä‘i táº­p gym Äƒn uá»‘ng táº©m bá»• Ä‘i báº¡n
NÃ´ TÃ¬	NÃ³i chuyá»‡n mÃ  cÃ³ chá»›t ta ti thÃ¬ Ä‘á»«ng nÃ³i ná»¯a nhÃ©!!!! CÃ³ nÃ³i thÃ¬ cx bá»‹ á»•ng dÃ nh pháº§n :))
Rod Jacky	á»¦a anh lÃ¢m Ä‘ang ngá»“i cÃ¡i Ä‘i vá» rá»“i :((
Tung Prince	Haha Justatee cute vai
noob gamming	tá»™i viruss vl
Tuáº¥n Anh Nguyá»…n	RÆ°á»£u thÃ¬ 100% miá»n nam ko láº¡i vá»›i miá»n báº¯c Ä‘Æ°á»£c, miá»n nam rÆ°á»£u Ä‘áº¿ nháº¹ há»u nÃªn tá»­u lÆ°á»£ng trong nam má»©c tháº¥p láº¯m nÃªn Ã´ng viruss cháº¡y lÃ  Ä‘Ãºng rá»“i !!!!!!
A-Tem TrÆ°á»ng	soju hÃ n xáº»ng
PhÆ°Æ¡ng Nam Nguyá»…n CÃ´ng	anh Äƒn hÃ nh náº·ng vÃ£i
Ken No	Vá»«a tá»‰nh rÆ°á»£u tháº¥y uá»‘ng muá»‘n say láº¡i r
Game PUBG.	*_Virus nhÃ¬n ngÆ°á»i nhÆ° con cÃ² hem Ã½ nháº§y.*
bun keytion	Ã”ng máº·c Ã¡o xanh say tá»« lÃºc tÃ´n ngá»™ khÃ´ng nháº­p vÃ o ngÆ°á»i á»•ng
xa quÃª	Jtt nhÆ° tháº±g báº¡n mÃ¬nh chuyÃªn gia khÃ¡y Ä‘á»ƒu :)
mon.key.D. luffy	:))
Jackie Newyen	nháº¡c ná»n lÃ  gÃ¬ v áº¡?
VÅ© Anh QuÃ¢n	CÃ´ng nháº­n a Viruss quan há»‡ tá»‘t tháº­t
cÆ°á»ng hoÃ ng	GhÃ©t nháº¥t cÃ¡i kiá»ƒu  Ã©p rÆ°á»£u
Quan Nguyen	viruss uá»‘ng khÃ´ng thÃ¨ hÆ¡i ra Ã  , cháº¯c phÃª láº¯m
SÆ¡n LÃª	khi nÃ o rá»§ tee uá»‘ng rÆ°á»£u xem thÃª nÃ o
thu truong	chÃ©n thá»© 13 lÃ  Ä‘áº¿n cá»• rá»“i :v
lBossl Hiáº¿u	uá»‘ng sochu nÃ y k Äƒn thua a áº¡
ThiÃªn ThiÃªn	tháº¥y anh cÆ°ng vá»n :)))))))))))))
Giang BÃ¹i HÆ°Æ¡ng	Tee nÃ³i láº¯m tháº¿ Ä‘au cáº£ Ä‘áº§u ğŸ˜’ cÃ²n Ã´ng Vi toÃ n VÃ£i cáº£ ná»“i ğŸ¤£
Linh mÃ¡t Nai	a Viruss dáº¡o nÃ y gáº§y quÃ¡
Nikama TunKo	Vr gáº§y vÃ£i cáº£ ná»•i :)))) a lÃ m hÃ nh trÃ¬nh thay Ä‘á»•i báº£n thÃ¢n Ä‘i a :)) dá»± cháº¯c sáº½ hot
Danh MV	CÃ¡i cÃ¢u "vÃ£i cáº£ ná»“i" nÃ³i pháº£i 1001 láº§n :))
Run _isme	Khá»• vlin :))
NhÃ¢Ì£t HuyÌ€nh	Aww chá»‹ Ly xinh quÃ¡, Æ°á»›c gÃ¬ Ä‘Æ°á»£c uá»‘ng vá»›i chá»‹ cho dÃ¹ say sml nhÆ°ng quÃ¡ lÃ  Ä‘Ã¡ng
à¹–Û£ÛœBÃ¸ss à¹–Û£ÛœBig	AI THáº¤Y PHÆ¯Æ NG LY GIá»NG PHÆ¯Æ NG ANH LEE ğŸ˜‰
Gathering TV	Six Som
Äáº¡t Nguyá»…n VÄƒn	Bá»‹ gÃ i rá»“i =)))
Kien Hoang	Phong cÃ¡ch Äƒn nháº­u kÃ©m v l Äƒn uá»‘ng mÃ  tay cáº§m bÃ¡t tay cáº§m chÃ©n gÃ   v l
Chuyá»‡n Ä‘Ã³ Ä‘Ã¢y	Team PhÆ°Æ¡ng Ly Ä‘iá»ƒm danh nÃ o :))) Xinh QuÃ¡ Trá»i
TrÃ  Nguyá»…n	Äáº¥y lÃ  má»›i uá»‘ng shochu thÃ´i Ä‘áº¥y ğŸ˜‚ğŸ˜‚ğŸ˜‚
Streamer Viet Nam	máº¥y Ã´ng Ä‘Ã´ cao vÃ£i ná»“i?
Há»“ng K	Ã”g a Ä‘á»™i mÅ© cá»© gÃ¡y trÄƒm pháº§n trÄƒm mÃ  lÃºc uá»‘g láº¡i thÆ¡m rá»‹u tháº¿ Ã  ğŸ˜‚ğŸ¤£ğŸ˜‚
Kids TVA	-ai fan viruSS Ä‘iá»ƒm danh-
Háº¥p Tiá»ƒu	Ã”ng tee kiá»ƒu say lÃ¨ nhÃ¨ vcl :)))))))))
Trang Nguyen	Ã”ng Just kiá»ƒu máº¥y Ã´ng nháº­u Ä‘Ã¡m cÆ°á»›i Ä‘Ã¡m cá»—, â€œ chÃº khÃ´ng ná»ƒ anhâ€, â€œ chÃº khÃ´ng xá»©ng lÃ  Ä‘Ã n Ã´ngâ€ :)))) giá»‘ng bá»‘ mÃ¬nh :)))) mÃ¬nh uá»‘ng hay k k qtrong, cá»© p Ã©p ng khÃ¡c uá»‘ng ms vui :))
Sniper The Wolf	Viruss cá»© cÃ¢u "vÃ£i cáº£ ná»“i" mÃ  phang láº·p Ä‘i láº·p láº¡i hoÃ i ğŸ˜‚ğŸ˜‚ğŸ˜‚
Pim Kute	viruss lÃ m viá»‡c nhiá»u trÃ´ng gáº§y quÃ¡ .giá»¯ gÃ¬n sá»©c khoáº» nha báº¡n
Tháº£o Army	Anh Tee ngá»§ dá»… thÆ°Æ¡ng quÃ¡
Le Bach	Cho xin tÃªn nháº¡c ná»n vá»›i
KhÃ¡nh Äá»—	KhÃ´ng uá»‘ng Ä‘Æ°á»£c, khá»• vÃ£i ná»“i :D
Jos Minh	NhÃ¬n máº·t Ã´ng Tee kiá»ƒu nhÆ° mÃ¬nh bá»‘ cÃ¢n háº¿t :)) trÃ´ng y há»‡t táº­p Äƒn cay vs Thuá»³ Minh. Tháº§n thÃ¡i vÃ£i chÆ°á»Ÿng. Äiá»m Ä‘áº¡m pháº¿t ğŸ¤£ğŸ¤£ğŸ¤£
TuÃ¢n BÃ¡	RÆ°á»£u vÃ o
Háº£i Viá»‡t ÄÃ o	4:06 nghe Ly cÆ°á»i kiafaaaaaa :(((
VÅ© Quang Tháº¯ng	Wtf =))
Mario Le	Ná»“i vÃ£i cáº£ ná»“i áº¡ :)))
Vinh co	Ui a hoÃ ng gáº§y qÃ¡ v. A giá»¯ gÃ¬n sk nha
Nhi Nguyá»…n	Ã”ng Tee láº§y vÃ£i :))) cÆ°á»i á»‰a
Anh Äá»©c DÆ°Æ¡ng	Ko bt nÃ³i gÃ¬ ngoÃ i VÃ£i Cáº£ Ná»“i :)/
vÃµ long	jaytea nhay vcc
Anh Tuáº¥n Tráº§n	Ä‘áº­u xanh, Ä‘ang Ä‘á»ƒ loa mÃ¡y tÃ­nh to, tá»± nhiÃªn "anh ÄiÃªn" hÃº hÃº hÃ¡ hÃ¡ cÃ¡i, cáº£ nhÃ  cháº¡y lÃªn tÆ°á»Ÿng bá»‹ lÃ m sao. háº¿t há»“n
Huutho Nguyen	NhÃ¬n Ã´ng tee cÆ°á»i cháº£y nÆ°á»›c máº¯t ğŸ˜‚ğŸ˜‚ğŸ˜‚
HoÃ ng Long	vÃ£i cáº£ ná»“i áº¡ :)
ZeNo C	Cháº¯c Ã´ng nÃ y chÆ°a tá»›i 50kg quÃ¡
Cáº­u 7Thanh	Ã”ng Just nÃ³i quÃ¡ trá»i ğŸ¤£
Nguyá»…n CÆ°á»ng	Cháº¯c rÆ°á»£u xochu rÆ°á»£u quÃª mÃ  chÃ©n tháº¿ kia sáº¥p máº·t háº¿t rá»“i
Nguyá»…n Ngá»c HÃ²a TV	*NhÃ¬n a nhÆ° th nghiá»‡n*
minh hoan	just bÃ¡ vÃª lá» â™¥â™¥â™¥
ngá»c pháº¡m	Tá»« phÃºt thá»© 6 lÃ  báº¡n just Ä‘Ã£ say chÆ°a nhá»??? NÃ³i nhiá»u vÃ£i Ä‘áº¡n =)))
Nguyen Hung	PhÆ°Æ¡ng Ly lÃ  pháº£i 3 ly má»›i nÃ³i chuyá»‡n .VÃƒI Cáº¢ Ná»’I ...Má»i nháº§m khÃ¡ch rá»“i.:))))
Quang Nguyen	RÆ°á»£u vÃ o lá»i ra ahihi, PhÆ°Æ¡ng Ly cute quÃ¡ :))
HoÃ ng Trá»ng Thá»‹nh	01:32 chÃ­nh lÃ  lÃ½ do tao dislike
phuong duy	Äá»ƒ dÃ²ng chá»¯ trÃªn vid nhÃ¬n khÃ³ chá»‹u vÃ£i
Nam	ThÃ´i cháº¿t ! Bá»‹ phÃª P.Ly rá»“i ğŸ˜
Thuáº­t Báº¡ch	1
Nhu-Ngoc Truong	Báº¡n Æ¡i nhá»› giá»¯ gÃ¬n sá»©c khá»e nhÃ©, nhÃ¬n báº¡n á»‘m hÆ¡n trÆ°á»›c nhiá»u quÃ¡. Take cáº£e nhÃ©!
Quang Chu	anh vi rÃºt gáº§y quÃ¡ -.- hic
Pham Thuphuong	Anh áº¥y cÃ³ tÃ­ men lÃ  nhiá»…u lun
NguyÃªn BÃ©	Ã”ng Tee naÌt quaÌ ğŸ˜‚.
Super TV	:)))
Báº¡ch LÃª Táº§n Tiáº¿n	Nháº¡c ná»n lÃ  gÃ¬ váº­y má»i ngÆ°á»i
hiá»‡p trá»‹nh	Hahah hai anh tÃ¢m sá»± chá»‹ ly chá»‰ biáº¿t cÆ°á»i pháº£i chÄƒng cÃ³ sá»± bÆ¡m nháº¹ ;)))
Há»“ Kháº£i	"VÃ£i cáº£ ná»“i áº¡" a ns nhÃ¬u :v
ChaÌnh KiÃªÌ£t ÄÄƒÌ£ng	Jusstatee láº§y vÃ£i :))
hÆ°ng nguyá»…n	Sao uá»‘ng Ã­t váº­y anh viruss em lÃ  em chÆ¡i Ä‘c hÆ¡n ná»¯a chay Ã¡k
Kien tran ngoc	mÃ¬nh mÃ  trong cuá»™c nháº­u nÃ y pháº£i má»i ly liÃªn tá»¥c máº¥t,ly xinh quÃ¡ <3
Vitalina Nguyen	Uá»‘ng ghÃª nha
Duy Phong	Hahahaha
Thanh Äá»©c	ViruSs khá»• vÃ£i ná»“i :))))))
Channel Slowyy	cÃ¡i Ä‘oáº¡n cuá»‘i cÃ¡i tá» giáº¥y bay bay trÃ´ng buá»“n cÆ°á»¡i quÃ¡ :)))
VÄƒn Quang Pháº¡m	Xem lai máº¥y láº¥n váºªn hÃ i ğŸ˜†ğŸ˜†ğŸ˜†ğŸ˜†
[Anime] Love's Story	Vui hen =))) nhÃ¬n Jus nÃ³i nhiá»u khiáº¿n t nhá»› tháº±ng báº¡n gá»‘c HÃ  Ná»™i vÃ£i . há»… Ä‘i nháº­u lÃ  nÃ³ nÃ³i t ngá»“i nghe Ã  @@
TuÃ¢n NGUYá»„N	nhÃ¬n nhÆ° tháº±ng nghiá»‡n
Underground - Rap Viet	*Tao vÃ´ Ä‘Ã¢y chá»‰ vÃ¬ coi PhÆ°Æ¡ng Ly*
VÃ¢n HÃ  BÃ¹i	NhÃ¬n cÃ´ Ly uá»‘ng rÆ°á»£u lÃ  biáº¿t team nÃ y tá»‘n cá»“n rá»“i. Trong bÃ n nháº­u hay cÃ³ cÃ¢u "RÆ°á»£u báº¥t kháº£ Ã©p, mÃ  Ä‘Ã£ Ã©p lÃ  pháº£i háº¿t". Háº¿t mÃ¬nh or háº¿t rÆ°á»£u.
NhÃ¢n Pro	tÃ´i Ä‘Ã£ tháº¥y Ä‘Æ°á»£c Ä‘áº±ng sau Justatee =]]
TrÆ°á»ng Giang	Ã´ng nÃ³i tÃ´i Ä‘au Ä‘áº§u láº¯m, Ã´ng chá»‰ cáº§n uá»‘ng thÃ´i khÃ´ng cáº§n nÃ³i :)))
ÄÄƒng Nguyá»…n	Anh Tee báº¯t báº» ghÃª quÃ¡ =)))
Tráº§n Huy Official	sub cheo ko ae
DucViet Pham	PhÆ°Æ¡ng Ly nÃªn Ä‘á»•i tÃªn thÃ nh NgÃ n Ly vÃ¬ uá»‘ng ghÃª vÃ£i ná»“i :)))
Äá»©c Nguyá»…n	VÃ£i cáº£ ná»“i láº§n e ná» :))
Mai DÆ°Æ¡ng Channel	thÃ­ch cáº£nh cuá»‘i
vÄƒn Ä‘iá»u nguyá»…n	NhÃ¬n PhÆ°Æ¡ng Ly Äƒn khÃ´ gÃ  nhÆ° Ä‘ang bucus áº¥y ae nhá»ƒ ğŸ˜ˆğŸ˜ˆğŸ˜ˆ
HÆ°ng Há»“	phÆ°Æ¡ng ly quÃ¡ xinhhhh
Hieu Phan	uÃ´Ìng dc 100 ly ko
hÃ¹ng lÃª lÃ¢m lÃ½	RÆ°á»£u vÄƒn cá»§a Ã´ng Tee khiáº¿p quÃ¡
Lil Skies	ÄÃºng rá»“i, hoÃ ng lÃ m tháº¿ kiá»ƒu cá»© chá»‘i rÆ°á»£u máº¥t cáº£ vui, ae Ä‘Ã£ tá»›i táº­n nÆ¡i rá»“i cá»© chá»‘i rÆ°á»£u, sao gÃ¬ Ä‘Ã¢u
TaÌ£o NguyÃªn	Say chá»‰ biáº¿t nÃ³i má»—i "vÃ£i cáº£ ná»“i "ğŸ¤£ğŸ¤£ğŸ¤£
Phuc Nguyen	PhÆ°Æ¡ng ly xinh vcÄ‘ ğŸ˜ğŸ˜ğŸ˜
Channel Aggregate	GÃ¡i 1 con trÃ´ng mÃ²n con máº¯t
The Sun South	NhÃ£m
Äá»©c Vlogs	TÃ´i Ä‘á»©c vlogs chÃ o ae ChÃ©o sub nÃ o ae Æ¡i
VÄƒn ThÃ nh Official	Ae qua kÃªnh MÃ¬nh xem phim zombie Ä‘i hay láº¯m
Dang Quang Huy	A hoang luÌc say :))
MON	ğŸ¤£ğŸ¤£ğŸ¤£
Cover hit TB	Em ms lÃ m video gÃµ bÃºt mn vÃ´ coi like giÃºp em nhÃ© náº¿u tá»‘t hÆ¡n thÃ¬ sub vÃ¬ nÃ³ miá»…n phÃ­ mÃ   Sub Ä‘i rep cmt em tráº£ cho  https://youtu.be/RJIzMpIRn1o
Rimzy TV	Quáº£ tÃ³c Ã´ng rá»›t ngÃ¡o quÃ¡ğŸ˜‚/tee giáº£ng Ä‘áº¡o hay quÃ¡ğŸ˜…/ PhÆ°Æ¡ng Ly xinh cháº¿t ngğŸ˜ğŸ˜˜/Ã´ng LÃ¢m giá»‘ng khá»‰ Ä‘á»™t quÃ¡ğŸ˜ƒğŸ¦
HÃ  Quang	Haha nÃ¡t quÃ¡
Mr. Zuster	rÆ°á»£u vÃ o lá»i ra
DÆ°Æ¡ng NgÃ´ HoÃ ng Äiá»n	NÃ³i chuyá»‡n cá»© nhÆ° anh Ä‘á»©c phÃºc áº¥y
Quá»‘c CÆ°á»ng ICT	Vá»£ tÆ°Æ¡ng lai uá»‘ng cÅ©ng khoáº» quÃ¡ cÆ¡ ğŸ˜
QuÃ¢n Tráº§n	Ae nÃ o bt nháº¡c ná»n k ??
ThÃ¡i Táº¡	A hoÃ ng Æ¡i a gáº§y láº¯m rá»“i :(((((( a hÆ°u sá»©c khá»e Ä‘i anh
2,641,998 subcribers	Ã” sÃ¡ng tÃ¡c thÃªm "tháº±ng hÃ i cá»‘t" Ä‘i
Minh LÃª	TÃ´i kh thá»ƒ Ä‘á»©ng vá»¯ng trÆ°á»›c váº» Ä‘áº¹p cá»§a PhÆ°Æ¡ng Ly -.- kiá»ƒu gÃ¬ cÅ©ng xinh â¤ï¸ğŸ˜’
SubestgameR	*Vius Ä‘Æ°á»£c 40kg khÃ´ng váº­y?*
Ä‘Äƒng vo	máº¥y Ã´ng báº£o 100% mÃ  uá»‘ng cÃ³ 50 viruss uá»‘ng nhiá»‡t cmn tÃ¬nh =)))
AA Esports	PhÆ°Æ¡ng Ly xinh quÃ©! Rá»¥ng tym rá»“i <3
CÃ´ng Nghá»‡ Má»›i	Ã”ng Justatee uá»‘ng bÃ¡ tháº¿ :))
DÆ°Æ¡ng Äá»— Háº£i	1:18
Viáº¿t Tuáº¥n Nguyá»…n	NhÃ¬n Ã´ng Ä‘Ã³ng tháº±ng Ä‘iÃªn trong MV toÃ n 100 phÃ¢n trÄƒm xong uá»‘ng khÃ´ng háº¿t hÃ i
LiÃªn QuÃ¢n Gema	Rá»¥ nÃ y uá»‘ng dá»… say láº¯m bá»¯a tÃ´i uá»‘ng cÃ³ 6 sÃ¡u li rá»¥ nÃ y lÃ  say say rá»“i
Ngá»c Armybts	CÃ¢u cá»­a miá»‡ng"VÃƒI Cáº¢ Ná»’I RA"
Linn â„¢	Máº¥y tháº±ng nÃ y nháº¡t vÃ£i lá»“n :)
gia báº£o Tráº§n	LY CUTE QUÃ <3
ngoc vi	Virus a á»‘m tháº¿. Pháº£i lo cho sá»©c khá»e chá»© a.
Gia HÆ°ng	Cháº£ qtam Ä‘áº¡o cÃ¡i moáº¹ j nhÆ°ng hay vÃ£i ra a áº¡ â¤ï¸â¤ï¸
Ngá»c HÃ¢n	em uá»‘ng 2 ly vÃ o thÃ¬ xanh Ä‘áº¿n khi háº¿t xanh rá»“i  vÃ i phÃºt sau háº¿t xanh rá»“i uá»‘ng tá»›i sÃ¡ng anh nhÃ©
PhÆ°Æ¡ng Thá»‹	Tháº±ng kÃ¬a cÆ°á»i Ã­t thÃ´i :v
Äáº¡t Biu	Anh viruss háº¡n cháº¿ dÃ¹ng tá»« "VÃ£i cáº£ ná»“i" Ä‘c khÃ´ng, nÃ³ thÃ nh thÃ³i quen rá»“i khi nÃ³i chuyá»‡n khÃ´ng Ä‘Æ°á»£c hay láº¯m
Nightbot	12:44 sai xÃ³t rá»“i nha, a nháº¥p mÃ´i cÃ³ cÃ¡i mÃ  tÃ­nh lÃªn 14, Ä‘iÃªu tháº¿ chá»© lá»‹
NguyÃªn Ninh Ká»·	Ã”ng Tee nÃ³i cÃ¢u nÃ o chÃ­ lÃ½ cÃ¢u Ä‘áº¥y :)
Tháº¯ng Tráº§n VÄƒn	Äáº¿n láº¡y thÃ¡nh Tee
HoÃ ng VÅ© Trung Anh	VÃƒI Cáº¢ Ná»’IIIIIII áº  =)))))~
Thiá»‡n Kiá»u	tee tá»­u
Anh Duc	BÃ i nháº¡c ná»n cá»§a video lÃ  gÃ¬ váº­y anh Æ¡i
Giang Pham	Ladykillah mÃ  láº¡i. Uá»‘ng rÆ°á»£u bia nhÆ° thuá»“ng luá»“ng uá»‘ng nÆ°á»›c =))
duc jp	Ä‘m giá»‘ng minh vl
TÃ¢n HoÃ ng	Sau khi xem xong clip vÃ  em nháº­n ra lÃ  Ä‘Ã£ lÃ¢u láº¯m em k Ä‘c la ca nhÆ° cÃ¡c anh r
Nguyen Chien Thang	Anh HoÃ ng nghe anh Tee nÃ³i tháº¥y Ä‘au Ä‘áº§u, choÃ¡ng vÃ¡ng :))
Minh KhÃ¡nh VÃµ	chá»‹ Ly xinh quÃ© <3
Tu Hoang	GhÃ©y nháº¥t tháº±ng nÃ o Ã©p riá»‡u
Duy Coconut	Cáº§m cÃ¡i chÃ©n hoÃ i váº­y Ã´ng
bÆ°a dz	NÃ³i chuyá»‡n nháº¡t vl
FB MC	thÃ¨m nháº­u quÃ¡
Bo Tháº¯ng Yang	ÄÃ£ lÃ¢u láº¯m tao máº¥y nÃ³i nhÃ¬n a Viruss nhÆ° Yoo Jea Suk Ã¡ 2 Ã´ng nÃ y Ä‘á»ƒ Ã½ kÄ© nhÆ° ae sinh Ä‘Ã´i haha cÃ¡ nhÃ¢n thÃ´i Ä‘á»«ng quang Ä‘Ã¡ e nha bÃ  con
Duy Pham	tiá»‡n thá»ƒ a Viruss há»i idol Tee dÃ¹m e lÃ  bÃ i Láº£ LÆ°á»›t khi nÃ o xong tháº¿ ?tháº¥y cÃ³ cÃ¡i báº£n demo gÃ¬ lÃ  thÃ´i ??vÃ£i cáº£ ná»“i áº¡ !!
Minh TrÆ°á»ng VÅ©	JayTee :))))))))))))))))))))
Trung Tá»­ Cung	Má»™t Ã´ng Ã­t giao lÆ°u trÃªn bÃ n rÆ°á»£u vs 1 ng Ä‘Ã£ vÃ o Ã³i ra bÃ² trÃªn bÃ n rÆ°á»£u!  TrÃ¬nh Ä‘á»™ nÃ³ khÃ¡c háº³n ğŸ¤”ğŸ˜‚ğŸ˜‚
Trung Nguyentritrung	VÃ£i ná»“i vs vÃ£i Ä‘áº¡n nhiá»u váº­y baaaaa ğŸ˜‚
Eyes Blue	Tee láº§y vl
HoaÌ€ng LÃ´Ì£c NguyÃªÌƒn	ViruSs anh nhá»› Äƒn uá»‘ng ká»¹ láº¡i anh Æ¡i, chá»© á»‘m quÃ¡ chá»i á»‘m rá»“i :((
Ngoc Hiáº¿u	vÃ£i cáº£ lá»“i Ã´ justatee Ã´ áº¥y phÃª con máº¹ zá»“i ká»ƒu nÃ y say Ä‘Ã©o ai cáº£n Ä‘c Ä‘Ã¢u =)))))))))
Ryuk	Anh ViruSs giá»‘ng em quÃ¡, uá»‘ng chÃºt xÃ­u lÃ  máº·t mÃ y Ä‘á» kÃ©!! :))
Trung Nguyen	Cháº¥t trai báº¯c
Tráº§n Thanh Tháº£o	Virrus gáº§y quÃ¡ anh Æ¡i giá»¯ gÃ¬n sá»©c khoáº» nha
Hieu Nguyen	vÃ£i Ä‘Ã¡i thanh niÃªn JT láº§y vl :)))
Bank Plus	Ã´ng tee nÃ¡t pháº¿t nhá»ƒ ha hÃ¡
hÃ¹ng nguyen	tee uá»‘ng ghÃª vÃ£i xoÃ i áº¡
Háº¡nh Minh	Cáº£m giÃ¡c giÃ³ cÃ³ thá»ƒ cuá»‘n viruss báº¥t cá»© lÃºc nÃ o âš™ï¸âš™ï¸âš™ï¸âš™ï¸
Chen Há»“	ğŸ‘ğŸ‘ğŸ‘
Lyric Nháº¡c cÅ©	Bá»… pháº¿t nhá»‰
David Troller	Ai cho xin cÃ¡i tÃªn nháº¡c
HÆ°Æ¡ng Ngá»c	PhÆ°Æ¡ng Ly mÃ  say rÆ°á»£u lÃ  xÃ¡c Ä‘á»‹nh quáº©y nÃ¡t nhÃ  viruss -.-
d nguyen	Tee láº§y vcd :))
D VQ	bá»™ xÆ°Æ¡ng khÃ´ virus Ã  ?? nhÃ¬n tháº¿ nÃ y cháº¯c k tá»›i 50 cÃ¢n, 45 cÃ¢n Ã  ?
Trá»©ng Biáº¿n ThÃ¡i	ÄÃºng kiá»ƒu rÆ°á»£u vÃ o lá»i ra... chÆ°a uá»‘ng thÃ¬ cÃ²n ngáº¡i ngÃ¹ng... mÃ  Ä‘Ã£ lÃª tÃª phÃª rá»“i lÃ  tá»›i báº¿n
nguyen phuong	Táº­p gym cho máº­p lÃªn Ä‘i a Æ¡i. A á»‘m qÃ¡
Min Suga	Viruss Æ¡i dáº¡o nÃ y anh gáº§y quÃ¡.. Ä‚n uá»‘ng Ä‘iá»u Ä‘á»™ chÄƒm sÃ³c sá»©c khoáº» nhÃ©.
Nguyá»…n Äá»©c Thá»	cháº³ng cÃ³ cÃ¢u nÃ o khÃ¡c cÃ¢u vÃ£i cáº£ ná»“i
quang pham	vÄƒn hay vcl tee áº¡
Khang Khang	VÃ£i cáº£ nÃ²i áº¡
Hue Nguyenhuu	VÃ£i cáº£ lá»“i áº¡
KiÃªn Tráº§n	1 2 3 zo
Nhat Huy Vo	Chá»‹ ly xinh vÃ£i tÃ¨o
Há»“ Háº£i ÄÄ‚NG	Ã”ng tee say , xÃ m vÃ£i Ä‘Ã¡i
Earth News	táº­p uá»‘n Ä‘i cháº¿ Æ¡i....vui ghÃª
trung vu van	anh lÃ m clip vá» bÃ i Thu Dáº©m cá»§a LK Ä‘i anh
thiá»‡n táº¡	Ã”ng Tuáº¥n nÃ¡t quÃ¡
Huy Tráº§n	ngÆ°Æ¡Ì€i giÌ€ Ä‘eÌ£p dÆ°Ìƒ v trÆ¡Ì€iii :))) Ly Æ¡iiiii
Hacker Anonymous	Má»i nháº±m khÃ¡ch rá»“iğŸ˜‚ğŸ˜‚
Anh Vy Tran	khÃ´ng co artro vs deep k ak anh
Vu Manh	Tháº§y t nÃ³i cáº¥m sai...3 Ã´ng nháº­u ko sao,thÃªm 1 cÃ´ gÃ¡i vÃ o nháº­u lÃ  cÃ³ chuyá»‡n liá»n
TÃ¢n Pháº¡m	Äáº­m cháº¥t ngÆ°á»i hÃ  ná»™i anh tee Æ¡i ğŸ˜‚ğŸ˜‚ğŸ˜‚
Vi Lá»¥c	Ä‘á»ƒ e Ä‘á»¡ cho a vai rá»›t :))
Tinh Teo	A tee nÃ¡t quÃ¡ ğŸ˜…
khuáº¥t há»¯u bÃ¬nh	Ko cÃ³ full Ã 
Quan Kháº£i	KhÃ¡ch má»i cá»¥c sÃºc VÃ£i Cáº£ Ná»“i,Viruss khá»u khá»u cho PhÆ°Æ¡ng Ly cá»©u bá»“ sáº¯p quáº¯t cáº§n cÃ¢u rá»“i bÃ£ xáº¡o xáº¡o em Ä‘ang nch vs m.n cho Just triá»‡t Viruss ğŸ¤£
BTM TÃ¡o CaCa Vlogs TV	Kkk, Ä‘Ã£ Ã  nha!
Chá»‰ Cáº§n LÃ½ Do	TiÃªn tá»­u viruss ğŸ˜ƒğŸ˜ƒ
SÆ¡n Thanh	Xin link full dc k anh hoÃ ng mn Æ¡iiii
Thinh Pham Le Gia	Cá»±c kÃ¬ thÃ­ch nháº¡c cá»§a Tee nhÆ°ng mÃ  clip nÃ y thÃ­ch thÃªm tÃ­nh cÃ¡ch cá»§a Tee ná»¯a =]]~
Dat Tran	- Ã”ng lÃ m máº¥y cÃ¡i vlog nÃ y vá»›i bÃ¡c Tee nhÆ° nÃ y vui nÃ¨ ;v
Duy KhÃ¡nh	haha xem mÃ  cÆ°á»i á»‰ağŸ˜‚ğŸ˜‚ğŸ˜‚
dat truong	vÃ£i cáº£ lá»“i áº¡ !!!
Viá»‡t HoÃ ng	Mua thuá»‘c tÄƒng cÃ¢n Ä‘i anh
Tina Nguyen	justatee toÃ n dáº­y Ä‘á»i buá»“n cÆ°á»i vÄ‘ :))))
LÃ¢m VÄƒn	BÃ  ly uá»‘ng kinh dá»‹ váº­y  ğŸ˜‚ há»›p má»™t há»›p má»™t ğŸ™„
Cong Lao	Ãƒi cáº£ ná»“i áº¡. Ok. VÃ£i cáº£ Ä‘áº¡nnn .  Ãƒi cáº£ ná»“i áº¡. Ok. VÃ£i cáº£ Ä‘áº¡nnn .  Ãƒi cáº£ ná»“i áº¡. Ok. VÃ£i cáº£ Ä‘áº¡nnn .  Ãƒi cáº£ ná»“i áº¡. Ok. VÃ£i cáº£ Ä‘áº¡nnn .  Ãƒi cáº£ ná»“i áº¡. Ok. VÃ£i cáº£ Ä‘áº¡nnn . $$
Sinobi Aliec	á»ng Ä‘ang bay thÃ¬ pháº£i ğŸ˜’ğŸ˜’ğŸ˜’ğŸ˜’ğŸ˜’ğŸ˜’
TÃš LIÃŠN QUÃ‚N MOILE	MÃ© chá»‰ tháº¥y ná»“i vá»›i Ä‘áº¡n ğŸ˜‚ğŸ˜‚ğŸ˜‚ğŸ˜‚ğŸ˜‚
Vy Nguyá»…n TÆ°á»ng	Anh " tháº±ng Ä‘iÃªn "ğŸ˜›ğŸ˜› báº£nh quÃ¡
channels JAV	Ngá»“i nÃ³i ráº¥t nhiá»u nhÆ°ng uá»‘ng ráº¥t Ã­t
Thanh QuÃ­ LÃª	Bá»‘ quá»³ vá»›i 3 Ã´ng nÃ y :))))
Ngá»c Xuyáº¿n	Ai Ã´m Ã´ng Tee váº­y ğŸ¤£
DTD _Vn	vÃ£i cáº£ ná»“i ngá»“i uá»‘ng rÆ°á»£u.
bao nguyen	ChÃº LÃ¢m Ä‘ang uá»‘ng cháº¡y Ä‘Ã¢u rá»“i?
TÃ´ Ly	Xem mÃ  cÆ°á»i vl ğŸ˜‚ğŸ˜‚ğŸ˜‚
VÅ© HoÃ ng Long DÆ°Æ¡ng	anh tee trÃªu anh viruss vui v :))))
Son Le Hoang	cÃº lá»«a giÃ nh cho viruss rá»“i :))
í•œë€ê¹€	S Ã´ng Viruss nhÆ° miáº¿ng dÃ¡n Ã©p v -_- Äƒn nhiá»u lÃªn nha a
To Hung	Hay
ChÃº TÆ°	á»”ng cá»© vÃ£i cáº£ ná»“i... VÃ£i cáº£ Ä‘áº¡n... Nghe cáº¥n cáº¥n khÃ³ chá»‹u
Monkey D. Luffy	KÃªu uá»‘ng 1 chÃ©n say ngá»§ :))
HÃ  TÃ¢m	Thanh niÃªn Tee khÃ´ng vá» thay bá»‰m cho con Ã  :))
duc anh pham	k pháº£i rÆ°á»£u quÃª k lo sáº¿p eiiiiiii
and game music	Láº§n Ä‘Ã¢u tiÃªn mÃ¬nh like clip cá»§a virus vÃ  cÅ©ng lÃ  láº§n Ä‘áº§u tiÃªn mÃ¬nh xem 1 clip cá»§a 1 stream mÃ  cáº£m xÃºc láº«n lá»™n tháº¿ nÃ y  HÃ£y sá»‘ng tháº­t vui váº» a nhÃ© VÃ  hÃ£y chÃ¢n trá»ng nhá»¯ng gá»«i báº¡n Ä‘áº¿n vá»›i mÃ¬nh sá»± chÃ¢n thÃ nh ^^ ChÃºc anh sáº½ ngÃ y cÃ ng phÃ¡t triá»ƒn trÃªn con Ä‘Æ°á»ng Ã¢m nháº¡c cá»§a mÃ¬nh :)
Nguyen Vinh	PhÆ°Æ¡ng Ly xinh vÃ£i cáº£ ná»“i áº¡
Linh Ho Xuan	Máº·t á»•ng uá»‘ng rÆ°á»£u nhÃ¬n ngu ngÆ¡ quÃ¢ !!!
Soi. MV	Vc khá»‰ğŸ˜‚
Lá»‡nh Ã½ hoÃ ng quÃ½ phi	Tá»› 20 chÃ©n váº«n tá»‰nh nhÆ°ng k bh uá»‘ng quÃ¡ nhiá»u
Bá»m Ka	Ã´ng kia sÃ m vÃ£i nhá»‰ say cmnr
Con MÃ¨o Äen	*nhÃ  a viruss láº¯m ná»“i vÃ£i ra*
XuÃ¢n Trung Nguyá»…n	11:45 to 11:55  Viruss said : Äá»¡ Ä‘á»¡..... ğŸ¤£ğŸ˜‚ğŸ¤£ğŸ˜‚ Äoáº¡n nÃ y chá»‹ Ly cute vÃ£i cáº£ ná»“iiiiiii â¤ï¸
HoÃ ng Nguyá»…n ÄÄƒng	1:21 Ä‘eo tai nghe giáº­t háº¿t cáº£ mÃ¬nh vá»›i Ã´ng LÃ¢m ( Thá»“n)
Fresh Juice	vÃ£i cáº£ ná»“i áº¡ :))
Äƒn cá»©t dÅ©ng	Máº¥y thÃ¡nh láº§y vc
Äá»©c Nguyá»…n Viá»‡t	Ná»“i Ä‘áº¡n nhiá»u vl haha
DÆ°Æ¡ng Nguyá»…n	Nháº­u xá»‰n xong group sex luÃ´n Ä‘i a hoÃ ng sau Ä‘Ã³ lÃ m clip group sex :))
Ngá»c Gooner	best Ã©p uá»‘ng =))))
DÆ°Æ¡ng Tráº§n	PhÆ°Æ¡ng ly xinh vÃ£iiiii!!!!
King Monster	Ã”ng rÃºt gáº§y vÃ£i Ä‘áº¡n áº¡  Há»— trá»£ thÃªm vÃ i ná»“i Ä‘áº¡n tÄƒng cÃ¢n Ä‘Ãª
Anh Tá»‘ng	Justatee nÃ³i phÃ¡t im re thá» táº¯t mÃ¡y quay ra vÄƒng ra chá»­i nhau sml viruSs má»™t phÃºt bá»‘c Ä‘g r
quyen monter kid	Bao nhiÃªu cÃ¢u vÃ£i cáº£ ná»“i
UX tuw2	A tee lÃªn hÃ  giang uá»‘ng rÆ°á»£u vá»›i bá»n em nhÃ© VÃ i chai Ä‘áº¥y nháº¯m má»“i thÃ´iğŸ˜…ğŸ˜…ğŸ˜…
ÄÄƒng Háº£i	Ko bt bao nhiÃªu cÃ¢u v~ ná»“i :))
Hien Nguyen	Uá»‘ng á»Ÿ nhÃ  báº¡n, nhÃ  mÃ¬nh thÃ¬ say sm ra thÃ¬ váº«n yÃªn chÃ­ ngá»§ láº¡i. Chá»‰ khá»• ngÆ°á»i dá»n "chiáº¿n trÆ°á»ng" thÃ´i :))
DÆ° Tráº§n	NhiÌ€n virus giÃ´Ìng Ã´ng mc quÃ´Ìc dÃ¢n bÃªn HaÌ€n quÃ´Ìc
Ichimoku Trá»‹nh PhÃ¡t	Máº¥y thanh niÃªn nÃ y uá»‘ng kinh quÃ¡
Khang Minh	ToÃ n vÃ£i cáº£ ná»“i vs cáº£ vÃ£i cáº£ Ä‘áº¡n
tam pham	just say nÃ³i hÃ i vcl ra
maruko chan	Ã”ng jus bÃ¬nh tÄ©nh dÃ£ man
Tin Nguyen	Sá»‰n vÃ´ ngá»“i vÃ£i liÃªn tá»¥c
TÃ´n Ngá»™ KhÃ´ng	Chá»‹ kia xinh tháº¿
Huy HÃ¹ng	vÃ£i cáº£ ná»“i + vÃ£i cáº£ Ä‘áº¡n x3.14
Jasmin Vuong	Sai rá»“i Rá»›t owiiii :)))
ThÃ nh NguyÃªn	nhÃ¬n anh tee ngá»©a máº¯t vc
HoÃ ng Tuáº¥n Pháº¡m	ViruSs bá»‹ váº­t nÃ¡t
KhÃ¡nh NÃ´ng	sáº¿p uá»‘ng xong toÃ n VÃƒI Cáº¢ Ná»’I áº  ğŸ˜‚ğŸ˜‚ğŸ˜‚
Giang Vu	Haha ğŸ˜‚ğŸ˜‚ğŸ˜‚
Quang Trinh	Chá»‹ ly xinh quÃ¡
TS LQH	VÃ£i cáº£ ná»“i
Nháº­t VLogs	say roi
nguyen quoc tuan	Justatee Ã¡c vl
Fan VR	"vÃ£i ná»“i quá»‘c dÃ¢n" =)))))
Romantic	Ly ngon quÃ¡ :(
Nguyá»…n Duy	thay vÃ¬ Ä‘áº¿m sá»‘ ly  Ä‘Ã£ uá»‘ng chi báº±ng Ä‘áº¿m sá»‘ ná»“i sá»‘ Ä‘áº¡n vÃ£i ra hay hÆ¡n
Gáº§y Gaming	ToÃ n vÃ£i cáº£ ná»“i áº¡
Prince Micheal	Anh Viruss uá»‘ng khoáº» váº­y
RR Kull	Tee cÄƒng vÃ£i ná»“i
just my opinion lol	1:22 rip earphones users
uchiha sasuke	gat the
Ta LÃ  GiÃ³	Viruss nhÃ¬n á»›m vÃ£i , ko bik bÃ  NgÃ¢n chÄƒm á»• ntn mÃ  á»›m vÃ£i.
Tá»‰nh Nguyá»…n	Ngá»±c chá»‹ Ly Ä‘Ã¢u r
Paddy nomal	ThÆ°Ì£c ra Ã´ng Tee say meÌ£ trÆ°Æ¡Ìc Viruss rÃ´Ì€i :P
God Jane	Tháº±ng kia quay Ä‘i . Máº·t anh Ä‘ang chá»nh há»…nh trÃªn tv m láº¡i xoÃ¡ háº¿t cáº£ máº·t anh . Con áº¡
Hiá»‡p Tráº§n	Gáº§y vÄ‘ áº¡ :))
PHONG YÃªu	Vai rá»›t gáº§y tháº¿, Äƒn vÃ o, chá»‹ch Ã­t Ä‘i
Minh Anh Äá»—	Cáº£ cÃ¡i video toÃ n: VÃƒI Cáº¢ Ná»’IğŸ˜‚
HÃ¹ng Kird	Chuáº©n ngÆ°á»i hÃ  ná»™i. Chuá»‘c cho rÃºt sáº¥p máº·t lol kk
Enterty Clan Vlogs	1 phÃ²ng 5 Ã´ng 1 bÃ  ???
NgaoDu90	ÄÃºng vÄƒn cá»§a máº¥y tháº±ng bá»£m. Hay láº±m JT =))
Háº£i ÄÄƒng	Äáº¡n vá»›i ná»“i nhiá»u vl ğŸ¤£ğŸ¤£ğŸ¤£
HKD Monster	v~ hÃ i
lam vÅ©	Ã´ng tea Ã¡c vÃ£i
N3n3	hahahaa
LÃ¢m Pháº¡m VÃµ	VÃ£i cáº£ ná»“i :))) VÃ£i cáº£ Ä‘áº¡n Ä‘áº¡n :))) VÃ£i rÆ°á»£u. VÃ£i gÃ¡i
Vu Nguyen Quang	jaytee kieu mot. ruou vl =))
Paul Dz	nhÃ¬n phÆ°Æ¡ng ly thÃ´i máº¥y Ã´ng áº¡
trung anh nguyá»…n	VÃ£i ná»“i * 3,14.... vÃ£i Ä‘áº¡n * 3,14...
KhÃ¡nh Viá»‡t	VÃ£i cáº£ ná»™i áº¡ :))
juun tráº§n	Äau ruá»™t
VU VÆ 	VÃ£i cáº£ ná»“i áº¡ hÃ i vc
april .09	láº§y vcl Ã´ng tee Æ¡iiiii
à¹–Û£ÛœNAMà¹–Û£Ûœ Aoyama- à¹–Û£ÛœKun	xem máº¥y thÃ¡nh phÃ¡n chá»‰ bt ngá»“i cÆ°á»i :))
huy nguyen	vÃ£i cáº£ ná»“i, vÃ£i cáº£ ná»“i, vÃ£i cáº£ ná»“i áº¡ :))
Khang Phan	phÆ°Æ¡ng ly <3
Há»“ng HÃ i Nhi	Äá» gÃ¬ thÃ¬ Ä‘á». Äá»«ng Ä‘á» rÆ°á»£u vá»›i ng miá»n bÄƒcd
TrÆ°Æ¡ng Gia Vinh	Ã´ng kia lÃ m con khá»‰ :)))
Nguyá»…n ÄÄƒng	kk =)))
SINO N2M	Anh viruss uá»‘ng 1 ly lÃ  Ä‘á» máº·t r
MIN Senter	VÃ£i cáº£ ná»“i áº¡ BÃ€ LY báº£ náº±m cÃ¡i tÆ°á»›ng...VÃ£i cáº£ ná»“i áº¡ ğŸ¤£ğŸ˜¨ğŸ¤£
Neko Mikiyo	NhÃ¬n ViruSs bÃ©o ghÃª :))))
Nguyá»…n LuÃ¢n	Thá» Ã´ng viruss cÃ ng ngÃ y cÃ ng xáº¥u vÃ  á»‘m quÃ¡ khÃ¡c xÆ°a
kim son hoang	Ok anh say! nhÆ°ng tim anh Ä‘ang Ä‘au áº¥u
hung tran	T Ä‘ang ngi ngá» Ã©o bit cÃ³ pháº£i riá»‡u k :))
Nam Tráº§n Trá»ng	VÃ£i cáº£ ná»“i áº¡.............vvvvvvv.......vvvvvvvvvvvv
tan nguyen	thÃ´i Ã´ng viruss nÃ¡t rá»“i Ã´ng Æ¡i  vÃ£i Ä‘áº¡n ...vÃ£i cáº£ ná»“i x1000
Tran Thanh Binh	nguyÃªn team Ä‘iÃªn vÃ  cháº¥t :))
MP Nguyá»…n	PhÆ°Æ¡ng Ly cÃ³ con rá»“i mÃ  nhÃ¬n nuá»™t vcl
HÆ°ng LÃª	Chá»‹ ly ngá»§ cute quÃ¡
duy nguyá»…n	Cáº¯t cá»‘c
Minzuz Tv	vÃ£i cáº£ ná»“i áº¡
VN-GÃ Con	Vcl jus uá»‘ng kinh tháº¿ thÃ¬ cha ná»™i viruss chá»‰ cÃ³ náº±m ğŸ˜‚ğŸ˜‚
QuÃ½ VÅ©	Uá»‘ng rÆ°á»£u sochu nháº¹ hÆ¡n vang chÃºt mÃ  gá»¥c háº¿t ntn Ã  :)) Pháº£i dÃ¹ng rÆ°á»£u tráº¯ng VN chá»© a Æ¡i :))
An Pham	Cáº£ nhÃ  ngÃ¡o háº¿t luÃ´n rá»“i.!!!
lang nguyen	Uá»‘ng rÆ°á»£u mÃ  gáº·p kiá»ƒu tee sá»£ vl
NghÄ©a HÃ 	Tee uá»‘ng kinh vÃ£i
Van Thao Chu	cÆ°á»i á»‰a
ThÃ nh VÄƒn	Ã”ng hoÃ ng hÃ´m nÃ o má»i cáº£ team youtube vá». LÃ m 1 bá»¯a. Äáº£m báº£o cáº£ triá»‡u share
CÃ´ng BÃ¬nh Nguyá»…n	V~ cáº£ ná»“i, Ä‘áº¡n x3.14 :))
Nguyen Nhi	chá»‰ cÃ³ TÃ”I vÃ  v~ cáº£ Ä‘áº¡n xuyÃªn suá»‘t video t Ä‘Ã£ biáº¿t 1 máº·t khÃ¡c cá»§a j
Tá»‘ uyÃªn	Táº¥m cuá»‘i dá»… thÆ°Æ¡ng vÃ£i Ä‘áº¡n
HÆ°ng Nguyá»…n ThÃ nh	RÆ°á»£u báº¥t kháº£ Ã©p. Ã‰p báº¥t kháº£ tá»« :))) ai cÅ©ng nhÆ° vr thÃ¬ nháº­u vui váº» gÃ¬ :)))) ngá»“i giá»¯ káº½ Ã  máº¥y nam thanh ná»¯ tÃº :))))
Binh nguyen van	Tay viruss bÃ© vÃ£i lá»“i
Äáº¡t Cter	ViruSs bá»‹ háº¥p diÃªm haha
JJ Hilley	Äáº¡i há»™i vÃµ lÃ¢m má»e r
ChiÌnh VÄƒn	CÃ¡i ná»“i bÃ¬nh dÃ¢n
HoÃ ng Pháº¡m	Sayyy rá»“i hÃ¢hha
Háº­u BgG	Bá»‹ chá»­i sml luÃ´n ğŸ˜‚ğŸ˜‚ğŸ˜‚
Ngoc rong sv4 Dragon	Virus Äƒn hÃ nh sáº¥p máº·t ğŸ˜‚ğŸ˜‚
Äá»— khÃ¡nh	Cháº£ pk sao ViruSs nháº¥p mÃ´i k Ã 
Sad Meo	Cho em há»i chá»‹ Ly cÃ³ ngÆ°á»i yÃªu chá»­a =))? Náº¿u chá»­a thÃ¬ nÃªn cÃ³ ngÆ°á»i yÃªu Ä‘i =)))
cccnek hoi	nhÃ  bÃ¡c viuSs k cÃ³ j ngoÃ i ná»“i vs Ä‘áº¡n
RÃ™A GAMER	A hoÃ ng sao gáº§y váº­y
quá»‘c huy Ä‘inh	CÃ³ ai tháº¥y JT uá»‘ng vÃ o xong cá»© xÆ¡n xÆ¡n qua vr nhÃ¬n giá»‘ng gay vl
Äá»©c BÃ¬nh	Ai Ä‘áº¿m thá»­ coi cÃ³ bao nhiÃªu cÃ¢u vÃ£i cáº£ ná»“i Ã¨n vÃ£i cáº£ Ä‘áº¡n =))))
VÆ°Æ¡ng Hiáº¿u	KhÃ  khÃ  khÃ ğŸ˜‚ğŸ˜‚ğŸ˜‚.
Nasus TV	Buá»“n cÆ°á»i ğŸ˜‚ğŸ˜‚ğŸ˜‚
HoÃ ng Long LÃª	RÆ°á»£u vÃ o lá»i ra Láº§n sau khÃ´ng muá»‘n má»i luÃ´n
HD258 Gaming	VÃ£i cáº£ Ná»’I x 3,14 VÃ£i cáº£ Äáº N x3,14 áº¡ áº¡ áº¡ ! :))))))))))))))))
Äen Tráº¯ng	Team bá»£m rÆ°á»£u :tee ly Team Ã­t nháº­u : viruss  :)))
Akagami ThÃ nh	HÃ´m ná» Ä‘á»c bÃ¡o nghe nÃ³i lÃ  nhá»¯ng ai uá»‘ng rÆ°á»£u mÃ  máº·t Ä‘á» lÃ  tá»‰ lá»‡ ngá»™ Ä‘á»™c cao gáº¥p 10 láº§n ngÆ°á»i bt ğŸ¤”
King NV.Tiá»‡p	Ã”ng tee ru hay quÃ¡ğŸ˜ğŸ˜
Night black	NÃ³i tháº­t nhÃ¬n bÃ  PhÆ°Æ¡ng ly nhÃ¬n giá»‘ng boxbox phiÃªn báº£n ná»¯ :v
Minh Nguyá»…n	Tee:"Láº¡i nháº£y vÃ o má»“m tÃ´i rá»“i " =)))
ThÃ nh Long Nguyá»…n Pháº¡m	Ty láº§y quÃ¡ A HoÃ ng e yÃªu a
Pew Noy	XONG phÆ°Æ¡ng ly naÌt r
Supper SWannaCry	Haha bÃ  PhÆ°Æ¡ng cute ghÃª
Hiáº¿u LÃª	Ai giáº£i thÃ­ch viruss liÃªn quan gÃ¬ Ä‘áº¿n Â«tháº±ng Ä‘iÃªnÂ»
pham thanh	K uá»‘ng Ä‘c k nÃªn Ã©p, Ä‘áº¥y lÃ  lá»‹ch sá»± ğŸ¤·ğŸ»â€â™‚ï¸
An Bui	A tee bá»‹ dÃ­nh rr ğŸ˜‚ğŸ˜‚
Subino Äáº·ng	Ä‘Ã¡ng yÃªu tháº¿ nhá»Ÿ ğŸ˜˜ğŸ˜˜ğŸ˜˜ğŸ˜˜ğŸ˜˜
VÅ© HoÃ ng Giang	RÆ°á»£u nháº¹ rá»“i =))
Nguyá»…n Háº£i Nam	15 chÃ©n Ä‘Ã£ say tháº¿ nÃ y thÃ¬ há»ng rá»“i :))  láº¡i cÃ²n lÃ  rÆ°á»£u soju ná»¯a chá»©
ÄÃ o Mai Quá»³nh	Äau ruá»™t vch,rÆ°á»£u vÃ o lá»i ra,Ä‘Ãºng bÃ i luÃ´n,Ã´ng tee máº·t tá» ra tá»‰nh láº¯m ğŸ˜‚ğŸ˜‚viruss váº­t vÃ£ Äƒn Ä‘á»§ vÄƒn táº¿ cá»§a Ã´ng tee ğŸ™ğŸ»ğŸ™ğŸ»
- Jikey-	Jt nÃ¡t kiá»ƒu má»›i =]]
HoÃ ng Duy BÃ¹i VÅ©	CÃ³ ai chá»‰ kÃ©m anh Viruss 2 tuá»•i nhÆ°ng váº«n kh biáº¿t uá»‘ng rÆ°á»£u bia nhÆ° mÃ¬nh kh?
Tiáº¿n Anh Tráº§n	PhÆ°Æ¡ng ly uá»‘ng rÆ°á»£u kinh váº­y
Lucifer	A vÃ£i cáº£ ná»“i hÆ¡i nhiá»u =))
supper Vip	#phuongly2vn ae eii =}}}
DIY Costume	Jus say nÃ³i chuyá»‡n láº§y quÃ¡
Ly Háº¡nh	nháº­u bÃ©t nhÃ¨! ghÃª tháº·c haha
Bergkamp Denis	Fps tháº¥p quÃ¡ a Æ¡i
VÆ°Æ¡ng DRX	*Viruss auto VÃ£i :D*
Cáº£nh RMA	gáº§y quÃ¡ viruss Æ¡i
Kiá»‡t	Ai biáº¿t info Ã¡o phÆ°Æ¡ng ly khÃ´ng
ÄÄƒng Pháº¡m	Äoáº¡n cuá»‘i ngáº§u nha :V
Hi im MÆ°a	"vÃ£i cáº£ ná»“i" x 3,14 :#
ThÃ nh NgÃ´	Uá»‘ng nc lá»c thÃ¬ cÃ³ ğŸ˜‘
chuotbi_yeu_gaoxu	Ã”ng tee eÌp rÆ°Æ¡Ì£u haÌ€i vaÌƒi chÆ°Æ¡Ì‰ng
Xe Ä‘iá»‡n PEGA	Chá»‹ PhÆ°Æ¡ng Ly xinh quÃ¡aa ğŸ˜
anh kygo	ÄÃ£ nhiá»u láº§n há»©a k uá»‘ng bia rá»±u ná»¯a nhÆ°ng nhÃ¬n vÃ o cá»‘c bia chÃ©n rá»±u láº¡i nghÄ© tá»›i ngÆ°á»i lÃ m ra nÃ³. Mk k uá»‘ng thÃ¬ con cÃ¡i há» láº¥y tiá»n Ä‘Ã¢u Äƒn há»c rá»“i cÃ²n bÃ  hÃ ng xÃ³m cáº¡nh nhÃ  Ã´ng bÃ¡n bia ná»¯a chá»©
FPS ÄÃ m	Virus con thá»© 2 r ba  :))
Nhiá»u KÃ­ Tá»± Zombie V4	https://youtu.be/niQcutIVAaA
Minh Nguyen	Ã”ng viruss á»‘m quÃ¡ r :/ táº­p trung Äƒn uá»‘ng táº­p thá»ƒ thao Ä‘i Ã´ng eiii
Máº¡nh VÅ©	Tee say rá»“i
Hao Le	ai Ä‘Äƒng kÃ­ kÃªnh mÃ¬nh Ä‘i Ã­t lÆ°á»£c Ä‘Äƒng kÃ­ quÃ¡ Ã k
Nguyá»…n minh Ä‘á»©c LÃª	CÃ³ mÆ°á»i máº¥y chÃ©n rÆ°á»£u mÃ  cá»© báº£o jus nÃ¡t vá»›i gÃ¬ lÃ  sao??? Äm bá»n mÃ y ngá»“i trong cuá»™c vui cháº³ng sáº¥p máº·t lá»“n ra áº¥y.
quy bui	Khá»• thÃ¢n bá»‹ cháº·t
HoÃ ng Nguyá»…n	PhÆ°Æ¡ng Ly xinh vcl :3
Fan BÃ© Chanh	*PhÆ°Æ¡ng ly uá»‘ng rÆ°á»£u nhÆ° nc Ã½ tu ghÃª ğŸ˜ğŸ˜ğŸ˜*
Kiá»‡t Onbi	Äáº­u xanh. May mÃ  mÃ¬nh khÃ´ng cÃ³ báº¡n nháº­u nhÆ° tháº¿. Láº§y vÃ£i ná»“i
Cu ThÃ³c	VÃ£i ná»“i liÃªn tá»¥c tháº¿ viris :))
quynh nguyen	Ai tháº¥y viruss giá»‘ng chÃº Jae suk running man Ä‘iá»ƒm danh nÃ 
tiá»ƒu cÆ°Æ¡ng thi	Ã”ng tee sá»‰n láº§y vler
TÄ©nh HÃ n Nhi	Hay ho Ä‘Ã©o gÃ¬ mÃ  Ã©p  Cá»© tÆ°á»Ÿng tháº¿ lÃ  hay
tea Ä‘inh	anh justatee láº§y qÃºa
Máº¡nh CÆ°á»ng	studio cá»§a virus á»Ÿ Ä‘Ã¢u nhá»‰ má»i ngÆ°á»i
Huong Truong	VÃ£i cáº£ ná»“i ,vÃ£i cáº£ Ä‘áº¡n áº¡ ğŸ˜‚ğŸ˜‚ğŸ˜‚
CHÃP Studio	Tá»±u lÆ°á»£ng tee ms ly cao quÃ¡ thá»
Fenix 25019	ViriSs gáº·p cao thá»§ Ã©p rÆ°á»£u rá»“i náº¿u khÃ´ng biáº¿t cÃ¡ch tá»« chá»‘i  khÃ©o thÃ¬ nÃ¡t ngÆ°á»i ngÃ y táº¡i háº¡ xin bÃ y chÃºt káº¿ cho cÃ³ thá»ƒ sá»­ dá»¥ng trÃªn bÃ n nháº­u cÅ©ng sÆ°u táº§m cáº£ thÃ´i : Uá»‘ng rÆ°á»£u khÃ´ng thá»ƒ giáº£i sáº§u uá»‘ng  rÆ°á»£u chá»‰ tá»• nhá»©c Ä‘áº§u mÃ  thÃ´i  Ä‘á»ƒ khÃ´ng tá»•n thÆ°Æ¡ng tÃ¬nh cáº£m tÃ´i uá»‘ng Ä‘á»ƒ khÃ´ng tá»•n thÆ°Æ¡ng sá»©c khá»e tÃ´i uá»‘ng Ã­t thÃ´i nhÃ©  Ã©p dáº§u Ã©p má»¡ ai ná»¡ Ã©p rÆ°á»£u  Ã´ng khÃ´ng uá»‘ng lÃ  khÃ´ng tÃ´n trá»ng tÃ´i xin lá»—i tÃ´i háº§u nhÆ° khÃ´ng tÃ´n trá»ng nhá»¯ng ai Ã©p tÃ´i uá»‘ng  cáº£ bÃ n uá»‘ng Ã´ng khÃ´ng uá»‘ng máº¥t vui Ã´ng xem cáº£ bÃ n váº«n vui vÃ  báº±ng chá»©ng lÃ  há» váº«n Ä‘ang uá»‘ng  cá»© uá»‘ng háº¿t mÃ¬nh Ä‘i, say tui Ä‘Æ°a báº¡n vá» khi say lÃ  tÃ´i khÃ´ng vá», mÃ  khÃ´ng vá» khÃ´ng Ä‘Æ°á»£c, khÃ´ng Ä‘Æ°á»£c tá»©c lÃ  tÃ´i pháº£i vá», mÃ  muá»‘n vá» thÃ¬ tÃ´i khÃ´ng Ä‘Æ°á»£c say  ná»‘t chai nÃ y rá»“i ae mÃ¬nh vá» Ä‘Ã¢y cÃ³ pháº£i lÃ  cÃ´ng viá»‡c Ä‘Ã¢u mÃ  ná»‘t cho xong  ná»ƒ nhau thÃ¬ uá»‘ng háº¿t chÃ©n nÃ y Ä‘i náº¿u Ã´ng coi uá»‘ng Ä‘á»ƒ chá»©ng minh tÃ´i ná»ƒ Ã´ng thÃ¬ tÃ´i khÃ´ng uá»‘ng cháº¯c Ã´ng hiá»ƒu chá»©  rÆ°á»£u báº¥t kháº£ Ã©p, Ã©p báº¥t kháº£ tá»« cÃ¢u nÃ y hay váº¿ Ä‘áº§u do tháº§y dáº¡y, váº¿ sau do bá»n phÃ m phu thÃªm vÃ o  tÃ´i khÃ´ng chÆ¡i vá»›i bá»n tá»¥c tá»­  chÃ©n nÃ y uá»‘ng vÃ¬ tÃ´i khÃ´ng láº¥y rÆ°á»£u lÃ m thÆ°á»›c Ä‘o   chá»‰ cÃ³ tháº±ng sá»£ vá»£ má»›i khÃ´ng dÃ¡m uá»‘ng chá»‰ cÃ³ tháº±ng khÃ´ng nÃ£o má»›i khÃ´ng sá»£ vá»£   Ä‘Ã n Ã´ng gÃ¬ mÃ  uá»‘ng nÆ°á»›c ngá»t uá»‘ng rÆ°á»£u cÅ©ng cháº¯c gÃ¬ Ä‘Ã£ lÃ  Ä‘Ã n Ã´ng  anh khÃ´ng uá»‘ng ly nÃ y thÃ¬ anh khÃ´ng ná»ƒ máº·t tÃ´i náº¿u Ä‘em sá»± nÃ´ng sÃ¢u cá»§a tÃ¬nh cáº£m so sÃ¡nh vá»›i tá»­u lÆ°á»£ng nhiá»u Ã­t váº­y thÃ¬ má»‘i thÃ¢m tÃ¬nh cá»§a chÃºng ta lÃ m sao so Ä‘Æ°á»£c vá»›i 1 ly rÆ°á»£u, vá»›i giao tÃ¬nh lÃ¢u nay nháº¥p mÃ´i thÃ´i cÅ©ng lÃ  ngá»t rá»“i  tÃ´i tÃ´n trá»ng báº¡n nhÆ°ng tÃ´i nghÄ© báº¡n cÅ©ng nÃªn tÃ´n trá»ng tÃ´i   hiá»ƒu táº¥m lÃ²ng cá»§a nhau lÃ  tá»‘t quÃ¡ rá»“i , khÃ´ng nÃªn Ä‘o lÆ°á»ng tÃ¬nh cáº£m báº±ng tá»­u lÆ°á»£ng, chÃºng ta vui lÃ  9, uá»‘ng Ä‘Æ°á»£c bao nhiÃªu thÃ¬ uá»‘ng báº¥y nhiÃªu nhÃ©, rÆ°á»£u khÃ´ng cáº¡n nhÆ°ng tÃ¬nh nghÄ©a váº«n sÃ¢u Ä‘Ãºng khÃ´ng nÃ o
XUÃ‚N QUANG	Haha
khÃ©t láº¹t	NhÃ¬n ngÆ°á»i Ã´ viruss cháº£ khÃ¡c gÃ¬ Ã´ lynk lee , khung xÆ°Æ¡ng Ä‘i Ä‘á»™ng :v
HoÃ ngg Huy	Anh Tee bá»«a quÃ¡ haha ğŸ˜‚
Tom Pháº¡m	Máº¹ tee nÃ³ Ã©p gáº¯t tháº¿ lms Ä‘á»¡ Ä‘x
Ã‚u Äá»©c Tráº§n	1:22 LÃ¢m vissay hÃ³a THáº°NG ÄIÃŠN
Tuáº¥n Dola	ChÆ°a cÃ³ ai say mÃ  báº£o mÃ¬nh say =)) nÃªn thÃ´i lÃ  uá»‘ng Ä‘i Ä‘á»«ng cÃ³ xáº¡o vÃ£i cáº£ ná»“i áº¡ =))
KiÃªn Nguyá»…n	Khi xong xuÃ´i táº¥t cáº£ Ä‘á»u ngáº¥t háº¿t ğŸ¤£ nÃªn cháº³ng cÃ³ ai dá»n ğŸ˜‚
Tháº¡ch Dá»«a Gaming	Reaction nhá»¯ng káº» má»™ng mÆ¡ Ä‘i báº¡n viruss Æ¡i
Gáº§yy Gaming	*cmt nÃ y Ä‘c 200 like sáº½ tÃ¬m táº­n nhÃ  virrus lÃ m clip nhÃ© ae ^^ qua kÃªnh Ä‘Äƒng kÃ­ nhÃª*
Sherlock Homles	ná»“i quá»‘c dÃ¢n
tuáº¥n nguyá»…n	Ráº¥t mong Ä‘c 1 ngÃ y gáº·p a hoÃ ng. E ráº¥t quÃ½ a. 0888900388 hi vá»ng a nhÃ¡ mÃ¡y e 1 láº§n. E Æ¡ VÄ©nh phÃºc
Nhi Nhi OFFICIAL	Äáº¡n vÃ   ná»“i =))
Äá»©c Leo	Ly xinh vÃ£i ná»“i
Nguyá»…n TÃ¹ng LÃ¢m	gáº§y quÃ¡ rá»“i anh Ã¢y ;) giá»¯ gÃ¬n sk anh nhÃ©
Le Toan	justatee noi chuan vai
NNH Vlogs	btw ViruSs váº«n lÃ  ngÆ°á»i tá»™i nháº¥t, bá»‹ giÃ£ cho tÃ­m cáº£ máº·t :(
Thu HÃ 	CÃ­u cÃ­u cÃ­u.... anh Tee Ã©p giá»i vchğŸ¤£ğŸ¤£ mÃ  nghe Ã´ng áº¥y nÃ³i cá»© tg Ã´ng áº¥y phÃª cÆ¡ Anh Viruss thÃ¬ hiá»n quÃ¡ Chá»‹ Ly xinh khá»i bÃ n mÃ  uá»‘ng Ä‘á»‰nh quÃ¡ğŸ˜ğŸ˜
Like You	Ã”ng kia Ä‘á»‘ng a trai HÃ¹ng trong NgÆ°á»i BÃ¢t Tá»­ quáº£ tá»± tá»­ nhÃ¬n ngáº§u pháº¿t hÃ¢hhah
Linh Di	Viruss thá»±c ra uá»‘ng Ä‘Æ°á»£c nhiá»u Ä‘Ã³ chá»© nhÆ°ng ko mÃ¡u báº±ng justatee Ä‘Ã³ thÃ´iğŸ˜†
Kháº£i Pháº¡m Quang	Uá»‘ng rá»±u mÃ  cá»© lÄƒm cÃ¡i chÃ©n v ba
ATSM TV	nhÃ¬n vai rá»›i tá»™i vÃ£i
ThÃ nh LÆ°Æ¡ng	Team ná»­a lÃ­t Ä‘Ã¢u rá»“i. TÃ´i 19 tuá»•i nhÃ©.
Huy Dinh	ly xinh vcl áº¡=(
Mr Pillow	cÃ´ Lyyyyyy
MONSTER NVQ	HÃ i quÃ¡ anh Tee Æ¡i ğŸ¤£
TP Gamer Vlogs	VÃ£i ThÃ¡nh Khá»‰ Giá»‘ng Vl Sub ChÃ©o Nha!!! KÃªnh MÃ¬nh ChuyÃªn Sub ChÃ©o
Thu Hiáº¿u	Chá»‹ NgÃ¢n Æ¡i... cho má»—i Ã´ng cÃ¡i má»m
TÃº LÃª Minh	Uá»‘ng nhiá»u vÃ o vÃ  nÃ³i Ã­t thÃ´i =))))
Khanh Le	chá»‹ ly máº¡nh dá»¯
Trinh Phan	HÃ¬nh nhÆ° phÆ°Æ¡ng ly lá»›n nháº¥t trong 3 ngÆ°á»i Ä‘Ãºng ko tağŸ˜
sáº¹o chiáº¿n	Ã´ng just Ä‘Ãºng chuáº©n kiá»ƒu dÃ¢n hay nháº­u Ä‘Ã¢y nÃ y
Tháº¯ng HoÃ ng	Viruss gáº§y nhÆ° thg nghiá»‡n Ã½ ae Ã  :))
Cao Manh	Tee nÃ¡t vÃ£i Ä‘áº¡n ğŸ˜‚ğŸ˜‚ğŸ˜‚
NL T	Ã”ng tee uá»‘ng kinh tháº¿
Nguyá»…n Trung	NhÃ  anh HoÃ ng ráº¥t nhiá»u ná»“i. VÃ£i riáº¿t nhÆ°ng váº«n chÆ°a háº¿t ná»“i :))
Nguyen Nguyen	VÃ£i cáº£ ná»“i vÃ£i cáº£ Ä‘áº¡n Ã— 3.14
Thu Tang	PhÆ°Æ¡ng Ly xinh qtqÄ‘ <3
Nguyen Thang	Ã´ng ná»™i Viruss á»‘m quÃ¡, pháº£i lÃªn táº§m 10-15kg ná»¯a thÃ¬ Ä‘áº¹p trai :D
khang nguyá»…n	nhaÌ€ anh khÃ´ng coÌ gi ngoaÌ€i  " nÃ´Ì€i vÆ¡Ìi Ä‘aÌ£n "
TrÃ¬nh Nguyá»…n	Vr Ã´ng bá»›t máº·c cáº£ vá»›i ngÆ°á»i xem Ä‘i nha Háº¿t mÃ¬nh vá»›i ngÆ°á»i xem Ä‘iğŸ»ğŸ» zÃ´ğŸ¤ª
ueki cute	Team a ko thá»ƒ nhá»‹n cÆ°á»i Ä‘cğŸ˜‚
phong ngÃ´ vÄƒn	Hay Ä‘Ã³
Vit Æ¡i	theo dÃµi háº¿t video thÃ¬ xÃ¡c nháº­n anh Viruss uá»‘ng dc rÆ°á»£u nhÆ°ng do la anh k thÃ­ch uá»‘ng vÃ  anh k uá»‘ng nhiá»u nÃªn lÃ  chÆ°a qen :))) chá»© Ä‘á»ƒ mÃ  uÃ´ng qen r thÃ¬ ghÃª pháº£i biáº¿t
ThÃ­ch Cover	Vui quÃ¡
Máº¡nh Nguyá»…n VÄƒn	Justa kÃ­ch :v
Zing Minh	uá»‘ng rÆ°á»£u cÃ³ thÃªm cÃ¡i Ä‘Ã n thÃ¬ phÃª ná»¯a cÃ¡c Ã´ng áº¡ <3
ë² íŠ¸ë‚¨ì¹œêµ¬ë“¤	Cháº¿ Viruss máº·c Ã¡o kia nhÃ¬n gáº§y quÃ¡.....ğŸ˜‚ğŸ˜‚ğŸ˜‚ğŸ˜‚ğŸ˜‚ğŸ˜‚ğŸ˜‚
Tam Bui	Tee láº§y vc! Cá»© nhÆ° váº­y má»›i lÃ  ngÆ°á»i thoáº£i mÃ¡i
ThÃ nh Mai	LÃ m thÃªm clip ná»¯a Ä‘i anh, nhÆ°ng thay vÃ¬ Ä‘áº¿m sá»‘ ly Ä‘Ã£ uá»‘ng thÃ¬ anh lÃ m Ä‘áº¿m sá»‘ cÃ¢u â€œvÃ£i ná»“i, vÃ£i Ä‘áº¡nâ€ tá»« Ä‘áº§u Ä‘áº¿n cuá»‘i clip :)))
Minh MÃ y MÃ²	136 cÃ¢u vÃ£i ná»“i
Kai Osti	PhÆ°Æ¡ng Ly xinh quÃ¡ :(
anh turtle	Up top 1 cho tháº±ng Ä‘iÃªn nÃ o mn ğŸ˜‡ğŸ˜‡ğŸ˜‡
Tuan MG	Anh tee bÃª quÃ¡ ğŸ˜
BÃ¹i XuÃ¢n Thá»§y	Uá»‘ng Ä‘Æ°á»£c thÃ¬ uá»‘ng khÃ´ng uá»‘ng Ä‘Æ°á»£c thÃ¬ rÃ¡ng uá»‘ng a Virusss Æ¡i ^^
bÃ© trung	Äoáº¡n cuá»‘i nÃ³i lÃªn táº¥t cáº£  tee cÃ³ trÃ¢u Ä‘áº¿n Ä‘Ã¢u cÅ©ng  pháº£i  náº±m sáº¥p  :))
#Thá»‹nh	NhÃ¬n viruss gáº§y y há»‡t lynk lee :v Ä‚n nhiá»u vÃ o !
Ä‘á»— minh phÆ°Æ¡ng	viruss liá»‡u Ä‘Æ°á»£c 50kg khÃ´ng
Thu Háº±ng Nguyá»…n	Viruss sao gáº§y quÃ¡ váº­y anh Æ¡i :)))
Kevin Hiáº¿u	Ná»“i vs Ä‘áº¡n
QuÃ¢n Nguyá»…n	Tee Ã¡c vccccc
Thanh Lá»‹ch Official	Ly nháº­u thÃ¬ thÃ´i rá»“i
Leo Nguyá»…n	nÃºt haha chá»— nÃ o nhá»‰
nam nguyá»…n	Ã´ T gia trÆ°á»Ÿng nha :v :(
Tháº£o lÃ  Cá»	CÃ¢u "Äáº¥y lÃ  viá»‡c cá»§a Ã´ng" vá»›i " VÃ£i cáº£ ná»“iii áº¡! " sáº¯p thÃ nh cÃ¢u cá»­a miá»‡ng cá»§a t rá»“i ğŸ˜‚ğŸ˜‚
Chung HÃ  XuÃ¢n Báº£o	Ba Ã´ng nÃ y hÃ i vÃ£i chÆ°á»Ÿng kkkkkkkk
SÆ¡n LÃ¢m	Anh em Báº¯c tá»¥ há»p trong Nam =))))
Glenn Wick	a Tee howi nats qua =)))))
HoÃ ng ThiÃªn Vlogs	HÃ´m nay ko say ko vá»
Hiáº¿u Pháº¡m	ghÃ©t nháº¥t thá»ƒ loáº¡i uá»‘ng rÆ°á»£u mÃ  cá»© Ã©p, ngta k uá»‘ng Ä‘c thÃ¬ Ä‘á»«ng Ã©p, ná»ƒ nÃªn uá»‘ng Ä‘áº¿n chá»¥c nhÃ¡y r mÃ  váº«n cá»‘ tÃ¬nh, nhÃ¬n ngta sáº¯p ngá»m máº¹ ra Ä‘áº¥y rá»“i cÃ²n gÃ¬ :))
ss Lolicon	hÃ i vl
Hao Hao	ÄÃ¹a vá»›i justatee ak
San LÃª	Dá»… thÆ°Æ¡ng quÃ¡ : )) Ã€ báº£o Tee nhá»› >w<
Ngá»c TÃ¡o vlogs	Ä‘á»£i mÃ£i cÃ¡i video nÃ y hÃ´m Ä‘Ã³ e ko dc xem hehe xem sáº¿p uá»‘ng tháº¿ nÃ o
PVN clips	" VÃ£i cáº£ ná»“i"  cÃ¢u nÃ y láº·p láº¡i hÆ¡i nhiá»u
Anh LÃ¢m	HÃ€I Ä THá»‚ Táº¢ ÄC :))))))))))))))))))))))
NTV Smile	ThÃ­ck nháº­u vá»›i just ng nhÆ° nÃ y vui láº¯m. Vr nay gáº·p cao thá»§ sm rá»“i kk
Tiáº¿n Pháº¡m	TÃ´i tháº¥y cÃ¡i video cÃ³ 14â€™34s mÃ  á»•ng cÃ³ 1,2 cÃ¢u á»•ng ns Ä‘i ns láº¡i,... tÃ´i hk ns ra cháº¯c máº¥y Ã´g bik lÃ  j r chá»© ğŸ˜‘ğŸ˜‘ğŸ˜‘
Danh Tráº§n	Sao anh khÃ´ng cho Ä‘áº¿m cÃ¡i cÃ¢u â€œvÃ£i cáº£ ná»“iâ€ vá»›i â€œvÃ£i cáº£ Ä‘áº¡nâ€ Ã¡ anh
Huynh Nguyen	Uá»‘ng nÆ°á»›c lÃ£ nhiá»u tháº¿ a Viruss :)))
Trung Cao	k biáº¿t lÃ  Ã´ng tee nÃ³i nhiá»u tháº¿ Ä‘Ã¢u :)))
smile 25	Tee Ä‘á»‰nh quÃ¡
Nguyá»…n NghÄ©a	Justtea vá»›i PhÆ°Æ¡ng Ly láº§y quÃ¡ hÃ i hÆ°á»›c ná»¯a coi cÆ°á»i Ä‘au bá»¥ng á»§ng há»™ nhÃ³m Ä‘iÃªn ğŸ˜‚
Hieu Pham Trung	=)))))))))
Nam Äinh	vÃ£i cáº£ ná»“i áº¡
Rexx Vigga	uá»‘ng soju Ã ? báº£o sao máº·t Ã´ng T tá»‰nh bÆ¡
Tien Boleo	Em  ko  bao  h  uong ruou
Anh Duc Nguyen	Má»›i hÆ¡n 10 chÃ©n mÃ  ... Top 1 thÃ¬ pháº£i sáº­p chá»© máº¥y ac Ãª. A viruss uá»‘ng nháº¥p mÃ´i Ã  ğŸ˜†
Yang Yang	Viruss khÃ¡ giá»‘ng MC Yoo Jae Suk.
Pháº¡m HÃ¹ng	RÆ°á»£u sochu Ã 
TÆ° Nguyá»…n	PhÆ°Æ¡ng ly lÃ  ai z mn
khoa ha	anh viruss Äƒn nhiá»u vÃ o nhÃ¬n anh cháº³ng khÃ¡c gÃ¬ tá» giáº¥y cáº£=))
Haru Chan	NhÃ¬n tháº¥y rá»“i nhÃ© vr nháº¥p mÃ´i lá»™ nhÃ© :))
LAD Vlog	Chá»‹ Ã¡o Ä‘en xinh tháº¿ anh Æ¡i ğŸ˜ğŸ˜ğŸ˜ğŸ˜ğŸ˜ğŸ˜ğŸ˜ğŸ˜ğŸ˜ğŸ˜
FG Shiro	Ã”ng HoÃ ng cÃ£i lÃ½  Dá»›t Ta Tiiiiiiiiii
Nguyen Phu Da	Haha ğŸ˜‚ má»i Ä‘Ãºng Ã´ng bá»£m nháº­u rá»“i
Dj Wolf	Sayyy thá»¥t l =))â‚©
Hani Leggo HÃ³i	A HoÃ ng gáº§y tháº¿. Má»ng dÃ­nh luÃ´n áº¥y. ğŸ˜‚ğŸ˜‚
HÆ°ng Huyá»n Thoáº¡i Moba	*SAY GAMNING LÃ€ ÄÃ‚Y*
ThÃ¡i LÃª xuÃ¢n	Sn 2001 uá»‘ng dk khoáº£ng 30 chÃ©n máº¯t trÃ¢u :))
YuYu NgoÌ£c	VÃ£i justatee gáº¯t vÃ£i haha ğŸ˜‚ ğŸ˜‚ ğŸ˜‚
Äá»©c Nguyá»…n CÃ´ng	Khá»• thÃ¢n bá»‹ gáº¡.
DOGE IS GOD	2' vÃ£i
Fantastic TÃº Baby	Team nÃ¡t vl hÃ  hÃ¡
Linh Huá»³nh	Wow
Long ThÃ¢n	troiwfiiiiiiiiiiiiiii PhÆ°Æ¡ng Ly uá»‘ng ghÃª dá»… sá»£ ))))
Äáº¡t Nguyá»…n Ngá»c	HÃ i a tee vch :))
Hiáº¿u x	vÃ£i cáº£ ná»“i áº¡ ğŸ˜‚ğŸ˜‚
Trang ThÃ¹y	Ã”ng tee nÃ¡t quÃ¡ rÃ²i :))) báº¯n nhÆ° tháº§y cÃºng váº­y ğŸ˜‚ğŸ˜‚
ÄÃ´ng ÄÃ¢y	ná»“i quá»‘c dÃ¢n :)
Smart NNT	BÃ  Ly tháº¥y ghÃ©t thiá»‡t há»© lÃ m j ko Ã 
Quoc Tuan Bui	VÃ£i cáº£ ná»“i áº¡ =)))
NhiÃªn An	Ã”ng ViruSs gáº§y vl :V
CÃ´ng DÆ°Æ¡ng Channel	Anh LÃ¢m táº©u nhanh quÃ¡ :v
anh dÆ°Æ¡ng	Tee vÄƒn hay vazz
KiÃªn Äáº­u	cÃ´ Ly uá»‘ng tháº§n sáº§u v
Shin Ye Eun	TÆ°á»Ÿng tÆ°á»£ng viruss vs phÆ°Æ¡ng ly lÃ  1 cáº·p......max Ä‘áº¹p Ä‘Ã´i
Minh Duong Nguyen	ÄÃ£ chÆ¡i pháº£i chÆ¡i nhÆ° just
BÃªn Em MÆ°a	NgÃ i Ã¡o xanh má» thÃ¬ 100% mÃ  lÃºc nÃ o cÅ©ng ná»­a ly,  thÃ¡nh
fit247 Eleven	VÃ£i cáº£ lá»“i
Tuáº¥n DÆ°Æ¡ng	Anh rc bÃ i ngÃ y chÆ°a giÃ´ng bÃ£o cá»§a BÃ¹i   Lan HÆ°Æ¡ng anh oi
Kim Chi Huá»³nh Thá»‹	*vÃ£i cáº£ Ä‘áº¡n áº¡* *VÃ£i cáº£ ná»“i áº¡* HÆ¡i nhiá»u hahaha
Thao Tung	Ã´ng lÃ¢m =)))
HxProx.	NhÃ¬n Ã´ng viruss máº¯c cÆ°á»i quÃ¡
COTREAL HD	*Uá»NG ÄÆ¯á»¢C THÃŒ Uá»NG, KHÃ”NG Uá»NG ÄÆ¯á»¢C THÃŒ...CÅ¨NG Gáº®NG MÃ€ Uá»NG :)) ÄÃ” J.TEE CÅ¨NG CAO NHá»ˆ :)) **P.LY** ÄÃƒ XINH Rá»’I CÃ’N Uá»NG RIá»†U Ná»®A CÃ€NG XINH HÆ N :)) MÃ€ ÄÃ‚Y RIÃŠá»¤ GÃŒ MÃ€ NGHE MÃ™I NHáº T NHáº¸ Váº¬Y A H.VIRUSS*
Heo Pham	Ã”ng tee say rá»“i kkk
Quang Gia Dang	Ná»“i vá»›i Ä‘áº¡n Ä‘Ã¢u láº¯m thÃ­a :3
NgoÌ£c AÌnh PhaÌ£m	VÃ£i ná»“i...vÃ£i Ä‘áº¡n...anh say nhÆ°g tim anh Ä‘ang Ä‘au :)))
Lam Nguyen	Uá»‘ng bia , rÆ°á»£u mÃ  máº·t Ä‘á» lÃ  khÃ´ng tá»‘t nhÃ© ! Khoa há»c chá»©ng minh rá»“i chá»© khÃ´ng pháº£i do mÃ¡u gÃ¬ Ä‘á» Ä‘Ã¢u , mÃ  lÃ  bá»‹ ngá»™ Ä‘á»™c nháº¹ Ä‘Ã³ ! Bá» Ä‘i nhÃ©
TÃt Nguyá»„n	VÃ£i cáº£ ná»“i áº¡
Thá»© Nguyá»…n	máº¥t hÃ¬nh tÆ°á»£ng Just quÃ¡
Trang Nguyá»…n Thá»‹ ThÃ¹y	Sáº¿p Rá»›t cÃ²n gáº§y hÆ¡n chá»‹ PhÆ°Æ¡ng Ly ná»¯a trÆ¡Ì€i Æ¡iiiiiii hÃ¢hha
Háº£i CkÃ½p	CÃ¡i kiá»ƒu cá»§a Justatee uá»‘ng lÃ  tá»›i báº¿n luÃ´n. Káº¿t rá»“i Ä‘áº¥y ğŸ¤£
Tráº§n Tuáº¥n	NgÆ°á»i cá»§a cÃ´ng chÃºng uá»‘ng rÆ°á»£u nÃ³i cÅ©ng hay mÃ  Ä‘Ã£ nÃ¡t thÃ¬ cÅ©ng nÃ¡t cÃ³ bÃ i cÃ³ báº£n Ä‘Ãºng lÃ  idol ğŸ˜ğŸ˜ğŸ˜ğŸ˜
Äan28 Bi	Sup chÃ³o qua kÃªnh tui
Tknt Thiá»‡m	Ã”ng tee thÃ¡nh nháº­u máº¹ rá»“i , vÄƒn vÃ£i ná»“i , nhÆ° nÃ y chá»‘i Ä‘c cá»‘c nÃ o :)))
Ngá»c ThÄƒng Pháº¡m	Äau ruá»™t
Huy Nguyen	rÆ°á»£u gÃ¬ Ä‘Ã³ viruss
QuÃ­ LÃª Trá»ng	Tee chuáº©n vÃ£i.^^.
Vinh DÆ°Æ¡ng	CÃ³ ai nhÆ° tui k.Uá»‘ng rÆ°á»£u máº·t Ä‘á» lá»« nhÆ°ng ko say.
viá»‡t LÆ°u	Anh tee nÃ³i hay tháº­t
Su- Tá»‘ NhÆ°	Xem mÃ  cÆ°á»i á»‰a
DÆ°Æ¡ng HoÃ ng	Anh Viruss váº«n uá»‘ng Ä‘c ná»¯a mÃ 
NguyÃªÌƒn Ä‘ÄƒÌc Phong	Chá»‹ ly xinh gÃ¡i :)
[V] Lá»C Zz	Tee lÃ  lÃ­ do anh say :)))
BÃ¡ch hÃ³a toÃ n thÆ° lÃ¡c Nguyá»…n	ğŸ˜‚ğŸ˜‚ğŸ˜‚ğŸ˜‚ğŸ˜‚ğŸ˜‚ğŸ˜‚ğŸ˜‚ğŸ˜‚ğŸ˜‚ğŸ˜‚ğŸ˜‚ğŸ˜‚ğŸ˜‚ğŸ˜‚ğŸ˜‚ğŸ˜‚ğŸ˜‚ğŸ˜‚ğŸ˜‚ğŸ˜‚ğŸ˜‚ğŸ˜‚ğŸ˜‚ğŸ˜‚ğŸ˜‚ğŸ˜‚ğŸ˜‚ğŸ˜‚ğŸ˜‚ğŸ˜‚ğŸ˜‚ğŸ˜‚ğŸ˜‚ğŸ˜‚ğŸ˜‚ğŸ˜‚ğŸ˜‚ğŸ˜‚ğŸ˜‚ğŸ˜‚ğŸ˜‚ğŸ˜‚ğŸ˜‚ğŸ˜‚ğŸ˜‚ğŸ˜‚ğŸ˜‚ğŸ˜‚ğŸ˜‚ğŸ˜‚ğŸ˜‚ğŸ˜‚ğŸ˜‚ğŸ˜‚ğŸ˜‚ğŸ˜‚ğŸ˜‚ğŸ˜‚ğŸ˜‚ğŸ˜‚ğŸ˜‚ğŸ˜‚ğŸ˜‚ğŸ˜‚ğŸ˜‚ğŸ˜‚ğŸ˜‚ğŸ˜‚ğŸ˜‚ğŸ˜‚ğŸ˜‚ğŸ˜‚ğŸ˜‚ğŸ˜‚ğŸ˜‚ğŸ˜‚ğŸ˜‚ğŸ˜‚ğŸ˜‚ğŸ˜‚ğŸ˜‚ğŸ˜‚ğŸ˜‚ğŸ˜‚ğŸ˜‚ğŸ˜‚ğŸ˜‚ğŸ˜‚ğŸ˜‚ğŸ˜‚ğŸ˜‚ğŸ˜‚ğŸ˜‚ğŸ˜‚ğŸ˜‚ğŸ˜‚ğŸ˜‚ğŸ˜‚ğŸ˜‚ğŸ˜‚ğŸ˜‚ğŸ˜‚ğŸ˜‚ğŸ˜‚ğŸ˜‚ğŸ˜‚ğŸ˜‚ğŸ˜‚ğŸ˜‚ğŸ˜‚ğŸ˜‚ğŸ˜‚ğŸ˜‚ğŸ˜‚ğŸ˜‚ğŸ˜‚ğŸ˜‚ğŸ˜‚ğŸ˜‚ğŸ˜‚ğŸ˜‚ğŸ˜‚ğŸ˜‚ğŸ˜‚ğŸ˜‚ğŸ˜‚ğŸ˜‚ğŸ˜‚ğŸ˜‚ğŸ˜‚ğŸ˜‚ğŸ˜‚ğŸ˜‚ğŸ˜‚ğŸ˜‚ğŸ˜‚ğŸ˜‚ğŸ˜‚ğŸ˜‚ğŸ˜‚ğŸ˜‚ğŸ˜‚ğŸ˜‚ğŸ˜‚ğŸ˜‚ğŸ˜‚ğŸ˜‚ğŸ˜‚ğŸ˜‚ğŸ˜‚ğŸ˜‚ğŸ˜‚ğŸ˜‚ğŸ˜‚ğŸ˜‚ğŸ˜‚ğŸ˜‚ğŸ˜‚ğŸ˜‚ğŸ˜‚ğŸ˜‚ğŸ˜‚ğŸ˜‚ğŸ˜‚ğŸ˜‚ğŸ˜‚ğŸ˜‚ğŸ˜‚ğŸ˜‚ğŸ˜‚ğŸ˜‚ğŸ˜‚ğŸ˜‚ğŸ˜‚ğŸ˜‚ğŸ˜‚ğŸ˜‚ğŸ˜‚ğŸ˜‚ğŸ˜‚ğŸ˜‚ğŸ˜‚ğŸ˜‚ğŸ˜‚ğŸ˜‚ğŸ˜‚ğŸ˜‚ğŸ˜‚ğŸ˜‚ğŸ˜‚ğŸ˜‚ğŸ˜‚ğŸ˜‚ğŸ˜‚ğŸ˜‚ğŸ˜‚ğŸ˜‚ğŸ˜‚ğŸ˜‚ğŸ˜‚ğŸ˜‚ğŸ˜‚ğŸ˜‚ğŸ˜‚ğŸ˜‚ğŸ˜‚ğŸ˜‚ğŸ˜‚ğŸ˜‚ğŸ˜‚ğŸ˜‚ğŸ˜‚ğŸ˜‚ğŸ˜‚ğŸ˜‚ğŸ˜‚ğŸ˜‚ğŸ˜‚ğŸ˜‚ğŸ˜‚ğŸ˜‚ğŸ˜‚ğŸ˜‚ğŸ˜‚ğŸ˜‚ğŸ˜‚ğŸ˜‚ğŸ˜‚ğŸ˜‚ğŸ˜‚ğŸ˜‚ğŸ˜‚ğŸ˜‚ğŸ˜‚ğŸ˜‚ğŸ˜‚ğŸ˜‚ğŸ˜‚ğŸ˜‚ğŸ˜‚ğŸ˜‚ğŸ˜‚ğŸ˜‚ğŸ˜‚ğŸ˜‚ğŸ˜‚ğŸ˜‚ğŸ˜‚ğŸ˜‚ğŸ˜‚ğŸ˜‚ğŸ˜‚ğŸ˜‚ğŸ˜‚ğŸ˜‚ğŸ˜‚ğŸ˜‚ğŸ˜‚ğŸ˜‚ ğŸ˜‚ğŸ˜‚ğŸ˜‚ğŸ˜‚ğŸ˜‚ğŸ˜‚ğŸ˜‚ğŸ˜‚ğŸ˜‚ğŸ˜‚ğŸ˜‚ğŸ˜‚ğŸ˜‚ğŸ˜‚ğŸ˜‚ğŸ˜‚ğŸ˜‚ğŸ˜‚ğŸ˜‚ğŸ˜‚ğŸ˜‚ğŸ˜‚ğŸ˜‚ğŸ˜‚ğŸ˜‚ğŸ˜‚ğŸ˜‚ğŸ˜‚ğŸ˜‚ğŸ˜‚ğŸ˜‚ğŸ˜‚ğŸ˜‚ğŸ˜‚ğŸ˜‚ğŸ˜‚ğŸ˜‚ğŸ˜‚ğŸ˜‚ğŸ˜‚ğŸ˜‚ğŸ˜‚ğŸ˜‚ğŸ˜‚ğŸ˜‚ğŸ˜‚ğŸ˜‚ğŸ˜‚ğŸ˜‚ğŸ˜‚ğŸ˜‚ğŸ˜‚ ğŸ˜‚ğŸ˜‚ğŸ˜‚ğŸ˜‚ğŸ˜‚ğŸ˜‚ğŸ˜‚ğŸ˜‚ğŸ˜‚ğŸ˜‚ğŸ˜‚ğŸ˜‚ğŸ˜‚ğŸ˜‚ğŸ˜‚ğŸ˜‚ğŸ˜‚ğŸ˜‚ğŸ˜‚ğŸ˜‚ğŸ˜‚ğŸ˜‚ğŸ˜‚ğŸ˜‚ğŸ˜‚ğŸ˜‚ğŸ˜‚ğŸ˜‚ğŸ˜‚ğŸ˜‚ğŸ˜‚ğŸ˜‚ğŸ˜‚ğŸ˜‚ğŸ˜‚ğŸ˜‚ğŸ˜‚ğŸ˜‚ğŸ˜‚ğŸ˜‚ğŸ˜‚ğŸ˜‚ğŸ˜‚ğŸ˜‚ğŸ˜‚ğŸ˜‚ğŸ˜‚ğŸ˜‚ğŸ˜‚ğŸ˜‚ğŸ˜‚ğŸ˜‚ ğŸ˜‚ğŸ˜‚ğŸ˜‚ğŸ˜‚ğŸ˜‚ğŸ˜‚ğŸ˜‚ğŸ˜‚ğŸ˜‚ğŸ˜‚ğŸ˜‚ğŸ˜‚ğŸ˜‚ğŸ˜‚ğŸ˜‚ğŸ˜‚ğŸ˜‚ğŸ˜‚ğŸ˜‚ğŸ˜‚ğŸ˜‚ğŸ˜‚ğŸ˜‚ğŸ˜‚ğŸ˜‚ğŸ˜‚ğŸ˜‚ğŸ˜‚ğŸ˜‚ğŸ˜‚ğŸ˜‚ğŸ˜‚ğŸ˜‚ğŸ˜‚ğŸ˜‚ğŸ˜‚ğŸ˜‚ğŸ˜‚ğŸ˜‚ğŸ˜‚ğŸ˜‚ğŸ˜‚ğŸ˜‚ğŸ˜‚ğŸ˜‚ğŸ˜‚ğŸ˜‚ğŸ˜‚ğŸ˜‚ğŸ˜‚ğŸ˜‚ğŸ˜‚ ğŸ˜‚ğŸ˜‚ğŸ˜‚ğŸ˜‚ğŸ˜‚ğŸ˜‚ğŸ˜‚ğŸ˜‚ğŸ˜‚ğŸ˜‚ğŸ˜‚ğŸ˜‚ğŸ˜‚ğŸ˜‚ğŸ˜‚ğŸ˜‚ğŸ˜‚ğŸ˜‚ğŸ˜‚ğŸ˜‚ğŸ˜‚ğŸ˜‚ğŸ˜‚ğŸ˜‚ğŸ˜‚ğŸ˜‚ğŸ˜‚ğŸ˜‚ğŸ˜‚ğŸ˜‚ğŸ˜‚ğŸ˜‚ğŸ˜‚ğŸ˜‚ğŸ˜‚ğŸ˜‚ğŸ˜‚ğŸ˜‚ğŸ˜‚ğŸ˜‚ğŸ˜‚ğŸ˜‚ğŸ˜‚ğŸ˜‚ğŸ˜‚ğŸ˜‚ğŸ˜‚ğŸ˜‚ğŸ˜‚ğŸ˜‚ğŸ˜‚ğŸ˜‚ ğŸ˜‚ğŸ˜‚ğŸ˜‚ğŸ˜‚ğŸ˜‚ğŸ˜‚ğŸ˜‚ğŸ˜‚ğŸ˜‚ğŸ˜‚ğŸ˜‚ğŸ˜‚ğŸ˜‚ğŸ˜‚ğŸ˜‚ğŸ˜‚ğŸ˜‚ğŸ˜‚ğŸ˜‚ğŸ˜‚ğŸ˜‚ğŸ˜‚ğŸ˜‚ğŸ˜‚ğŸ˜‚ğŸ˜‚ğŸ˜‚ğŸ˜‚ğŸ˜‚ğŸ˜‚ğŸ˜‚ğŸ˜‚ğŸ˜‚ğŸ˜‚ğŸ˜‚ğŸ˜‚ğŸ˜‚ğŸ˜‚ğŸ˜‚ğŸ˜‚ğŸ˜‚ğŸ˜‚ğŸ˜‚ğŸ˜‚ğŸ˜‚ğŸ˜‚ğŸ˜‚ğŸ˜‚ğŸ˜‚ğŸ˜‚ğŸ˜‚ğŸ˜‚ ğŸ˜‚ğŸ˜‚ğŸ˜‚ğŸ˜‚ğŸ˜‚ğŸ˜‚ğŸ˜‚ğŸ˜‚ğŸ˜‚ğŸ˜‚ğŸ˜‚ğŸ˜‚ğŸ˜‚ğŸ˜‚ğŸ˜‚ğŸ˜‚ğŸ˜‚ğŸ˜‚ğŸ˜‚ğŸ˜‚ğŸ˜‚ğŸ˜‚ğŸ˜‚ğŸ˜‚ğŸ˜‚ğŸ˜‚ğŸ˜‚ğŸ˜‚ğŸ˜‚ğŸ˜‚ğŸ˜‚ğŸ˜‚ğŸ˜‚ğŸ˜‚ğŸ˜‚ğŸ˜‚ğŸ˜‚ğŸ˜‚ğŸ˜‚ğŸ˜‚ğŸ˜‚ğŸ˜‚ğŸ˜‚ğŸ˜‚ğŸ˜‚ğŸ˜‚ğŸ˜‚ğŸ˜‚ğŸ˜‚ğŸ˜‚ğŸ˜‚ğŸ˜‚ ğŸ˜‚ğŸ˜‚ğŸ˜‚ğŸ˜‚ğŸ˜‚ğŸ˜‚ğŸ˜‚ğŸ˜‚ğŸ˜‚ğŸ˜‚ğŸ˜‚ğŸ˜‚ğŸ˜‚ğŸ˜‚ğŸ˜‚ğŸ˜‚ğŸ˜‚ğŸ˜‚ğŸ˜‚ğŸ˜‚ğŸ˜‚ğŸ˜‚ğŸ˜‚ğŸ˜‚ğŸ˜‚ğŸ˜‚ğŸ˜‚ğŸ˜‚ğŸ˜‚ğŸ˜‚ğŸ˜‚ğŸ˜‚ğŸ˜‚ğŸ˜‚ğŸ˜‚ğŸ˜‚ğŸ˜‚ğŸ˜‚ğŸ˜‚ğŸ˜‚ğŸ˜‚ğŸ˜‚ğŸ˜‚ğŸ˜‚ğŸ˜‚ğŸ˜‚ğŸ˜‚ğŸ˜‚ğŸ˜‚ğŸ˜‚ğŸ˜‚ğŸ˜‚ ğŸ˜‚ğŸ˜‚ğŸ˜‚ğŸ˜‚ğŸ˜‚ğŸ˜‚ğŸ˜‚ğŸ˜‚ğŸ˜‚ğŸ˜‚ğŸ˜‚ğŸ˜‚ğŸ˜‚ğŸ˜‚ğŸ˜‚ğŸ˜‚ğŸ˜‚ğŸ˜‚ğŸ˜‚ğŸ˜‚ğŸ˜‚ğŸ˜‚ğŸ˜‚ğŸ˜‚ğŸ˜‚ğŸ˜‚ğŸ˜‚ğŸ˜‚ğŸ˜‚ğŸ˜‚ğŸ˜‚ğŸ˜‚ğŸ˜‚ğŸ˜‚ğŸ˜‚ğŸ˜‚ğŸ˜‚ğŸ˜‚ğŸ˜‚ğŸ˜‚ğŸ˜‚ğŸ˜‚ğŸ˜‚ğŸ˜‚ğŸ˜‚ğŸ˜‚ğŸ˜‚ğŸ˜‚ğŸ˜‚ğŸ˜‚ğŸ˜‚ğŸ˜‚ ğŸ˜‚ğŸ˜‚ğŸ˜‚ğŸ˜‚ğŸ˜‚ğŸ˜‚ğŸ˜‚ğŸ˜‚ğŸ˜‚ğŸ˜‚ğŸ˜‚ğŸ˜‚ğŸ˜‚ğŸ˜‚ğŸ˜‚ğŸ˜‚ğŸ˜‚ğŸ˜‚ğŸ˜‚ğŸ˜‚ğŸ˜‚ğŸ˜‚ğŸ˜‚ğŸ˜‚ğŸ˜‚ğŸ˜‚ğŸ˜‚ğŸ˜‚ğŸ˜‚ğŸ˜‚ğŸ˜‚ğŸ˜‚ğŸ˜‚ğŸ˜‚ğŸ˜‚ğŸ˜‚ğŸ˜‚ğŸ˜‚ğŸ˜‚ğŸ˜‚ğŸ˜‚ğŸ˜‚ğŸ˜‚ğŸ˜‚ğŸ˜‚ğŸ˜‚ğŸ˜‚ğŸ˜‚ğŸ˜‚ğŸ˜‚ğŸ˜‚ğŸ˜‚ ğŸ˜‚ğŸ˜‚ğŸ˜‚ğŸ˜‚ğŸ˜‚ğŸ˜‚ğŸ˜‚ğŸ˜‚ğŸ˜‚ğŸ˜‚ğŸ˜‚ğŸ˜‚ğŸ˜‚ğŸ˜‚ğŸ˜‚ğŸ˜‚ğŸ˜‚ğŸ˜‚ğŸ˜‚ğŸ˜‚ğŸ˜‚ğŸ˜‚ğŸ˜‚ğŸ˜‚ğŸ˜‚ğŸ˜‚ğŸ˜‚ğŸ˜‚ğŸ˜‚ğŸ˜‚ğŸ˜‚ğŸ˜‚ğŸ˜‚ğŸ˜‚ğŸ˜‚ğŸ˜‚ğŸ˜‚ğŸ˜‚ğŸ˜‚ğŸ˜‚ğŸ˜‚ğŸ˜‚ğŸ˜‚ğŸ˜‚ğŸ˜‚ğŸ˜‚ğŸ˜‚ğŸ˜‚ğŸ˜‚ğŸ˜‚ğŸ˜‚ğŸ˜‚
huuthien Phac	Sao gÃ¢y tháº¿ a Virusss
EDM NEW	Xin chÃ o Viruss
ÄÆ°Ìc Anh NguyÃªÌƒn	Ã”ng Tee láº§y vl, rÆ°á»£u báº¥t kháº£ Ã©p ~> Ã©p báº¥t kháº£ tá»« ~> tá»« tá»« rá»“i cÅ©ng háº¿t. Gáº·p Ä‘á»™i ca si lÃ¡t nÃ y thÃ¬ chá»‰ cÃ³ gá»i huá»‡ thÃ´i :v bÃ  Ly cÅ©ng gá»i lÃ  biáº¿t chÆ¡i Ä‘áº¥y :)))
The Carry	Ly xinh quÃ¡ ğŸ˜ğŸ˜ğŸ˜
Sentinel Zzz	Tháº­t ra Ã©p rÆ°á»£u hay nÃ© rÆ°á»£u cÅ©ng pháº£i cÃ³ nghá»‡ thuáº­t háº¿t, lÃ m tháº¿ nÃ o k máº¥t lÃ²ng nhau mÃ  váº«n vui lÃ  thÃ nh cÃ´ng rá»“i =))
Hoang Tu	Chá»‹ ly xinh tháº¿  Anh hoÃ ng yáº¿u quÃ¡
quang hung	Ná»“i vÃ  Ä‘áº¡n quá»‘c dÃ¢n
Tháº¯ng ÄoÃ n Minh	CÃ² hÆ°Æ¡ng vcl :))
quang tráº§n	ChÃ©n Ä‘ gÃ¬ to vcl , cháº¯c rÆ°á»£u nÃ y nháº¹ thÃ´i , chá»© náº·ng rÃ³t táº§m nhÆ° nÃ y cháº¯c phá»t ra luÃ´n máº¥t
PhÃºc Kig	uá»‘ng rÆ°á»£u vÃ o rá»“i nÃ³i nháº£m vÃ£i
Tzil	PhÆ°Æ¡ng ly uá»‘ng gáº¯t ghÃª , nguyÃªn lÃ½ mÃ  tháº¥y máº·t bth luÃ´n ms ghÃª chá»© :))
Levi Ackerman	PhÆ°Æ¡ng ly cute vl :v
Tháº±ng LÆ°á»i	uá»‘ng ghÃª tháº¿ :v
minh má»‘c	RÆ°Æ¡Ì£u haÌ€n Ä‘uÌg k mÃ¢Ìy Ã´g  thÃªÌ thiÌ€ nhÄƒÌ€m nhoÌ€ giÌ€
Máº¡nh Tháº¿ DÅ©ng Nguyá»…n	Tee khÃ©o kinh :))
ToÃ n Sida	vi dÃºt nháº¡t vÃ£i cá»© vÃ£i cáº£ Ä‘áº¡n vá»›i cáº£ vÃ£i cáº£ ná»“i . tee Ä‘anh Ä‘Ã¡ quÃ¡
K Cloud 1304	Tee kiá»ƒu Äƒn nÃ³i vÄƒn váº» vcl. Chuáº©n máº«u Ä‘Ã n Ã´ng r
Bian	PhÃª
Nháº¡c game Offcial	https://youtu.be/9S2AMZNTOcY
B L A C K	Cháº¿t má»£, anh Tee bÃ¬nh thÆ°á»ng Ã­t nÃ³i, uá»‘ng vÃ´ sao hÃ³a chao nÃ³i nhÆ° tháº§n tháº¿ nÃ y.
Cu's TÃ­'ss	Th kia cÃ³ uá»‘ng dell Ä‘Ã¢u lá»«a virrus uá»‘ng thÃ´i
Thanh VÃ¢n #VMin #Meanie #LinHoon #JackMark	. "TÃ´i sáº½ che chá»Ÿ cho Ã´ng" :))
Ngoc Xuan Nguyen	Haha anh justi nÃ³i nhiá»i quÃ¡
Nam LÃ¡o Official	Trug bÃ¬nh cá»© 5ly Ä‘áº¥y lÃ  dk 100 mÃ  uá»‘g 13ly cá»© cho lÃ  ms dk 300 váº«n chÆ°a dk ná»­a lÃ½ mÃ  cÃ¡i nÃ y cÃ²n pháº£i uá»‘g nhiá»u :v
Hiáº¿u Super	A tee giÃ´Ìng tui say laÌ€ noÌi chuyÃªÌ£n nhiÃªÌ€u caÌ€ng say caÌ€ng noÌi :))
Spice T	Ai tháº¥y phÆ°Æ¡ng ly xinh gÃ¡i lá»“n to Ä‘iá»ƒm danhhhhhh !!!!!
Quá»‘c ToÃ n	Clip nÃ y hay quÃ¡ cÆ°á»i Ä‘au bá»¥ng  :))
Tat Hoan	Viruss nhjn khá»• vai kakaka
DÆ°Æ¡ng Gia Thoáº¡i	VÃ£i cáº£ ná»“i ra VÃ£i cáº£ Ä‘áº¡n ra
Tiáº¿n Anh Nguyá»…n	CÃ³ pháº£i Ã´ng ngá»“i bÃªn pháº£i hay Ä‘Ã³ng phim khÃ´ng ta
Tráº§n Anh Tuáº¥n	Biáº¿t lÃ  nhiá»u khi Ã©p lÃ  ko hay nhÆ°ng ngá»“i bÃ n nháº­u pháº£i cÃ³ 1 2 thanh niÃªn báº¯t lá»—i tháº¿ nÃ y má»›i vui
KhoÌi BuÌ£i	VÄ‚N Uá»NG RÆ¯á»¢U Cá»§a Team SS Jus PhÆ°Æ¡ng Ly kinh vÃ£i chÆ°á»Ÿng :))) vÄƒn uá»‘ng ruowjy kinh tháº¿
Tuan Nguyen	PhÆ°Æ¡ng Ly cá»§a em Ä‘Ã¢u anh
Long Ninja TÃ¡o	Khi rÆ°á»£u Ä‘Ã£ ngáº¥m
hiáº¿u vÃµ	Thanh niÃªn bÃ¡n ná»“i lá»›n nháº¥t vá»‹nh nam bá»™ :v
Dung Ngo	hoÃ ng gáº§y quÃ¡ hoÃ ng Æ¡i...
BÃ¹i ThÃ nh Äáº¡t	Má»i Justatee lÃ  sai rá»“i ğŸ˜‚ğŸ˜‚
KhÃ¡nh Nguyá»…n	Viruss sai láº§m khi má»i phÆ°Æ¡ng ly vs justatea vá» uá»‘ng. PhÆ°Æ¡ng ly vá»«a xinh mÃ  uá»‘ng ghÃª vcl ÄÃ¡ng lÃ  editor pháº£i Ä‘áº¿m sá»‘ cÃ¢u vÃ£i cáº£ ná»“i áº¡ cá»§a viruss
Truong Le	Cofirm Justti say tá»« Ä‘áº§u clip cmnr:))
Yuno TTN	just say tá»« ly thá»© 5 vÃ  cÃ¡i jeets cÃ³ háº­u
Ronaldo Johnson	VÃ£i ná»“i + vÃ£i Ä‘áº¡n =)))
thu vÄƒn	*ok anh say* (Em lÃ  lÃ½ do anh say)
Máº¡nh QuÃ¢n	VÃ£i cáº£ ná»“i áº¡!!!
BÃ¹i VÄƒn Trung	Uá»‘ng ko láº¡i sao ko gá»i ngÃ¢n sÃ¡t thá»§ Ä‘áº¿n uá»‘ng há»™
Äá»©c Anh NgÃ´	Justa â€œVÄƒnâ€ Tee :))
Danh HoÃ ng	Uá»‘ng rÆ°á»£u kÃªu Ã´ng vs tÃ´i =))) cÃ³ váº» hÆ¡i nháº¡t :v
É´eed Î³ou	Má»›i qua Ä‘i uá»‘ng cÆ°á»›i báº¡n máº¹ 6 tháº±ng ngá»“i vÃ o kÃªu ko Ä‘c Ã©p nhau ae pháº£i Ä‘oÃ n káº¿t chÆ°a dá»©t cÃ¢u 10phÃºt khÃ¡ch tá»›i nÃ³ báº«y máº¥y cÃ¢u máº¥y tháº±ng Ä‘ua nhau dÃ¬m nhau lÃ m máº¹ tÆ°á»Ÿng sÆ°á»›ng lÃ m uá»‘ng sáº¥p máº·t nÃ´n tá»« cÆ°á»›i vá»f Ä‘áº¿n nhÃ  ae Ä‘i uá»‘ng tiá»‡c Ä‘á»«ng tin bá»‘ con tháº±ng nÃ o tá»± cá»©u mÃ¬nh thÃ´i,lá»¡ má»“m 1 cÃ¢u thÃ´i tráº£ giÃ¡ báº±ng viá»‡c pháº¡t uá»‘ng Ä‘Ã©o uá»‘ng chÃºng nÃ³ báº£o mÃ y sang máº¹ bÃ n con gÃ¡i mÃ  ngá»“i . ğŸ˜ğŸ˜
Trong Han	viruss nháº­u ná»“i nhiá»u vÃ£i
01 KhÃ¡nh Ali	CÃ¡i j cx vÃ£i cáº£ lá»“i:3
Hehehe Channel	Vcl
HÆ°ng Bá»m	Thik phÆ°Æ¡ng ly quÃ¡
Le Quang	VIRIT CHá»ˆ BIáº¾T NÃ“I :VÃƒI Cáº¢ Ná»’I. XUá»T Bá»®A NHáº¬U. HÃ€I VL.. ğŸ˜‚ğŸ˜‚. CHá»ŠU LUÃ”N. GÄ‚PH PHáº¢I DÃ‚N NHáº¬U ÄÃCH THá»°C
Tráº§n ÄÃ¬nh Nam	Ã”i ThÃ´i 2 Idol Cá»§a TÃ´i ğŸ˜¢ MÃ¬nh Ngá»“i Xem MÃ  Cá»© CÆ°á»i Anh Rá»›t Ko Ã€ ? CÃ¢u VÃ£i Cáº£ Ná»“i Cháº¯c Ã”ng NÃ³i Äáº¿n Máº¥y Chá»¥c Láº§n ğŸ˜‚ğŸ˜‚
Nguyá»…n Chung	mÃ­a cÃ³ má»—i bÃ i tháº±ng Ä‘iÃªn mÃ ,anh lÃ m láº¯m clip tháº¿
Huong Nguyenthi	PhÆ°Æ¡ng Ly xinh vch maÌ€ ğŸ˜
An ThuyÃªn	Uá»‘ng váº­y chit ng Ä‘Ã³ Äƒn vÃ o chá»© uá»‘ng tháº¿ dá»… ra láº¯m nha ğŸ˜‚ğŸ˜‚ğŸ˜‚
CÃ´ng BÃ¬nh Tráº§n	HÃ¬nh nhÆ° lÃ  anh just cÃ³ lÃ m video vá» uá»‘ng rÆ°á»£p há»£p lÃ½ áº¥y nhá» ğŸ˜€ğŸ˜€ğŸ˜€
HÃ¹ng Nguyá»…n Tuáº¥n	ÄÃ¹ Máº¥t ngÆ°á»i
Tá»‘n Táº¡	Jus noÌi Ã´ng chiÌ‰ cÃ¢Ì€n uÃ´Ìng thÃ´i Ã´ng noÌi nhiÃªÌ€u t Ä‘au Ä‘Ã¢Ì€u lÄƒÌm trong khi jus noÌi nhiÃªÌ€u vl
Nero Tráº§n	Tee nháº­u xong láº§y kinh :))
Sá»¹ Äá»—	Em vá»«a Ä‘i há»c vá» nÃªn like muá»™n
Long Nguyen	CÃ³ ai nghÄ© Ä‘Ã³ lÃ  nÆ°á»›c nhÆ° tao ko ğŸ˜‚
Broken Heart	Tee láº§y =)
Ren KouHa	Cháº³ng lÃ  a hoÃ ng Ã­t uá»‘ng nÃªn k quen thÃ´i..chá»© a hoÃ ng mÃ  uá»‘ng thÃ¬ a Tee chá»‰ cÃ³ nÃ¡t..nhÃ¬n tá»‰nh bÆ¡
YÃªu BÃ³ng ÄÃ¡	Thanh niÃªn uÃ´Ìng rÆ°Æ¡Ì£u cuÌƒng deÌ‰p
Duy D	VaÌƒi caÌ‰ Ä‘aÌ£n
Anh Phan	CÃ¢u cá»§a miá»‡ng:" vÃ£i cáº£ ná»“i áº¡"
An SuÃ½tÄzai	:)))) vl tee :))
Pháº¡m VÄƒn ThÆ°	Ã”ng Tee uá»‘ng rÆ°á»£u vÃ o lÃ  nÃ¡t :3
HJP Channel	Mk uá»‘ng 1,2.. chÃ©n lÃ  máº·t Ä‘á» nhÆ° Ä‘Ã­t khá»‰.cÃ³ ai giá»‘ng mk ko??ğŸ¤—
Ngá»c Thá» BÃ¹i	Nhá»› thÃ¡o tem chai rÆ°á»£u anh nhÃ©
Tuan To	Ly cuá»‘i cÃ¹ng Ã´ng Ä‘Ã£ uá»‘ng Ä‘Ã¢u mÃ  cÃ²n tÃ­nh ly thá»© 15, gian vÃ£i ná»“i
HÃ¹ng Äá»©c LÃª	Say máº¹ rá»“i kkk
j 4 c eå°å¿ƒ	viruss nhin Phuong Ly, kieu, in love cmnr ((=
ChÃ¡o Tráº¯ng	Ly ngon quÃ¡! Em quáº©y háº¿t Ä‘Ãªm Ä‘c Ã¡=))))
Trung Äá»©c VÅ©	Tee láº§y vÃ£i ná»“i =)))))
Hola Hola	lÃ m cÃ¡i Ä‘áº¿m cÃ¢u vÃ£i cáº£ ná»“i xem Ä‘Æ°á»£c bao nhiÃªu Ä‘i :))
Giang Nguyen	A jusstatee ko ve cho con bu Ä‘i a bá» bÃª chi Tram Anh á»Ÿ nha the ha -))))
Hubg Luu	Iu phÆ°Æ¡ng ly
Cuong Quoc	Ã”ng Ã¡o tÃ­m láº§y nÃ³i 100% mÃ  uá»‘ng tÃ½ táº¹o lÃ  bá»
TrÆ° BÃ¡t Giá»›i	Viruss gáº§y lÃ  tháº§y uá»‘ng rÆ°á»£u ğŸ˜ƒ
YÃªu EDM	Tá»•ng  há»£p cuá»™c nÃ³i  chuyá»‡n cá»§a Viruss : VÃ£i cáº£ ná»“i!,VÃ£i Cáº£ Äáº¡n!,VÃ£i cáº£ chÆ°á»Ÿng!...
Hannah Dang	Máº¯t Tee thÃ¢m háº¿t r:( thá»©c khuya nhiá»u quÃ¡ Ä‘áº¥y anh Æ¡iii giá»¯ sá»©c khá»e nhÃ¡:((
ÄoÃ n HoÃ  Dá»±	Uá»‘ng cÃ³ trÃ¡ch nhiá»‡m pháº§n 3 Like a Tee
Hau Ngoc	VÃ£i cáº£ ............!
Nguyá»…n BÃ­ch Huyá»n	Ly cÃ²n ai Ä‘Ã³ Äƒn táº¿t cÃ¹ng nhÆ°ng viruss thÃ¬ ko cho nÃªn lÃ  uá»‘ng Ä‘i =>> tee láº§y vl
Giang Nguyá»…n	vai rá»›t vÃ£i háº¿t cáº£ ná»“i cháº£o , Ä‘áº¡n dÆ°á»£c rá»“i haha
NDT Vlog	A mÄƒÌ£t Ä‘oÌ‰ raÌ€ kiÌ€a anh Viruss
Nguyá»‡t Ãnh	Äá» nghá»‹ a Viruss trÃ­ch 1 sá»‘ tiá»n mua thuá»‘c tÄƒng cÃ¢n =)))
phong van dinh	PhÆ°Æ¡ng Ly
Quoc Bao UTC	Virus nÃ³i hÆ¡i bá»‹ yáº¿u nhá»‰ :3 jusstatee giÃ nh nÃ³i háº¿t :))
áº¨n	CÃ³ chÃºt rÆ°á»£u mÃ  mÃ¬nh láº¡i bay bay tháº¿ nÃ y :))
Yonroot	ThÃ¡nh Tee báº¯t lá»—i kinh
RM5S _NghÄ©a	ThÃ­ch cÃ´ ly ghÃª
pukA phan	VÃ£i cáº£ ná»“i
fKt VÅ©	anh HoÃ ng Æ¡i..! Äƒn uá»‘ng vÃ o......nhÃ¬n giá»‘ng nghiá»‡n rá»“i Ä‘áº¥y......
HoÃ ng Viá»‡t	Ã”ng Tee cá»¥c xÃºc vl ğŸ˜‚
NghÄ©a VÅ©	PhÆ°Æ¡ng ly â¤ï¸
Trá»c Been	á»¦ng há»™ tee. HÃ£y bá»©t phÃ¡ lÃªn vir
tuan nguyen minh	Ná»“i Ä‘Ã¢u ra mÃ  nhiá»u váº­y
CÃ´ng Tuáº¥n TrÆ°Æ¡ng	VÃ£i cáº£ ná»“i :))
TÃº Thanh	Ã”ng tee say láº§y vl
Minh KhÃ´i	NgoÃ i vÃ£i cÃ¡i ná»“i thÃ¬ Ã´ng háº¿t biáº¿t nÃ³i gÃ¬ rá»“i rá»“i áº¡ ??
Toáº£n Tráº§n	PhÆ°Æ¡ng ly xinh quÃ© ğŸ˜ğŸ˜ğŸ˜
Tuáº¥n Linh LÃª	Cáº£ Ä‘áº§u Ä‘áº¿n cuá»‘i chá»‰ vÃ£i ná»“i vÃ£i Ä‘áº¡n
nguyh huy	Just gáº¯t tháº¿, viruss cáº¡n cmn lá»i ğŸ˜‚ğŸ˜‚ğŸ˜‚
Kazuto Kirigaya	VÃ£i cáº£ lÃ m con khá»‰ ğŸ˜‚
love you	phÆ°Æ¡ng ly uong dá»¯ quÃ¡
Dragon Viet	Sáº¿p mÃ¬nh said : VÃƒI Cáº¢ Ná»’I áº .ğŸ˜‚ğŸ˜‚
HoÃ ng Mai	Uá»‘ng Ä‘Æ°á»£c cÅ©ng Ä‘Æ°á»£c, uá»‘ng khÃ´ng Ä‘Æ°á»£c cÅ©ng Ä‘Æ°á»£c, nhÆ°ng mÃ¬nh khÃ´ng thÃ­ch kiá»ƒu Ã©p rÆ°á»£u rá»“i lÃ´i chuyá»‡n lÃ  Ä‘Ã n Ã´ng pháº£i uá»‘ng, pháº£i chiá»u báº¡n. MÃ¬nh thÃ­ch lá»‘i sá»‘ng cá»§a anh Viruss, cÃ¡i gÃ¬ cÅ©ng vá»«a Ä‘á»§, khÃ´ng Ä‘á»ƒ báº£n thÃ¢n rÆ¡i vÃ o tÃ¬nh tráº¡ng máº¥t kiá»ƒm soÃ¡t
Linh Diá»‡u	Ná»“i áº¡ Ä‘áº¡n áº¡....
BSQãƒƒBinosS	Justatee xá»‰n=))
NGT CHANEL	áº¤u cay...!!! Anh say... NhÆ°ng tim anh Ä‘ang Ä‘au... áº¤u !! ÄÃ¢u hay .... CÃ³ chÃºt rÆ°á»£u mÃ  mÃ¬nh láº¡i bay bay tháº¿ nÃ y.... Em Æ¡i...!! ÄÃ´i rÆ°á»£u lÃ m mÃ¬nh tá»‰nh giáº¥c Ä‘Ã³... BuÃ´ng lÆ¡i.... Anh cháº³ng muá»‘n nghÄ© tá»›i..
Huá»³nh Táº¥n Äáº¡t	Anh Tee kiá»ƒu ngÆ°á»i bÃ¬nh tÄ©nh chá»© khÃ´ng pháº£i khÃ´ng say
vlog mÃ­t	Trong má»—i cuá»™c rÆ°á»£u luÃ´n luÃ´n cÃ³ má»™t ngÆ°á»i lÃ m Ä‘áº§u Ä‘Ã n, báº¯t lá»—i, nÃ³i nhiá»u vÃ´ cÃ¹ng nhÆ° Ã´ng just  > RÆ°á»£u báº¥t kháº£ Ã©p
nam pham	hay lÃ  viruss uá»‘ng rÆ°á»£u tháº­t, 2 vá»‹ kia uá»‘ng nÆ°á»›c lá»ccccc
Quang Hiáº¿u Tráº§n	PhÆ°Æ¡ng Ly xinh vÃ£i
Mayumi Saegusa	A tee chÆ¡i xáº¥u vl
Duy Pháº¡m	Sao cá»© vcÄ‘, vcn váº­y anh.... ko háº¡n cháº¿ láº¡i Ä‘Æ°á»£c Ã , nghe nhiá»u quÃ¡ cÅ©ng khÃ³ chá»‹u Ä‘áº¥y.
Pháº¡m Äá»©c	máº¥y cÃ¡i nháº¥p mÃ´i ko tÃ­nh nha
My Ngoc Duong	Tá»™i sáº¿p quÃ¡ trá»i áº¡ ğŸ˜„ğŸ˜„ğŸ˜„
ÄoaN D.Ä	VR háº§u nhÆ° lÃºc nÃ o cÅ©ng cÃ³ cÃ¢u vÃ£i nghe nhiá»u tháº¥y khÃ³ chá»‹u ghÃª
KhÃ´ng TÃªn Tuá»•i	VÃ£i cáº£ ná»“i áº¡...ğŸ˜‚ğŸ˜‚ğŸ˜‚
G Channel	NhÃ¬n buá»“n cÆ°á»i vÃ£i
wa Ä‘uhek	NhÃ¬n ah nhÆ° thag nghiá»‡n Ã½
LÃ½ Lee	PhÆ°Æ¡ng Ly uá»‘ng kinh váº­y ğŸºğŸ˜±
Wall	VÃ£i Cáº£ Ná»“i x3,14
dat tuan	A viruss bá»‹ a justatee báº¯t lá»—i nhiá»u vl =))))
Trang Trá»‹nh	Ly Æ¡i em bÃ¡ quÃ¡ :))
Äáº¡i Phi	Jus tá»• lÃ¡i
Lee Chul Soo	Soju uá»‘ng thÃ¬ bao h má»›i say???
Nguyen Duc Cuong	VÃ£i ná»“i hÆ¡i nhiá»u ğŸ˜‚
An Tráº§n	PhÆ°Æ¡ng lyyyyy dá»… thÆ°Æ¡ng
BÃ¡ Láº¡i	Tee láº§y
Háº­u Nguyá»…n Ngá»c	YÃªu ly vcc :))
ThÃ¡i thiÃªn tháº§n	jaytee thuá»™c thÃ nh pháº§n nÃ¡t khi uá»‘ng rÆ°á»£u
TrÃ¬nh Huá»³nh	Xem máº¥y láº§n rá»“i mÃ  váº«n buá»“n cÆ°á»i hahaaha
Viet Oreki	Ä‘oáº¡n cuá»‘i máº¥y Ã´ng hÃ i vl :v :v :v
Tháº¿ Anh Tráº§n	VirusS:vÃ£i cáº£...
giÃ³ vÃ´ tÃ¬nh	Khi báº¡n Ä‘á»ƒ con gÃ¡i say :))
Vu Nguyen	tee láº§y kinh há»“n :)) haha quáº£ nÃ y viruss ra hÃ  ná»™i chá»‰ cÃ³ bÆ¡i ngá»­a :))
challenge ChÃ­ PhÃ¨o	máº¥y Ã´ng kia cÃ³ uá»‘ng nhiÃªu Ä‘Ã¢u toÃ n anh viruss uá»‘ng ko kkkk
Äá»©c Thiá»‡n Nguyá»…n	Kinh
Linh TrÆ°á»ng Nguyá»…n	VÃƒI Cáº¢ Ná»’I
Call My Name Fox	VÃ£i cáº£ lá»“iiiiii áº¡
nhimxelu_no1 nhim	Ã”nng Viruss váº­t vÃ£ váº­y =))))
Duy Nguyen Cong	á»¨ gÃ¬ ğŸ˜‚ğŸ˜‚ğŸ˜‚
WindDashers	*Ok anh say, nhÆ°ng tim anh Ä‘ang Ä‘au oh... Ä‘Ã¢u hay, cÃ³ chÃºt rÆ°á»£u mÃ  mÃ¬nh láº¡i bay bay tháº¿ nÃ y =))*
Vitun Le	Ã”ng Tee láº§y vÃ£l cáº£ ná»“i
HoÃ ng HÃ´n KhÃ³c	nÃ³i tháº­t nhÃ© náº¿u rÆ°á»£u nÃ y Ä‘Æ°a Ä‘Ã¢y tao mÃºc 1 buá»•i sÃ¡ng cÅ©ng Ä‘c :)) tháº­t Ä‘áº¥y. bá»n tao uá»‘ng rÆ°á»£u TQ 10 ngÃ n 1 lÃ­t kia cÃ²n bay cáº£ 2 lÃ­t mÃ  cÃ³ 1 cÃ¡i uá»‘ng xong Ä‘áº§u Ã³c nÃ³ quay cuá»“n thÃ´i :))
Hamster nguyá»…n	ná»¯ chÃ­nh MV xinh quÃ¡. =)) mÃ  cÃ¡ tÃ­nh ná»¯a
2811 NTK	#tramanhvirussderoi=)))
hoa tran	Ai tháº¥y phÆ°Æ¡ng ly Ä‘áº¹p gÃ¡i,Ä‘iá»ƒm danh ğŸ˜ğŸ˜
Äáº¡t Nguyá»…n	PhÆ°Æ¡ng ly xinh quÃ¡
LÆ°Æ¡ng Báº¯c Äá»—	cÆ°á»i Ä‘iÃªn ngÆ°á»i =)))))0 hahahahaha
Sam Esther	1:20 ai nhÆ° tui hÃ´ng Háº¿t há»“n chim Ã©n
Báº£o Gin	phÆ°Æ¡ng lyyyyyy cá»§a t
Roo Ty	Tee Ä‘anh Ä‘Ã¡ v~ :)))
ÄÆ°á»ng Tam Táº¡ng	Äi ca nÃ´ ko tá»¥i em chá»‹ láº¥y giÃ¡ ráº» :))
QuÃ½ Nguyá»…n	Láº¡i nháº£y vÃ o má»“m tÃ´i rá»“i :))
annt SE00065x	VÃ£i cáº£ ná»“iiiiii Ã hh
top 1 thÃ¡ch Ä‘áº¥u liÃªn quÃ¢n Viá»‡t Nam	Ã” Ã¡o xanh toÃ n nháº¥p mÃ´i. Ã thá»©c nháº­u kÃ©m vkl
7arker	Ai thá»‘ng kÃª cho t Ã´ng Viruss nÃ³i bn cÃ¢u â€œVCNâ€ vs â€œVCÄâ€ vs nÃ o ğŸ˜‚
ThÃ¡i Nguyá»…n Tháº¿	cÃ¡c cá»¥ cÃ³ cÃ¢u: cÃ¡c cáº­u cÃ³ cu :v :v
THACH DANG	Tá»™i vr vl
BoBo PooM	a tee mÃ  gáº·p e Ã¡. e cho a uá»‘ng 1 e uá»‘ng 2 nhÃ©. a chá»‰ báº¯t náº¡t dk viruss thÃ´i:)
Su Tuyáº¿t	Cho e há»i mua tháº£m Ä‘Ã³ á»Ÿ Ä‘Ã¢u v áº¡??
Duy Gioi Nguyen	NhÃ  anh khÃ´ng thiáº¿u gÃ¬ ngoÃ i ná»“i vs Ä‘áº¡n =)))
zero 9	Uá»‘ng ko háº¿t dc ly rÆ°á»£u sao mÃ  gÃ  váº­y cÃ³ ai Ä‘á»ƒ Ã½ dÄ©a thá»©c Äƒn ko sao mÃ  tá»« Ä‘áº§u Ä‘áº¿n cuá»‘i váº«n cÃ²n nguyÃªn váº­y nháº­u j mÃ  uá»‘ng má»—i lá»­a ly rÆ°á»£u tráº» ghÃ© Ã 
TUNG LE	Just,just,just,just,just, am just, am just Ã .. Anh uá»‘n khÃ´ng sayyy KhÃ´nh say Ä‘Ã¢u mÃ .. Uá»‘n tiáº¿p Ä‘i Ã´ng.. KÃªu tui lÃªn mÃ .. PhÆ°Æ¡ng ly Ä‘Ã£ tá»›i.. ThÃªm vÃ i hiá»‡p ná»¯a.. ChÆ¡i háº¿t tá»‘i nayyyy...
Hai Hoang	Viruss cÅ©ng uá»‘ng kinh bá» máº¹ ra áº¥y chá»© :))
Nháº¡c Phong Official	Láº§y vÃ£i ná»“i
Mr_ Gia PhÃº	Má»“m báº£o chÄƒc tÃ´i uÃ´ng 4 Ä‘áº¿n 5 chÃ©n lÃ  ngu mak Ä‘áº£ 8 chÃ©n vÃ£i Ä‘áº¡n
The GOD Rubik	PhÆ°Æ¡ng Ly xinh quÃ©! Rá»¥ng tym rá»“i <3
nhÆ° lai pháº­t tá»•	TrÃ¢m anh chÆ°a giáº¿t cÃ¡c anh Ã  ><
Tuáº¥n Anh Tráº§n	TrÃ´ng tháº¿ justatee gia trÆ°á»Ÿng nhá»‰
TÃ¹ng Haha	Ã©p dáº§u Ã©p má»¡ ai lá»¡ Ã©p rÆ°Æ¡u. trong bÃ n nháº­u kiá»ƒu gÃ¬ cÅ©ng cÃ³: 1 tháº±ng cáº­y uá»‘ng Ä‘c rá»“i hay khÃ­ch Ä‘á»ƒu(tee), 1 tháº±ng Ä‘ell biáº¿t uá»‘ng nhÆ°ng ko muá»‘n máº·c vÃ¡y(vruss), cÃ²n má»™t Ä‘á»©a im láº·ng quan sÃ¡t rá»“i diá»‡t má»“i tá»« Ä‘áº§u Ä‘áº¿n cuá»‘i buá»•i nháº­u( phÆ°Æ¡ng ly) vÃ  cÃ²n 1 Ä‘á»©a Ä‘Ã£ chuáº©n bá»‹ má»i thá»§ Ä‘oáº¡n trÃ¡nh rÆ°á»£u trc khi vÃ o cuá»™c(tháº±ng Ä‘iÃªn). mÃ  trÃªn Ä‘á»i ghÃ©t nháº¥t lÃ  máº¥y Ä‘á»©a khÃ­ch uá»‘ng bia uá»‘ng rÆ°á»£u. bá»n mk uá»‘ng cháº³ng bg Ã©p chá»‰ Ä‘Æ°a ra cÃ¡i luáº­t Ä‘á»©a nÃ o uá»‘ng Ã­t nháº¥t lÃ  ko tÃ´n trá»ng ae, tÃ­ dá»n Ä‘á»‘ng nÃ y. tháº¿ thÃ´i:v
Nghiá»‡n CÃ´ng Nghá»‡	NhiÌ€n viruss Dam Dang v ğŸ¤£ğŸ¤£ğŸ¤£
Anh BÃ¨o	vui quÃ¡ máº¥y anh Æ¡i
HÃ²a 23	Best Ã©p rÆ°á»£u. HÃ i vkl =)))
vu huy	Anh Tee gáº¯t :))
Thuáº­n Tráº§n	Jus gáº¯t vl
HadeSs gaming	Best tee Ã©p rÆ°á»£u
tÃ´n ngá»™ khÃ´ng	say quÃ¡ cÅ©ng Ä‘á»«ng Ä‘*t chá»¥y phÆ°Æ¡ng ly nhÃ© anh
Big Bird	Viruss gáº§y thÃ©eeee
Oc buou gold	A Tee chÃºc cá»© vui mÃ  :))
win Huynh	Ã”ng viruss cá»© vÃ£i cáº£ ná»“i áº¡, vÃ£i Ä‘áº¡n áº¡ =))
tung duong nguyen duc	T Ä‘áº¿ch tháº¥y hay gÃ¬ kiá»ƒu Ã©p rÆ°á»£u ná»­a Ä‘Ã¹a ná»­a tháº­t tháº¿ nÃ y .
Háº£i Nguyá»…n	Reaction Sá»‘ng cho háº¿t Ä‘á»i thanh xuÃ¢n cáº£u dick Ä‘i anh :))
ê§à¼ºÑ•Ñ‚à¿Äáº¡tGGà¼»ê§‚ -offical	Ah Viruss máº·t Ä‘á» nhÆ° gÃ  tÃ¢y váº­y ğŸ˜‚ğŸ˜‚
Master Jack	HÃ i vÃ£i
king boss	Ã”ng HoÃ ng Ä‘i táº­p gym Ä‘i, cá»© nhÆ° bá»™ xÆ°Æ¡ng khÃ´ :))
hÆ°ng lÃª	Anh tee uá»‘ng rÆ°á»£u nÃ³i nhÃ¬u vÃ£i
Tuáº¥n ÄÃ©p	Anh Say nhÆ°ng tim anh Ä‘ang Ä‘au Ã³,Ä‘Ã¢u hay.... :v
LÃ¢m Tiá»u Phu	Ã´ng Tee rÆ°á»£u vÃ o váº«n tá»‰nh bÆ¡
Hiá»n carÃ´	Láº¡i gáº·p thÃ¡nh uá»‘ng rÆ°á»£u viruss pháº£i quá»³
Äá»©c Vinh	VÃ£i cáº£ ná»“iiiğŸ¤£ğŸ¤£
ThÃ nh HoÃ ng	Tee uá»‘ng gáº¯t vl
We-Pi	VÃ£i cáº£ ná»“i áº¡
Nam Ä‘áº¹p zai khoai lang	8:20 chia sáº» cá»§a 1 báº¡n tráº» cÃ³ vá»£ .
NgÃ¢n NgÃ¢n Vlogs	*Láº§n Äáº§u Tháº¥y Anh Uá»‘ng RÆ°á»£u* :))
Trung LÃª	HÃ¬nh áº£nh cuá»‘i cÃ¹ng lÃ  Ä‘áº¹p nháº¥t anh Æ¡i
áº¨m Thá»±c Tam Mao	Cmt Ä‘á»§ 200 like ae nhÃ  Tam Mao sáº½ thá»­ thÃ¡ch tÃ¬m Ä‘áº¿n nhÃ  cá»§a Viruss nhÃ©
B Tube	tÆ°ng tÆ°ng máº¯c cÆ°á»i quÃ¡ :D
minhthuan nguuyen	NÃ³i Ã­t thÃ´i uá»‘ng nhÃ¬u vÃ o ğŸ˜‚ğŸ˜‚
Tuáº¥n Devin	A Virrus uá»‘ng riá»‡u giá»‘ng mÃ¬nh 1 chÃ©n lÃ  Ä‘á». Uá»‘ng say Ä‘áº§u Ã³c váº«n tá»‰nh  A Justatee kiá»ƒu ngÆ°á»i cÃ ng uá»‘ng cÃ ng nÃ¡t. ( uá»‘ng Ä‘Æ°á»£c nhiá»u ) VÃ  quáº£ káº¿t quÃ¡ gáº¯t. :))
Tiáº¿n Anh Äinh	Virss hÃ£i
Ngá»c ThÃ¢n Nguyá»…n	Virus vs jus laÌ€ baÌ£n hoÌ£c hay s z trÆ¡Ì€i
Háº¯c kiáº¿m sÄ© Kirito	Chá»‹ phÆ°Æ¡ng linh Ä‘Ã¢u :v
Hai Minh	Láº¯m ná»“i quÃ¡ ğŸ˜‚ğŸ˜‚ğŸ˜‚
Cam TV	Team xem sá»›m ğŸ˜€ğŸ˜ğŸ˜€
Tuáº¥n Anh	Anh Ã¡o vÃ ng vÃ  anh Ã´m tee lÃ  ai v :v
HoÃ ng Äiá»‡p	nhÃ¬n nhÆ° t nghiá»‡n
Chung Nguyen Tat	4:18 Viruss nhÃ¬n PhÆ°Æ¡ng Ly mÃ  ná»ƒ
yÃªu nÃ´ng nghiá»‡p	Con em nÃ o dá»ƒ thÆ°Æ¡ng z
Äáº¯c Hiáº¿u Nguyá»…n	ViruSs gáº§y quÃ¡
Äá»— TÃº	Tee uá»‘ng ghÃª vlin
Sang Dinh	Hi
TrÃºc PhÆ°Æ¡ng	*Xem mÃ  cÆ°á»i Ä‘au bá»¥ng*
QuÃ¢n Nguyá»…n TV	*Team ko bik uá»‘ng rÆ°á»£u, bia Ä‘Ã¢u rá»“i* ğŸ‘ŒğŸ»ğŸ‘ŒğŸ»ğŸ‘ŒğŸ»ğŸ‘ŒğŸ»
BÃ´ Máº­p Channel	mÃ¬nh mÃ  lÃ m video nÃ y thÃ¬ end trong vÃ²ng 3 ná»‘t nháº¡c. 1 nÃ³c lÃ  lÃªn máº¹ rá»“i
Báº¯c WK	Ummmm bh anh má»›i reaction váº­y !!
Hiáº¿u VÃµ	VÃ£i cáº£ ná»“i =)) vÃ£i cáº£ Ä‘áº¡n :))
Jeon Jungkook	Wow
HÃ  VÅ©	A gáº§y tháº¿
Má»±c khÃ´	HÃ³ng Ã´ng viruss lÃ m thÃªm má»™t bÃ i ná»¯a =))
Violet VÆ°Æ¡ng	hAHAhaHa
Ari MVP	*Fan Virus Ä‘iá»ƒm danh nÃ o 6h 30phut hÃ´m nay mÃ¬nh táº·ng nick liÃªn quÃ¢n mong ae ghÃ© qua á»§ng há»™ mÃ¬nh nhÃ© cáº£m Æ¡n*
TÃ¢m ÄoÃ n	VÃ£i cáº£ ná»“iiiiiiiiiii áº 
khesanh.net	ViruSs gáº§y quÃ¡, táº­p gym Ä‘i em
Tonny Official	A just say ğŸ˜‚ğŸ˜‚
Cf m	PhÃª chÆ°a anh
LÃª TÃ¬nh	BEST SAY RUU HAHAHA
Vy Nguyá»…n	ğŸ˜‚ğŸ˜‚
channel GD	Haha ğŸ˜„
A.R.M.Y & SKY & BLINK & VIP	LÃ£o jus uá»‘ng kinh tháº¿
Tháº£o Trang	ÄiÃªn lÃ  Ä‘iÃªn lÃ  Ä‘iÃªn ğŸ˜‚
Kháº£i Tik Tok	sud chÃ©o uy tÃ­n
murad siÃªu viá»‡t	Hi
ATS BOSS	Hello 3 anh
Yab	Gáº§y
Tháº£o Há»“ng	ğŸ’Ÿ
QuÃ¢n Gray	ChÃ©o sub uy tÃ­n
Naga Dosu	V khá»‰
Nguyá»…n Quá»‘c Anh	ChÃº LÃ¢m toÃ n 1%
Cannabin Tv	VÃ£i cáº£ xoong
EDM MUSIC	LÃ¢u lÃ¢u lÃ¢u thÃ¬ ta má»›i nháº­u 1 láº§n
Chang Bin	LÃ€m Æ¡n ai Ä‘Ã³ Ä‘Ã³ cÃ³ táº¥m lÃ²ng háº£o tÃ¢m hÃ£y lÃ m phÆ°á»›c bá»‘ thÃ­ cho tÃ´i 1 like vÃ  1 SUB Ä‘c ko áº¡
á»© á»«	Sub uy tÃ­n 100%
tien nam	DÃ´ nÃ oooooooooo
NHT Gamer	top 2 like Ä‘áº§u hihi
