Sheikh Sameer	1 thing is correct Prime minister will not give NRO But indirectly there are effort in background to get from someone else mean establishment and judiciary Some spot fixer are trying to facilitate Mafia Twitter sheikhoffic
khuram khan	Ø¨Ú¾Ù¹ÛŒ Ø§ÛŒÚ© Ù†ÛØ§ÛŒØª Ø¨Û’ÛÙˆØ¯Û Ø´Ø®Øµ ÛÛ’ Ø§Ø³ Ú©Ùˆ Ù†Ú©Ø§Ù„ Ø¯ÛŒÚº Ø´Ú©Ø±ÛŒÛ
Bosal Tv1	http youtu be I3P3skZftgQ
Mohammed Akhtar	WAALEYKUM ASSALAAM WR WB P P P AND P M L N MIAN SANAP NAWAZ SHAREEF THEY RE ALL TRAITOR OF 21ST CENTURY LOCKED IN HELL FIRE THEY RE BLACK INDIAN COBBRA SHEESH NAAG LOWER THAN SNAKES BELLY
samia kausar	Bhati sahab ap ki bat k jhoot bolny Wala ka moon kala waqiy maza I jay
Sahar Tariq	Bhatti sahb I respected you before yesterday s comment about IK and Altaf Please don t let the people start hating you Sabir Sahb and Ehtisham Sahb your analysis is always good and made our day Keep it up Sir you are really doing a great jobğŸ‘
Nemat Niazi	Bhatti dant nhi nikal
Abdul Aziz	In currept zardari or shrif mafia ka medium bycot Karo ye khod he marjaengy
RED ON YELLOW	I I Pti
Tahir Rashid	Mr Bhatti don t talk too much and sensationalized for rating and showing how smart you are i suggest instead you take advantage of Citizens portal and register your complaint there
Shah Ahmad	He is most stupid bahtti
malik shahzad Latif	Bhatti sahib bhi shahbaaz sharif ki tara show baaz hi hai ba
Aftab Jamal	I like the light humor from bhatti Sahab app muskuratey huwe changey lagtey hain
khan sadia	Qatar NRO ka bol raha hai bcz u ko apni shazadi ko bachana hai
Umar Hassan	Bhatti Lifafa
Shafia Jahan	Bhatti nawaz zardi shabaz bhai bhai
Waqaruddin Ansari	Ø´Ø§Ú©Ø± ØµØ§Ø­Ø¨ ÛŒÛ Ø¢ÛŒØª Ø³Ø¨ ÛÛŒ Ú©Û’ Ù„Ø¦Û’ Ú¾Û’ Ù…Ú¯Ø± Ù†ÙˆØ§Ø² Ø´Ø±ÛŒÙ Ø²Ø±Ø¯Ø§Ø±ÛŒ Ú©Û’ Ù„Ø¦Û’ Ø®ØµÙˆØµØ§Ù‹Û” ÙƒÙØ¨ÙØ±Ù Ù…ÙÙ‚Ù’ØªÙ‹Ø§ Ø¹ÙÙ†Ù’Ø¯Ù Ø§Ù„Ù„Ù‘Ù°Ù‡Ù Ø§ÙÙ†Ù’ ØªÙÙ‚ÙÙˆÙ„ÙÙˆØ§ Ù…ÙØ§ Ù„ÙØ§ ØªÙÙÙ’Ø¹ÙÙ„ÙÙˆÙ†ÙÛ
burningsoul20	The day Nab is able to recover corrupt money from zardari nawaz am gon na fly straight to Pakistan and gon na punch bhatti on his face and knock his as down
dabbapeer	ARY is now attacking PTI with both arshad sharif and this ullo ka pattha bhatti the frontmen this bhatti is getting unwatchable how he ha become to be on tv is a mystry he doe not know how to conduct himself ARY remove him he is a very negative person change take time bhatti saab but your lifafa demand immidiate change at everything in Pakistan after year of corruption and decay
Shahzad Azzam	Bhatti saab to aese bharke howe hai jaise Imran Khan ne in k kareebi ko nikal diya hai bureaucrat se Bhatti saab kher hogai
Fozia Shahid	Bhatti jokarğŸ‘ğŸ‘ğŸ‘ğŸ‘ğŸ‘ğŸ‘ğŸ‘ğŸ‘ğŸ‘ğŸ‘ğŸ‘
O.Deepok Asif	Good job Sabir Bhai Live LongğŸ’“ğŸ’“
Ejazbutt Butt	bhatti sahib aap chup hi raha kry aap mayousiyat pheelaa rahy hain plz donot take much time n debate
Skepti Media	ÛŒÛ Ø¬Ø§ ÛÙ„ Ø­Ù…ÛŒØ¯ Ø¨Ú¾Ù¹ÛŒ Ú©Ùˆ Ù†Û Ø¨ÙˆÙ„Ù†Ø§ Ø¢ØªØ§ ÛÛ’ Ù†Û ÛÛŒ Ø§Ø³ Ú©Ø§ Ú©ÙˆØ¦ ØªØ¬Ø²ÛŒÛ ÛÛ’Û” Ø¨Ø³ ÛŒÛ Ù¾Ø±ÙˆÚ¯Ø±Ø§Ù… Ú©Û’ Ù…Ù†Ù¹ Ù¾ÙˆØ±Û’ Ú©Ø±Ù†Û’ Ú©Û’ Ù„Ø¦Û’ Ø¨ÛŒÙ¹Ú¾Ø§ ÛÛ’ Ø§Ø¯Ú¾Ø±Û” Ø¬Ø§ ÛÙ„ Û” Ø¨Û’ ÙˆÙ‚ÙˆÙÛ” Ú¯Ø¯Ú¾Ø§Û”
Ijaz Butt	U R gr8 man s
Qader Zaman	Hhhhh butti zyada nakhry na kar plz
Tehmina Ashraf	Bhatti k pas koi information tu nei hoti b imran khan k khilaaf bhoonkana ata hai
Abubkar Jutt	good program
Life Life	Bhatti khud shirf family k ghulam hai
Asim khan	Bhatti are you crazy
Mustjab KHOKHAR	Chor already akathey hain
Muhammad Akbar khan	Marium ko period horahay tu sabir sb ko Kese Pata chala Aur bhatti sb ko farq he nhi parta p Lolz
saqib haffez	oh bhati sab agar manister ka phone nahi suna jaey gaa tou i say ye kaisay sabat huta kah adaron kay head gair janab daar hu gaia ha jab kah imran khan apni har taqreer maen kahta raha kah beurocuresy saath nahi de rahi
masab khan	Welcome back Sabir shakir Pakistab zindabadâ¤ğŸ‡µğŸ‡°â¤ Imran khan zindabad
junaid warich	Ø¹Ù…Ø±Ø§Ù† Ø®Ø§Ù† Ø²Ù†Ø¯Û Ø¨Ø§Ø¯ Ù¾Ø§Ú©Ø³ØªØ§Ù† Ø²Ù†Ø¯Û Ø¨Ø§Ø¯ Ù¾Ø§Ú© ÙÙˆØ¬ Ø²Ù†Ø¯Û Ø¨Ø§Ø¯
Aftab Arzo	Batti sab ap apna elaj karwe
Aslam Wazir	Waaqi Imran khan khod ko abi tak appositon may samj te hay jo k is liye achi baat hay k jub wo in dono k kartooth ko dheke ga to Khan Sahib our b sakht hojayega our inko our energy aathi hay
atique ur rehman baig mirza	Bhatti g PTI Ke HUKMAT Aya gai hay Uttho Bhatti akhnay kholo Bistar choro or monh dho lo
Mirza Ateeque	Ø§Ù¾Ù†ÛŒ Ø¯ÙˆÙ„Øª Ø¨Ú†Ø§Ù†Û’ Ú©Ø§ Ú†Ú©Ø± Ú¾Û’ Û”Û”Ø­Ø§Ù„Ø§Øª Ø¬Ù„Ø¯ÛŒ Ø¬Ù„Ø¯ÛŒ Ø®Ø±Ø§Ø¨ Ú¾ÙˆØ±Û’ Ú¾ÛŒÚº Ø§Ø³ Ø³Û’ Ù¾ÛŒ Ù¾ÛŒ Ø§ÙˆØ± Ù† Ù„ÛŒÚ¯ ÙØ§Ø¦Ø¯Û Ù†Û Ø§Ù¹Ú¾Ø§Ù„ÛŒÚº Û”Ø§ÙˆØ± Ø¹Ø±Ø¨ Ø¯Ù†ÛŒØ§ Ú©ÛŒ Ø·Ø±Ø­ ÛŒÛØ§Úº Ø¨Ú¾ÛŒ Ø®Ø§Ù†Û Ø¬Ù†Ú¯ÛŒ Ù†Û Ú©Ø±ÙˆØ§Ø¯ÛŒÚº Û”Û”Ú†ÙˆØ±ÙˆÚº Ú©Ùˆ Ø³Ø²Ø§ Ø¬Ù„Ø¯ÛŒ Ø¯ÛŒÚº
Nabil Vlogs Germany	Ú©ÙˆØ¦ÛŒ Ù…ÛŒØ±ÛŒ Ø§ØµÙ„Ø§Ø­ Ú©Ø±Û’ ÛŒÛ Ø¨Ú¾Ù¹ÛŒ ØµØ­Ø§ÙØª Ú©Û’ Ù„Ø§Ø¦Ù‚ Ú¾Û’ Ù…ÛŒØ±Û’ Ø®ÛŒØ§Ù„ Ù…ÛŒÚº ØªÙˆ Ø§ÛŒØ³Û’ Ú©Ú†Ú¾ Ø§ÙˆØ± ÛÙˆÙ†Ø§ Ú†Ø§ÛÛ’ ØªÚ¾Ø§ Ø¢Ù¾ Ú©ÛŒ Ø±Ø§Ø¦Û’ Ú©ÛŒØ§ Ú¾Û’
abid khan	Saber shakir awar ehtesam sab ap ke del ke sachae ham samjhte he jete raho
waqas liaqat	Good sir sber sahb
Towhid ahamed akash	Imran khan should support export industry seriously
Muhammad Ali	Altaf Hussain ka nam atay hi inke pichwaron main bomb phat jata haiğŸ¤£ waqai dushmano k zehno par ab bhi khof tari haiğŸ˜‚
Muhammad Bilal Raja	â€Ø³Ù†Ø§ ÛÛ’Ù†ÛŒØ§ Ù†Ø¹Ø±Û Ù…Ø§Ø±Ú©ÛŒÙ¹ Ù…ÛŒÚº Ø¢ÛŒØ§ ÛÛ’ ØªÛŒÙ† Ú†ÙˆØ± Ø§ÛŒÚ© Ø¢ÙˆØ§Ø² ÚˆÛŒØ²Ù„ØŒ Ø²Ø±Ø¯Ø§Ø±ÛŒ Ø§ÙˆØ± Ù†ÙˆØ§Ø²ğŸ¤£ğŸ¤£ ğŸ˜ğŸ˜
Tajpk 1952	THE REPORTERS WHAT A FUNNY PROGRAM WHAT A SENSE OF HUMOR
Wasim Choudhry	Ø³Ù¾Ø±ÛŒÙ… Ú©ÙˆÙ¹ Ø¢Ø¦ Ø¬ÛŒ ÛŒØ§ ÚˆÛŒ Ù¾ÛŒ Ø§Ùˆ Ú©Û’ ØªØ¨Ø§Ø¯Ù„Û’ Ù¾Û Ø¯Ø³ Ø³Ø§Ù„ Ù¾ÛÙ„Û’ Ù†Ùˆ Ù¹Ø³ Ù„ÛŒØªÛŒ ØªÙˆ Ø¢Ø¬ ÛŒÛ Ø¯ Ù† Ù†Û Ø¯ÛŒÚ©Ú¾Ù†Ø§ Ù¾Ú‘ØªØ§Û” Ø¯ÙˆØ³Ø±ÛŒ Ø¨Ø§Øª Ø§Ú¯Ø± Ø§ÛŒÚ© Ø¢Ø¦ Ø¬ÛŒ ÙˆÙØ§Ù‚ÛŒ ÙˆØ²ÛŒØ± Ú©Ø§ ÙÙˆÙ† Ù†ÛÛŒ Ø§Ù¹Ú¾Ø§ØªØ§ ÙˆÛ Ø¢Ù… Ø¢Ø¯Ù…ÛŒ Ú©Ø§ Ú©ÛŒØ§ Ø§Ù¹Ú¾Ø§Û’Ú¯Ø§Û” ØªÛŒØ³Ø±ÛŒ Ø¨Ø§Øª Ú†ÛŒÙ Ø¬Ø³Ù¹Ø³ Ú©Ùˆ Ø¬ØªÙ†Û’ Ø¨Ú¾ÛŒ Ø¢Ø¦Ø¬ÛŒ ÛÛŒÚº Ù¾Ø§Ú©Ø³ØªØ§Ù† Ù…ÛŒÚº Ø§Ù† Ø³Û’ Ù…Ù†ØªÚ¾Ù„ÛŒ Ø±Ù¾ÙˆØ±Ù¹ Ù„ÛŒÙ†ÛŒ Ú†Ø§ÛÛ’ Ø§ÙˆØ± ÛŒÛ Ø¨Ú¾ÛŒ Ø¯ÛŒÚ©Ú¾Ù†Ø§ Ú†Ø§ÛÛŒÛ’ Ú©Û Ø¨Ø§ÛØ³ Ø¢ÙˆØ± Ø¢ÛØ¬ÛŒ Ú©Ø¯Ú¾Ø± ØªÚ¾Ø§Û”
Muhammad Sohail	Respected bhatti sab please Put your are complain in pakista citizen portal about police health education etc
Shahid Pervaiz	O man I m batter then arif bhati what a nonsense man he is
shahid yousaf	Arshad bhati hamejsha he chwallen marta hai
bilal hussain	bhatti tm kr e lo tankeed imran khan pr vote ly k aya ha tuj jesy bhonkty rhty hain
Black Zero	I hate all economical hit man plz ihtisab ke amal ko tez karo aur mulk ka loota hua paisa wapis lao no mercy plz
ali ahmed	Ø¢Ø¬ ØªÚ© Ø¢Ù¾ Ú©Ø§ Ù¾Ø±ÙˆÚ¯Ø±Ø§Ù… Ø¨ÛØª Ø²Ø¨Ø±Ø¯Ø³Øª ØªÙ‡Ø§ Ù„ÛŒÚ©Ù† Ø¢Ø¬ Ø¨Ù‡Ù¹ÛŒ Ù†Û’ Ø®Ø§Ù† Ù†Ø§Ù… Ø§Ù„Ø·Ø§Ù Ú©Û’ Ø³Ø§ØªÚ¾ Ù…Ù„Ø§ Ú©Ø± Ø¨ÛØª Ø¨Ø±Ø§ Ú©ÛŒØ§ ÛÛ’ Ø§Ø³ Ø¨Ù‡Ù¹ÛŒ Ù¾Ø± Ù„Ø¹Ù†Øª ÛÙˆ Ø¨
Awis Khan	ÛŒÛ Ø¨Ù¹ÛÛŒ Ú©Ùˆ Ú©ÛÛŒ Ø§ÛŒÙ†Ù¹ ÙˆØ§Ù„Û’ Ø¨Ù¹ÛŒ Ù…ÛŒÚº Ù„Ú¯Ø§ Ø¯Û’ Ø§Ø³ Ú©Ùˆ Ú©Ø³ Ù†Û’ ØµØ­Ø§ÙÛŒ Ø¨Ù†Ø§ÛŒØ§ ÛÛ’
Shakeel Ahmed	I don t like any more this program because bhti Saab talk s
Abdul Wahid	Ø¨Ú¾Ù¹ÛŒ ØµØ§Ø­Ø¨ Ø¨ÛŒØ±ÙˆÚ©Ø±ÛŒÙ¹Ø³ Ø­Ú©ÙˆÙ…Øª Ú©ÛŒ Ø³Ø§ØªÚ¾ ØªØ¹Ø§ÙˆÙ† Ù†ÛÛŒÚº Ú©Ø± Ø±ÛØ§ Ø§ÙˆØ± Ø¬Ø¨ Ø­Ú©ÙˆÙ…Øª Ú©Ø§Ø±ÙˆØ¦ÛŒ Ú©Ø±ÛŒÚº ØªÙˆ ÙˆÛ Ø¬Ø¬ Ø§ÛŒÚ©Ø´Ù† Ù„ÛŒØªØ§ ÛÛŒÚº ÛŒÛ Ø¨ÛŒØ±ÙˆÚ©Ø±ÛŒÙ¹Ø³ Ù†ÙˆØ§Ø²Ø´Ø±ÛŒÙ Ú©Û’ Ú©Ø§Ø±Ù†Ø¯Û’ ÛÛŒÚº Ø§ÙˆØ± ÙˆÛ Ú©Ø±Ù¾Ø´Ù† Ú©Û’ Ø³Ø±Ø¯Ø§Ø±ÙˆÚº Ú©Û’ Ù…Ø¯Ø¯ Ú©Ø± Ø±ÛÛŒ ÛÛŒÚº Ø¯ÙˆØ³Ø±ÛŒ Ø·Ø±Ù Ú©Ø³Ù¹Ù… Ø§ÙØ³Ø± ØªØ¨Ø¯ÛŒÙ„ Ú©Ø± Ú©Û’ Ø§Ø³ Ù¾Ø± Ú©ÙˆØ¦ÛŒ Ø³ÙˆÙ…ÙˆÙ¹Ùˆ Ø§ÛŒÚ©Ø´Ù† Ù†ÛÛŒÚº Ù„ÛŒØ§ Ú©ÛŒØ§ ÛŒÛ Ø¯ÙˆØºÙ„ÛŒ Ù¾Ø§Ù„ÛŒØ³ÛŒ Ù†ÛÛŒÚº
Shakirullah Khan	Ø¢ Ù†Ø³Ø§ Ù† Ú©ÛŒÙ„Û’ Ø§ØªÙ†Ø§ Ø¬ØªÙ†Ø§ Ú©Û Ø§Ø³ Ù†Û’ Ú©Ùˆ Ø´Ø´ Ú©ÛŒ Ø¢ Ù„Ù‚Ø± Ø¢Ù† Ø¹Ø²Øª Ø§ÙˆØ± Ø²Ù„Øª Ø³Ø¨ Ø¢Ù„Ù‘Ù„Ù„ÛÙ Ú©Û’ Ú¾Ø§ ØªÚ¾ Ù…ÛŒÚº Ú¾Û’ Ø¬Ø³Ú©Ùˆ Ú†Ø§ Ú¾Û’ Ø¹Ø²Øª Ø¯ Û’ Ø¬Ø³Ú©Ùˆ Ú†Ø§ Ú¾Û’ Ø° Ù„Øª Ø¯ Û’ Ø¢Ù„Ù‚Ø± Ø¢ Ù† Úˆ ÛŒØ² Ù„ Ø¨Ú¾Øª Ø³Ø³ØªØ§ Ú¾Û’ Ù„ÙˆÚ¯ Ø§Ø³ Ú©Ùˆ Ù…Ú¾Ù†Ú¯Ø§ Ø³Ù…Ø¬Ú¾ØªÛ’ Ú¾ÛŒÚº ØŒÚ©Ú¾ØªÛ’ Ú¾ÛŒÚº Ø¬ØªÙ†ÛŒ Ø¢Ù¾Ú©ÛŒ Ú†Ø§ Ø¯ Ø± Ú¾Ùˆ Ù¾ÛŒØ± Ø§ØªÙ†Û’ Ù¾Ú¾ÛŒÙ„Ø§ ÙˆØ¡ Ùˆ Ø±Ù†Û Ø¨Ø§ Ú¾Ø± Ù†Ú©Ù„ Ø¬Ø§ ÛŒÙ†Ú¯Û’ Ù†Ùˆ Ø§ Ø¨ Ø² Ø§ Ø¯Û Ù†ØµØ± Ø§ Ù„Ù„Ù„ÛÙ Ù…Ø± Ø­Ùˆ Ù… Ø³Û’ Ú©Ú†Ú¾ Ø³ÛŒÚ©Ú¾ØªÛ’ ØªÙˆ Ø§Ú†Ú¾Ø§ Ú¾Ùˆ ØªØ§
Omar Nadeem	Bhatti ko Allah ke waste bulwate Ho Isko Kya baat karni hai nahi pata ye kesa Tajzia hai iska samajh se bahar
JS Magrey	O kanjar Khursheed pani assman se ata hay Asman se pani sumander k bukhrat sey gaya hua pani
Umar Afridi	Ye cheef jastes urfy fujj ka pala hoa kuta ye awi bonkta he jastes ne abi tak kese ko insaf nhi dia jab tak fujj ka qabza hukomat pe khatam nai hota tab tak pakistan mai khushali nai asakta
Mujahid Abbasi	Ù†Ø¨ÛŒ Ú©Ø±ÛŒÙ… ØµÙ„ÛŒ Ø§Ù„Ù„Ù‘Ù°Û Ø¹Ù„ÛŒÛ ÙˆØ³Ù„Ù… Ú©ÛŒ Ø´Ø§Ù† ÛÛŒÚº ÙˆØ±Ù†Û Ù¾ÛÙ„Û’ Ø§Ù…Øª Ù…ÛŒÚº Ù„ÙˆÚ¯ Ø¬Ú¾ÙˆÙ¹ Ø¨ÙˆÙ„ØªÛ’ ØªÚ¾Û’ Ø¨Ú¾ÙˆÙ„Ùˆ Ø¨Ù†Ø¯Ø± Ø¨Ù† Ø¬Ø§ØªÛ’ ØªÚ¾Û’ ÛÙˆÚ‘ ØªÛ’ Ù…ØªÚ¾Û’ ØªÛ’ ÙˆÙ¹ Ù†ÛŒ Ø¢ Ù†Ø¯Ø§
Zia Khan	Bhatti s analysis is exactly like how he sound jahil aur anparh
Qaiser Khan	Ø¨Ù¹Ú¾ÛŒ ØµØ§Ø­Ø¨ Ø§Ù¾ ØªÙ†Ú©ÛŒØ¯ Ú©Ø±ÛŒÚº Ø§Ù¾ Ú©Û’ Ø¯Ù„ Ù…ÛŒÚº Ù¾Ø§Ú©Ø³ØªØ§Ù† Ú©Û’ Ù„ÛŒÛ’ Ø¯Ø±Ø¯ Ú¾Û’ Ù…Ú¯Ø± Ø¨Ù¹Ú¾ÛŒ ØµØ§Ø­Ø¨ Ø§Ø¬ Ú©Ù„ Ù…Ø§ÛŒÙˆØ³ÛŒ Ù¾Ú¾ÛŒÙ„Ø§Ù†Ø§ Ø­Ú©ÙˆÙ…Øª Ú©Ùˆ Ø¹ÙˆØ§Ù… Ú©Û’ Ù„ÛŒÛ’ Ø§Ú†Ú¾Û’ Ø§Ù‚Ø¯Ø§Ù… Ø³Û’ Ø±ÙˆÚ©Ù†Ø§ Ø§Ù† Ø³Ø§Ø±Û’ Ú†ÙˆØ±ÙˆÚº Ú©Ø§ Ú©Ø§Ù… Ú¾Û’ Ø³Ø¨ Ú†ÙˆØ± Ø§ÛŒÚ© Ø³Ø§ØªÚ¾ Ù…Ù„ Ø¨ÛŒÙ¹Ú¾Û’ Ø§Ù† Ø´Ø§Ø¡ Ø§Ù„Ù„Û ÛŒÛ Ø§Ø³ Ù…ÛŒÚº Ø¨Ú¾ÛŒ Ø°Ù„ÛŒÙ„ Ùˆ Ø®ÙˆØ§Ø± ÛÙˆÚº Ú¯Û’ Ø³Ùˆ Ø§Ù† Ú©ÛŒ Ù¹ÛŒÙ… Ù†Û Ø¨Ù†ÛŒÚº
SUBHASH BHASKAR	ye haramzaade hen loterey sub eik hen jo kaam khud kerte hen naam doosron ka lete hen jhoote 1
Muhammed Wasim	Bhatti sahib You are ovedoing a bit
Haji Ajmal	Ù† Ù„ÛŒÚ¯ ÙˆØ§Ù„Û’ Ù…Ù„Ú© Ø¯Ø´Ù…Ù† ÛÛŒÚº Ú†ÙˆØ± Ù„ÛŒÚ¯ ÚˆØ§Ú©Ùˆ Ù„ÛŒÚ¯ Ø§Ù„Ù„Û ØªØ¹Ø§Ù„ÛŒ Ù† Ù„ÛŒÚ¯ ÙˆØ§Ù„ÙˆÚº Ú©Ùˆ Ø¨Ø±Ø¨Ø§Ø¯ Ú©Ø±ÛŒÚº Ø¢Ù…ÛŒÙ† Ø«Ù… Ø¢Ù…ÛŒÙ† Ø®Ø§Øµ Ú©Ø± Ù†ÙˆØ§Ø² Ø´Ø±ÛŒÙ Ú©Ùˆ Ø§Ù„Ù„Û ØªØ¹Ø§Ù„ÛŒ Ø¨Ø±Ø¨Ø§Ø¯ Ú©Ø±ÛŒÚº Ø¢Ù…ÛŒÙ† Ø«Ù… Ø¢Ù…ÛŒÙ†
bajwa G	yar tum log hoty kon ho is ig ko lga do isko nikal do had hai yar pm KIS lye hota hai afsoos
Nabeel Israr	I think bahti Sb is drunk
M Taj	Arshid bate such kr bat kro
awan yarmuhammed	Please Bhatti leave this program bcoz you don t deserve
Arman khan wazir	Imran khan zindabad Cecilian mafia murdabad
Sajid Mehmood	Bhatti tere Sahafat p lanat
Bilal Ahmad	excellent programm
Hashim Ali	ğŸŒ¹ğŸ˜ğŸ˜˜â˜•ğŸŒ¹ğŸ˜ğŸ˜˜â˜•ğŸŒ¹ğŸ˜ğŸ˜˜â˜•
Asif Gujjar	ØµØ§Ø¨Ø± Ø´Ø§Ú©Ø± Ø§ÛŒÚ© ØºÛŒØ±Øª Ù…Øª Ø§Ù†Ø³Ø§Ù† ÛÛ’ Ø§Û’Ø¢Ø±Ø¤ÛŒÛŒ Ø§Ú†Ú¾Ø§ Ú†ÛŒÙ†Ù„ ÛÛ’ Ø§Ú†Ú¾Ø§ Ú©Ø§Ù… ÛÙˆ Ø­Ú©ÙˆÙ…Øª Ú©Ø§ ÙˆÛ Ø¨Ú¾ÛŒ Ù¾ÛŒØ´ Ú©Ø±ØªÛ’ ÛÛ’ Ø¢ÙˆØ± Ø­Ú©ÙˆÙ…Øª Ú©Û’ Ø®Ø±Ø§Ø¨ Ú©Ø§Ù… Ù¾Ø± ØªÙ†Ù‚ÛŒØ¯ Ø¨Ú¾ÛŒ Ú©Ø±ØªÛ’ÛÛ’ ÛŒÛ ÛÛ’ Ø§ØµÙ„ Ù…ÛŒÚˆÛŒØ§ Ø¬ÛŒÙˆ Ù†ÛŒÙˆØ² ØµØ§Ù Ú†ÙˆØ±ÙˆÚº Ú©Û’ Ù„ÛŒØ¦Û’ Ø§Ù†ØµØ§Ù Ø¹Ø¯Ø§Ù„Øª Ø¨Ù† Ø¬Ø§ØªØ§ ÛÛ’
Farida Khajawall	bhati ha lost it
Umair Shah	Bhati sahib main apko bahut pasand karta ho lekin aaj main apko sirf ye kahonga just shut up
Ihsanullah Khan	Imran khan great
nadeem mughal	Fazool batain kr rha hai ye Bhatti sharam Ani chahiye isko Imran khan pe tanz kr rha hai
Shafaat Ali	ARY s The Reporters alias THE AVENGERS I want to ask you only this ARE YOU REALLY AS STUPID AS SOUND In fact you all three are more stupid than this Please note that there exist no BOGUS BANK ACCOUNT whatsoever Ask The Senior Most stupid Arif Hameed Bhatti whether he can have a bogus bank account He speaks from his heart and never us his brain I think he never ha one You favor whoever you like and that is not a work of a so called anchor You never discussed how a bogus bank account is opened and operated Can you deposit money in any bank account but how can you transact from that account If a bank account is not being used for a certain period it becomes closed by the State Bank of Pakistan If such an account exists that is misappropriation by bank staff Please guide the general public properly instead of just talking non sense all the time GOD SAVE US FROM ANCHORS like you
zuhaib khalid	sabir shakir great
Kiffal Kiffal	sarkare hospital ke bat na karo bhati sab hakumt ko time do 1 sal kam s kam
Shahid Ali	Bhatti pary darjy ka bewaqoof hy
Fouzia Rajput	Not only polticion and beurocrite are crroupt but people are also crroupt in Pakistan
Mohammed Ali	Why ha islamabad iG been verbally dismiss Bludy Sharif brothersğŸ˜
Naveed Gujjar	LOVE YOU PTI koch ni hoga jo marzi kar ley ye sab mil kar
smrtmax	Bhatti sb Sorry But ab app ka tajzia ke jaahil admi ka bolna lagta hai Seems u r out ur mind
Tauseef Ahmad	Salam to sabir shakir a true patriot god bless you
Niaz Khan	Bhatti ka lafafa Band ho gaya hai Ab ulti sedi Mar raha hai ğŸ˜‚
Avinash Kumar Avinash	Ary chahe jitna jrdari or shrif ki purani kbr khod len But halat aise bn gye hen ki aane vale dino me ye log ek hi nao pe swar dikhenge
Razzaque Abdul	Tm medium walon ki bhi bjne walu hai arif bhatti
maqsood ahmed	Imran Khan will change Pakistan thanks very much for imran khan today all crpet mafia be come together ppp and plmn they want to save money
Shah Gul	Ø¨Ú¾Ù¹ÛŒ ØµØ§Ø­Ø¨ Ø¨Ø§Ø² Ø§ÙˆÙ‚Ø§Øª Ú©Ú†Ú¾ Ø²ÛŒØ§Ø¯Û ÛÛŒ Ø¬Ø°Ø¨Ø§ØªÛŒ Ú¾Ùˆ Ø¬Ø§ØªÛ’ Ú¾ÛŒÚº Ø§ÙˆØ± Ø­Ø¯ Ø³Û’ Ø²ÛŒØ§Ø¯Û Ù†Ú©ØªÛ Ú†ÛŒÙ†ÛŒ Ø¹Ù…Ø±Ø§Ù† Ø®Ø§Ù† Ù¾Ø± Ú©Ø±ØªÛ’ Ú¾ÛŒÚº
kashif Jawad	Bahut bara Lanati hai bhatti
Muhammad Akhtar	Ø¨ÛØª Ø³Û’ Ù„ÙˆÚ¯ÙˆÚº Ú©Ùˆ ØªÚ©Ù„ÛŒÙ ÛÙˆ Ú¯ÛŒ Ú©Ø±Ù¾Ù¹ Ù„ÙˆÚ¯ÙˆÚº Ú©Ùˆ
Tanweer Qureshi	Sabir Shakar Sahib you made my day I hope these corrupt never get NRO these Sharif and Zardari family should be eliminated from the politics for ever the people of Pakistan have seen enough of their so called good governance the whole nation is sick and tired of these corrupts
N. K. Khan	Let me tell you a great secret Bhatti Sahab Do not wait for the last judgement it take place every day So go and put your creed into the deed Don â€™ t speak with double tongue ğŸ‘ğŸ¼ğŸ‘…ğŸ‘…ğŸ‘…ğŸ‘ğŸ¼
Javed Malik feroz	Good
Ghania Nasir	Bhatti Saib are u crezy
Jafariqbalkhattak Khattak	Acha program Sabir shakir zinda bad
hajira tahir	ye cj choron ki saath mil gya ha saad rafiq jaise corrupt ko chor dia jata ha aur ig change hone par maut par jate ha isse
Hamza Imran	Bhattu ko bhe dana dunka milgya hai isi leay behki behki batein kr rha hai
Nadir Hussain	bahtti sahab ap bhe chorohin ky sahat
Sager Khan	Bhatti Sab what are you taking Altaf Imran bhai bhai very sed on your
Ihsan Haq	STUPID IDIOT BHATTI IS IGNORANT HE TRIED THIS NONSENSE OF CALLING IMRAN AND ALTAF BHAI BHI LISTENING TO HIM IS WASTE OF TIME
Pakistan sab ka bap hai pakistan sab ka bap hai	Bahtti donki ki king haiğŸ˜‚ğŸ˜‚ğŸ˜‚ğŸ˜‚ğŸ˜‚ğŸ˜‚ğŸ˜‚ğŸ˜‚ğŸ˜‚ğŸ˜‚ğŸ˜‚
Zeus7777 Appolon7777	Bhatti sahib Punjab MEIN pti GOVT NE 700arrab rupee KI ZAMEEN GOVT KO wapis KI hey QABZA group SE Overseas money KO wapas Lane MEIN time lagta hey Fazool me ham SAB KO mayus na karen
Abdullah Khan Abdullah Khan	ÛÙ… Ø¬Ù†Ø§Ø¨ ÙˆØ²ÛŒØ±Ø§Ø¹Ø¸Ù… Ø¹Ù…Ø±Ø§Ù† Ø®Ø§Ù† Ø§ÙˆØ± Ø¢Ø¦ÛŒ Ø¬ÛŒ Ù¾Ù†Ø¬Ø§Ø¨ Ø§Ù…Ø¬Ø¯ Ø³Ù„ÛŒÙ…ÛŒ Ø³Û’ Ú¯Ø²Ø§Ø±Ø´ Ú©Ø±ØªÛ’ ÛÛŒÚº Ú©Û Ù¾Ù†Ø¬Ø§Ø¨ Ù¾ÙˆÙ„ÛŒØ³ Ù…ÛŒÚº Ú©Ø§Ù†Ø³Ù¹ÛŒØ¨Ù„ Ú©ÛŒ Ø¨Ú¾Ø±ØªÛŒ Ú©Û’ Ù„ÛŒÛ’ Ø¹Ù…Ø± 18Ø³Ø§Ù„ Ø³Û’ 22Ø³Ø§Ù„ Ú¾Û’ Ø§Ø³Ú©Ùˆ 18Ø³Ø§Ù„ Ø³Û’ 25Ø³Ø§Ù„ Ú©ÛŒ Ø¬Ø§Ø¦Û’ Ø§ÙˆØ± Ù…ÛŒÙ¹Ø±Ú© Ù…ÛŒÚº 50 ÙˆØ§Ù„ÛŒ Ø´Ø±Ø· Ú©Ùˆ Ø®ØªÙ… Ú©ÛŒØ§ Ø¬Ø§Ø¦Û’ 2017 ÙˆØ§Ù„Ø§ Ø§Ø´ØªÛØ§Ø± Ú©Ùˆ Ø¨Ø­Ø§Ù„ Ú©ÛŒØ§ Ø¬Ø§Ø¦Û’ ØªØ§Ú©Û ÛØ²Ø§Ø±ÙˆÚº Ø¨Û’ Ø±ÙˆØ²Ú¯Ø§Ø±ÙˆÚº Ú©Ùˆ Ø±ÙˆØ²Ú¯Ø§Ø± Ù…Ù„ Ø³Ú©Û’
AM.gaming and cards Abdul-muhyee	Bhatti should be on khabarnaak with other marasis he should not be on the same level a sabir
Muhammad Javeed	Bhatti SB you idiot
Muhammad Malik	NAB KA BUHT BUHT SHUKRIA CHHOTAY SHER KO KAMZOOR NAHI HONAY DIA USS KAMRAY MEIN RAKH KER JAHAN SOORAJ KE ROOSHNI BHEE NAHI AATEE ALHAMDULILAH INTAHAI ACHHI SEHAT HAI LUHGTA HAI CHOOTA SHER CHAIRMAN NAB KEE TAFTEESH KER RAHA HAI
Ballu Paanwala	Imran Taliban Homosexual wale Khan is failed Politician ğŸ–ğŸ–ğŸ–ğŸ–ğŸ–ğŸ˜‚ğŸ˜‚ğŸ˜‚ğŸ˜‚ğŸ‡µğŸ‡°ğŸ‡µğŸ‡°ğŸ‡µğŸ‡°ğŸ‡µğŸ‡°ğŸ‡µğŸ‡°
nighat hanif	I watch only the reporter now But because of bhatti it is going to messy who said he is chief bureau he look like immature and insensible
Ali Hamza	Sir g u are amzing Ap nye hmesa sach apne awam tak phcnhyia hy Meri ap sye ak he drkwast hy ka PLMN oR PPP ka asal chara lzmi smne rhkyae ga
Muhammad Atif	Love you pak isi and pak armyğŸ‡µğŸ‡°ğŸ’šğŸ‡µğŸ‡°ğŸ’šğŸ‡µğŸ‡°ğŸ’šğŸ‡µğŸ‡°
Samia Sheikh	Bhatti Sahib why you are so negative about IK I hate you when you say that and do not see what ha been changed so far I think people are more smarter than you You should not be here Very negative attitude Even what ever is happening is because of PTI Government Sorry to say nut please keep you mouth
Sfgfc Vvccfh	saber u great
Shah zain	Ø³Ù†Ø¯Ú¾ Ú©Û’ Ø¹ÙˆØ§Ù… Ù†Û’ Ø§Ù¾Ù†ÛŒ Ø¯Ø§Ú‘ÛÛŒ Ø§ÙˆØ± Ø§Ù¾Ù†ÛŒ Û”Û”Ù…Ø§Úº ØŒ Ø¨ÛÙ† Ú©ÛŒ Ø­ÙØ§Ø¸Øª ÚˆØ§Ú©Ùˆ Ø²Ø±Ø¯Ø§Ø±ÛŒ Ú©Û’ ÛØ§ØªÚ¾ Ù…ÛŒÚº Ø¯ÛŒ ÛÛ’ Û”Û”Û” ÙˆÛ Ù„ÙˆÚ¯ Ø§Ø¨ Ø´ÙˆØ± Ù†Û Ú©Ø±ÛŒÚº Û”Û”
Malik Awan	Kamal ye ha ke aik taraf in per money laundering ke kaises hain dosarey taraf qoam ka paisa lharach ker ke Natiomal Assembly main late hain kya ye khulla tazad nahe
ch.abdulsattar Jani	Nawaz shareef shabaz shareef rana sanaulla saad rafeeq khwaja asif in bhan chodo ko goli mar dani chaiey q k ye asli khanzeer ke bache he bhan chod
EX FATA QABAIL	Ø´ÛŒØ·Ø§Ù† Ú©Ùˆ Ø¬Ù†Øª Ø§ÙˆØ± Ù…ÙˆÙ„Ø§Ù†Ø§ ÙØ¶Ù„ Ø§Ù„Ø±Ø­Ù…Ù°Ù† Ú©Ùˆ Ù¾Ø§Ø±Ù„ÛŒÙ…ÛŒÙ†Ù¹ Ø³Û’ Ù†Ú©Ø§Ù„Û’ Ø¬Ø§Ù†Û’ Ú©Û’ Ø¨Ø¹Ø¯ Ø§ÛŒÚ© Ø¨Ø§Øª Ù…Ø´ØªØ±Ú© ÛÛ’ Ú©Û Ø¯ÙˆÙ†ÙˆÚº Ù†Û’ Ù„ÙˆÚ¯ÙˆÚº Ú©Ùˆ Ú¯Ù…Ø±Ø§Û Ú©Ø±Ù†Ø§ Ø´Ø±ÙˆØ¹ Ú©Ø± Ø¯ÛŒØ§
M. Adil	Arif Bahtti ik mayo insan he
Yousuf Sabir	Jis country ne nro ka kaha wo hai Qatar 100 percent correct âœŒ
Rukashana Waheed	chore chore chore pasey wipeas do zardare nawaz shabaze hamza chore macheay sure chore macheay sure lakdelanet lakdelanet ğŸ‘‹ğŸ‘‹ğŸ‘‹ğŸ‘‹ğŸ‘‹ğŸ‘‹ğŸ‘‹ğŸ‘‹ğŸ‘‹ğŸ‘‹ğŸ‘‹ğŸ‘‹ğŸ‘‹fatamue fatamue
Pyarali Khoja	I m shocked with Arif Bhatti he is comparing Imran with Altaf
alex phy	ya Batti hamisha mayoosi pailata rahata ha i manoos ka our koi kaam nahi ha
VIJAY SIR Ji	Imran khan Pakistan ka Super Hero bnne ki Koshis kr raha tha pr Chief Justice ne usy Joker bna dia ğŸ˜ƒğŸ˜‚ğŸ˜ƒğŸ˜‚
Safina Safina	Bati sab don t say about imrankhan He is the 1 who will take Pakistan on Wright deration Please sport Pakistan
blackgoldseeker	Ye Lahoriye Imran ki mukhalfat krtay hi krtay hain jaisay k ye clown Arif Hameed Bhatti
Aziz Patel	Chief justice sab Sab ko chuteya bana raha Panama me box no 10 gum maryam nawaz fake document Gum so many so moto Liya So many notice 3 saal me ek bhi aadmi jail nahi gya na hath kadhi na money wapas aaye Chief justice sab zinda baad mat kaho pehle zinda karo chief justice sakib nasir sab ko
Shahnaz Qazi	Bhatti Sahib you watch your mouth about Imran Khan
Wasil Burki	Bhatti should be made PM Maybe that will shut him up
mario khan	Ø¹Ù…Ø±Ø§Ù† Ø®Ø§Ù† Ø²Ù†Ø¯Û Ø¢Ø¨Ø§Ø¯ Û”Û”Û”Û”
Aftab Ahmad	ihtsham sb sabir sb your analysis so good and better so called other ankar ğŸ‘ŒğŸ‘ŒğŸ‘ŒğŸ‘ğŸ‘
ZULFIQAR Ali	GOOD ARY G
Akhtar Rao	Ø§Ùˆ Ú¯Ù†Ø¬Û’ Ù†ÙˆØ§Ø²Ø§ ØªÙ… Ø¬Ú¾ÙˆÙ¹Û’ Ú¾Ùˆ Û” ØªÙ… Ù…Ù†ÛŒ Ù„Ø§Ù†ÚˆØ± Ú¾Ùˆ Û” ØªÙ… Ú©Ø±Ù¾Ù¹ Ú¾Ùˆ Û” ØªÙ… ØºØ¯Ø§Ø± Ú¾Ùˆ Û” ØªÙ… Ú©Ùˆ ØªÙˆ Ø³Ø±Û’Ø¹Ø§Ù… Ù¾Ú¾Ø§Ù†Ø³ÛŒ Ø¯ÛŒÙ†ÛŒ Ú†Ø§ÛØ¦Û’
Hina Niazi	Ø¯Ù†ÛŒØ§ Ú©Ø§ Ø³Ø¨ Ø³Û’ Ø¨Ú‘Ø§ Ø¬Ú¾ÙˆÙ¹ ÛÛ’ Ø¬Ø¨ Ø´Ø±ÛŒÙ ÙÛŒÙ…Ù„ÛŒ Ú©ÛØªÛŒ ÛÛ’ Ú©Û ÛÙ… Ù†Û’ Ú©Ú†Ú¾ Ù†ÛÛŒÚº Ú©ÛŒØ§ Ø§ÙˆØ± ÛÙ… Ø¨Û’ Ù‚ØµÙˆØ± ÛÛŒÚº ğŸ™‚
