Agent K	DAMN THIS GUY HAS BARS ALL DAY
Daniel Sandoval	Bismak with the big smack I love this guy
Bob Lee Swagger	On the nba dot com tgjfkslxc
O INUSITADO	TIROU A ARMA DO PORTA MALAS http youtu be PYKRfbd1Q1s
Biffalo Bull	Shebron can make a three but not a free Lakers 0 3 Ain t nuttin here to see What it gon na be
NPC #3974163	Bismarck with the big smack delicious
Davaun	Better on the scoop than Baskin Robbins Jeez
Zexi Dong	you nba official really disrespect spur and their player
Joshua Gilley	Lavar ball I could do all of those upside down with my eye closed
Tomas Kubinski	This segment need a new commentator Too many metafors Dude is annoying
Reyson Zarate	and the game winner is gone
YossiDagan	wow goatmenator in his prime right here
DentargPL	Where s Rudy block on LBJ
Kingbing _cash	LIL PUMP
Nate walker	That rhyming though lol
CHARLES TV	http youtu be fg2XMl5whpM
Regie balasbas	1 like button is not enough for great Goatmentator
Kai Burmeister	STOP RHYMING
Kevin M	Man this voice announcer kill I wonder if he writes a script up while watching the clip but he s good
Austin Walkup	I honestly don â€™ t care what number but if Lebron get 2 then Patty at least deserves one spot to show him icing it
Leandro Reyes	Skeets
Joe Soile	MUTE Mofo ing metrosexuals
JP Tizon	No Respect on Patty Mills Game Winning Shot that s cute
hazyMAGPIE	LUKAAAAA ROTY
Kelvano Burrows	Where is lillard left hand dunk on Oubre
Den Ber	Yeah NBA have you read some of the comment Well Let me add my comment on top of those YOU PUT LBJ SHOT TWICE BUT NO PATTY MILLS WINNING SHOT CMON NOW
michael gutierrez	More on Lechoke than my man Patty Game winner NBA selection is trash once again
MJ AC	I m a lebron fan but lebron tying three is better than mill s game winner Really How bias is this Haha
mert firat	Thank god for the GOATMENTATOR
daniel trang	Patty mill nail those shot constantly Get him to pull up from a deep three like LBJ to tie the game Unlikely Aussie myself but sorry the king is called the king for a reason
Raffa Saadi	Fucking shit loser have highlight the winner no highlight bullshit
Da ReMicks	leBron is da Man but damn doe not deserve a spot on this top 10 bias and weak compilation NBA
Ghost Henson	His voice ruin the highlight
Bertin Etem	I m just here for this awesome commentator
Sambo	Bro commentator got more bar then these rapper nowadays ğŸ˜‚
Senyor Chang	Lunka looking like a 10 year superstar veteran
taprackbang88	Harden dunk on LBJ AND McGee and no mention but LBJ get 2 spot for a game they lost FOH
Romnick Aljecera	patty patty patty it s in the same game day right
Chris	How is there no game WINNING shot This is why people can t stand LBJ or the MSM FakeNews
Ocean Seaweed	Still cant fuckin tell what he s saying at the end
Josh	this guy is rhymin like crazy
Jez1496	why lebron is the 2 they lost the game patty mill game winner WTF
Saurav Chandra	D Rose crossover
OVO Feels Gets Carried	So we goin ignore that other Lavigne dunk ok
Matt Butler	How are you not gon na show John wall win securing block
Jon G	Damn im gon na miss this guy and his one liner or two either way he s GOAT
Vincent Chauvet	more bounce then a kangaroo on the moon
LeHenryCotton	If one of you guy could check out my MVP Drose mix and drop a like it â€™ d mean the world to me
ClydeBenedict57	Javale mcgee s rebound and followup is better than any of these
MhinShin	No Stephen Curry on Dbook and Patty Mills game winner What the heckğŸ˜¡the worst Top 10 I â€™ ve ever seen
gippo alonzo	Top 10 got no love for spur GG Patty 3
JA0911 GaminG	No 1 should be LBJ free throw because it is not a choke Stephen A Smith
Humberto Cardoso	Patty
delon t	Better on the Scoop then Baskin Robbins LOLOL
Jejomar Benigian	No Mills Too bias
edwindmunoz	So I love LeBron but why is his 3ptr ranked at 2 As Troy Asquith said Patty Mills shot should be on top of instead Stop being so damn biased promote the game not player http www youtube com watch v 6Gk5m7Dxx08
Yudi Peralta	470
ä½™äº®å‡	No way patty mill isn t there
alexander tsetskhladze	2 TIME Finals MVP
BnaBreaker	Theeee NBA commmmmmmm DSAFOWIJAFIWFH
That dude Cole	I love this gy voice ğŸ¤£ğŸ¤£ğŸ¤£ğŸ’¥ğŸ”¥
sintwoOone	Certified Lebitch cock swallower
Aleksandros Ksanthopoulos	I wonder why LeBron shooting and missing free aren â€™ t here sure were better than Mills â€™ s winner
andy kodakAP	Instead of showing LeBron make those shot should of should him chocking against the best team Spurs baby 210
Cam	SHUT THE FUCK UP Anyone remember when highlight were about the play and not the commentator How the fuck did it come to this
Samuel Glidden-Fry	Rudy Gay REJECTED LeBron and Patty Mills sunk a game winning jumper on the Lakers but instead of seeing those we see 2 LeBron play that weren â€™ t all that special and a regular dunk by the Warriors What b
Nino brown	I like this guy He turnt up
physics2112	Brilliant
Zee Martin	Lebron Travled
FRB88	No Mills game winner Jajajaja
Jackson Littlewood	Ok seriously what â€™ s with all the rhyming
Wilbert Saintil	This guy ha barsğŸ˜…ğŸ’¯ğŸ’ªğŸ¼
Anthony Okeiyi	This guy is Legendary
Kiel Babac	mill game winner curry saucing up db and also his crossover and euro to an open three guess the lakeshow is back smh The nba back at it
Marcin Marcin	Lebron traveling OMG
Rawr5649	Dude we got it you can make rhyme now please cut them back by about 90
Robbie Johnson	Dick ride the lakers so tough Mills shot wa waaay better smh
jayr arciaga	No Patty Mills Stupid top 10
Matt Taylor	no patty nothing from the wild WAS POR game just some average dunk and lebron terrible list
HonestLyrics 100	Biyombo is SO underrated
Sanch Jim	When the game is on the line LeBron choke two free throw
captainhobo1234567	How the fuck are they gon na disrespect my spur like that LBJ get two top three spot for clutch play in a game he LOST and my man Patty Thrills get jack shit
Romer Bautista	Game tying 3 of Lebron is more clutch than patty mill game winner you kiddin right
Eric Chuang	shoutout to JE SKEETS if it wasn t for him it would ve been lebron s 2 missed free throw on 1 on the nba dot commmm top10
Matthew Spurs	Wait so Lebron tie the game and get in but Patty WINS the game and doesn t Silver and the NBA homo for Lebron
Thefox. com	PATTY MILS
tuileandganache ganache	Top 10 play not Top 10 Sauciest play C mon man Norman Powell over Patty Mills game winner
Roldan Ramirez	3 2 L
Pratik Narwal	Missed GOATMENTATOR more than NBA supahotfiya
Wonel2K	No mill game winner no wall dagger no Rose crossover no Steph crossover on booker but instead we have lechoke who is 0 3 Gianni s easiest oop Durant and lavine uncontested dunk
nisino25	They fucking retarded
azizair	1 spur last play double screen to free up Patty Mills for the winning shot
nachh0	these pun are so annoying I m keeping the volume on 0 everytime
Tyrone Cunningham	and the LA Symphony ha a new conductor and when the game is on the line he call on the string section I mean how great is this guy with the metaphor This announcer s the ğŸ
Isaac Cohen	He â€™ s the best commentator by far
Marvin Reid	Man Lakers should â€™ ve won that game
juanvictord	Este top 10 estÃ¡ vendido donde estÃ¡ Patty Mills
Matus	where is D Rosee cross
tranlanga mingo	WHEREDAFUQPATTY
Ken Moe	Damn I miss Stuart Scott
Jake Williams	Why doesn t this guy have a record deal
Bordzy	Powell WeTheNorth
Charles Green	Bro I swear he â€™ s the best video announcer for the NBA no one ever should announce but him ğŸ’¯
real ghost hunting adventures	You should re upload and put spur in there we got block and a game wimner but no you still dont and lakers lost
Andrew O'Donnell	How is lillard â€™ s dunk not on here
Stephen Curry	Too much dickriding of lebum
Knick Johnson	nba is so rigged they favour the lakers and lebron but still they cant win lol How are u not gon na have the patty mill game winner on here
Martin Onuegbu	what s goatmentator saying at the end of the hgihlights
Mr Winter	JE Skeets shout outğŸ˜‚ğŸ˜‚ We The North ğŸ˜³ğŸ˜³ğŸ‘‘
The Gunner	topten topten
Kevin Wang	GOAT COMMENTATOR
Sugeng Purnomo	Hit big shot but miss easy shot Always like that i don t understand with Bron how it happened almost everytime
Ablene	What about Johnathan Williams block on DeMar Derozan
KnewportEnt713	The disrespect on patty mill oh my ğŸ˜ª
HALA Madrid	No love for patty Mills
Jist	My today no1 is stephen curry 2quarter stepback 3point shot Is perfect stepback So amazing move
Frank West	â€œ Better on the scoop than Baskin Robins â€
Marko Keskitalo	These list are fucking bullshit nowadays nothing but LEBRON ASSKISSING and DUNKS
Labiang Jonathan	nba love lebron so much lmaooo
Andrew Gomez	You fucking pussy Patty Mills Should be number 1 or 2 with that game winner against the Lakers
Jude Tumogdan	This is so bias I hate it
Seth Toland	Yall really gon na just ignore the patty mill game winner cuz it wa against bron ğŸ˜‚
Ian de la Cerna	rudy gay s block on the travelling lebron
Matt Sandells	Goatmentator I love you
CiCLoDoL	Doncic played 3 game two time in top 10 play already haha It s only the beggining
Bishop 619	That 1 wa weak
David Sacre	Bruuh the reporter is a beast ğŸ˜‚
quamail10	No Damian lillard dunk
Reumil Moreno	Patty Mills game winner should be 1 Curry put booker and the other sun on skate a well Drose had some flashback too Crappy top 10 goatmentatornomore PS Those who hit the like button are salty lakers fan Lol
mike theud	More bounce than a kangaroo in the moon GOAT
Billy Zambidis	Are you SERIOUS NBA Dick Riding LeChoke WAY too much it would be fine if you had Patty Mills game winner SOMEWHERE in here BIG L
T.J. Sandhu	Thank you put some respect on the Raptors name
charles pitter	More bounce than a kangaroo on the moon to deliver the boom smh this guy is the greatest
Asher Bean	bro you got ta stop rhyming everything
Marquise Robinson	Whos the commentator he funny a hell
jef rosimo	i wa so sure the patty mill game winner wa top 1 what the are you kidding me NBA what wa that number 1 a regular dunk anyway we all here know it wa the top 1
Michael Caruth	â€œ Better on the scoop than Baskin Robin â€ I felt that
Gabe Ratcliffe	I think we need to have a goatmentator guest appearance on The Starters ğŸ¤”ğŸ¤”
Tommy	ãªã‚“ã§ãƒŸãƒ«ã‚ºã®ã‚²ãƒ¼ãƒ ã‚¦ã‚£ãƒŠãƒ¼ãªã„ã­ã‚“ã‚“ã‚“
Kikz Bau	You should put bron bron choking at 1 NBA riding bron s dick again lol
AWD 22	A lot of player get the number one play if they hit the game winner Patty doe it and is not even in the top ten
no future at all	Dislike No highlight at least one from Wizards Trailblazers game and no Patty Mills game winner
King Vintage	Disrespectful DRose â€™ s killer crossover didn â€™ t even make top 10 but some average dunk made it
Hawthorne Hunter	wtf where is patty mill game winner curry s crossover euro splash
calvin jenkins	Where is DRose crossoverğŸ¤”
Letter A	Goatmentator WordPlay But man patty mill should be on the list
Ashwin Raj	Patty Mills got snubbed smh
Borja PÃ©rez Ventura	No Patty No PartyğŸ˜ª
Linus Granberg	Built like a tractor
Olesor Barredo	KD s dunk is nothing compared to Mills game winner hahaha allstar treatment here in top 10 hahaha
Suar SP	What about d rose s cross over
Joshua Strauss	Im a lakers fan but honestly how is patty mill not number 1 he hit a game winner and thats somehow not even in the top 10
Neil Eric Orlanes	Where s patty the silencer mill Cmmon man
Kebin Galo	I wa waiting for the DRose cross on Bogdanovic And don t forget that game winner from Mills
George Clooney	If it would have been Lebron making the same shot Patty Mills made to put them up at the end of OT he would have got the number one spot Smh you bitch
Aki Anonuevo	Number one should be for lebron for missing the two free throw to let the Spurs win OT
EVANSCLAN	This is why Australian medium and Australian NBA fan think the nba ha something against AustraliansğŸ˜‚
Chrisztof	Luka rooke get the cooke
Anthony Ventula	goat mentor your lebum fan how about patty mill
1k subs without a video challenge !!	Can i get 2 sub
Alessandro Ceo	Og anna no way ğŸ˜‚ğŸ˜‚ goatmentator ğŸğŸ
Vangidism C	Feat J E Skeets wow
vise yviseman	biased
Andy Newton	no respect for patty
Christian Rey Sanopo	Bismack with the big smack i love that ahhaha
Alford Cas	LeBron lost and made the countdown twice This video must be a parody
poboy fresh	â€œ Bismack with the Bigsmack â€ goat commentator
nintendo spurs	Mills got robed
eric gumpper	So steph curry toying with devjn booker isnt better than that zack levine dunk okay
Kobe Lackin	Patty mill game winner
Al Wong	Where are those missed free throw by lbj lol
Wyatt Cobb	WAIT WHERE WAS BEALS 3
Marco Lertora	what a shitty top how much publicity NBA need to keeping look for the name and not the play we are with u Patty TOP 1
Aaron James Baligod	NBA biased by LAL and GSW
Aidanpv	rudy gay block on LeFail
Andre Royal	So no d rose or patty mill oh nba y â€™ all stupid stupid
Matt Schatz	What about Juancho s game winning double block against the warrior
Russell Smith	LeBron missing those 2 free throw at the end of the game should be 1
Muscat10	Yo Norman Powell I m really happy for you I ma let you finish but Patty Mills had one of the best clutch game winner of the season One of the best clutch game winner of the season
George Anto	Lebron making a freethrow should have benn number 1
SSJ Kenny	Better on the scoop than Baskin Robbins ğŸ˜‚ğŸ˜‚ Goatmentator ğŸ‘ğŸ¾ğŸ‘ğŸ¾ğŸ‘ğŸ¾
Daniel Hutson	Warriors best ever
pothny3	He rhyme so naturally
Michael B	Where is Gay â€™ s block on LeBron Mills â€™ game winner
Carla Trott	Again these top play video should contain play from the team who WON THE GAME
gifted85cy	Knock knock Patty is that you
KOLUX 97	how about patty mill steph curry crossover on booker steph euro step pas relocate 3
G10VANN1 TH3 G35 FAN	As a spur fan it expected for u to be shown no love but we always end up in the playoff ğŸ˜„ğŸ˜„
K Yu	so a clutch shot to force a ot is more impressive than a buzzer beater to end the ot game
Anonymous	Where is JJ Barea
John Doe	WHERE THE FUCK IS PATTY
snah onab	Where is drose crossover
Stephanie Rkdjfbdn	No steph playsğŸ‘
Daylight	the 1 deserve with LEBRON free throw
Kaelen Brix	the missed clutch free throw should be here damn it
Jack Cooper	this is the most b top 10 ive ever seen NBA once again only care about big named people and when for instance people like kelly olynk or patty mill hit a gamewinner they just completely ignore it Biggest load of crap i have ever seen and will keep spreading my hate until the NBA show some goddamn repsent to australian
ivan	Where is steph s stepback on booker
SamuraiJack	MISS FREE THROWS BY LECHOKE SHOULD HAVE BEEN TOP 1
ã‚ã²ã‚‹1905	ã‚„ã£ã±ã‚Šã€ãƒ¬ãƒ–ãƒ­ãƒ³ã¯ã™ã’ãƒ¼ ãã—ã¦ã€ãƒ‰ãƒ³ãƒãƒƒãƒã‚‚ã™ã’ãƒ¼
Vincemoke Luffy	No patty mill No curry cooking dbook No drose amazing crossover Just shit
Ghfgsa	No Otto porter no patty Take that L
Joe McDonald	Who else hate the NBA editing this year first shaqtin is terrible now and the top 10 there just commercialising their marketable player rather then the top ten actual play smh
Niccolo Banini	Bridges gon na be a problem
bruce lau	WOW no Patty Mills GW damn
Roberto DÃ­az Merino	honestly why do you care so much if your fav play doesnt appear do you start cryin or sum you can watch it in another video jeez and you complain about people complaining about everything these day it just a video
MrLtotheA	Best commentator
Joseph Ferrera	Wheres patty mill game winner Biased nba SMH
Mr. Wonderful	1 dislike for Goatmentator s top 10 play No patty mill gamewinner shot
Thanongrit Suriyarungka	Deandre wa late at the date And kd leaf him with the bill Call the fireman there s too much fire in here Omg what a metaphor The bill is the price to pay for being late at the date The price ayton paid wa two point allowed for being late at the rim v kd late at the date
djctoafn	WTF this guy too busy rhyming Tractor and Raptor to realise Patty Mills giving LBJ the L Get your head outta your as mate
Banks the halo great	Levine one the greatest dunker of all time that a big statementğŸ¤¨ğŸ¤·â€â™‚ï¸
Zsa Tenorio	Bron freethrow should number 1
aldrinz gesmundo	Where s Patty mill Winning shot
Rosemarie Valbuena	No rose crossover
raynmaker21	Editor must be a laker fan and got but hurt lol How can Patty Mills game winner not be 1
Le ComÃ©dien	Look Lavine he want a foul call but nobody touch him XDDDD What a fagot fuckin looser
Meauxten	Seriously how the HELL did the GAME WINNER by Patty Mills not make the list but the GAME TYING shot from LeBron did
Joseph Kapa	â€œ Luka the rookie get the cookie here at number five â€ GOATNESS
Lorenzo Severi	I guess winning the game is not a good play anymore
Night Mist	Does the spur ever get a damn highlight
Ericson Imperial	Dumb mother fucker host no game winner for patty mill Really
Hannes Neumann	Doncic should be 3
FrenkyCRO	DonÄiÄ‡ looking like PetroviÄ‡ on Olayuwon Also that wa travel
TÃ¼mer Onur TÃ¼zÃ¼n	GOATMENTATOR
Marc Tan	Where is Patty Mills
Coco Buff	Spurs are done
grunermrk	I hate that the top 10 play are like 8 dunk and maybe 2 actual good play I m a Raptors fan and that Powell dunk shouldn t even be on here There were much better play from the game like Danny Green deflecting a pas Kawhi running the ball into the paint then back out to Green for the 3 This is a well executed play A single dunk is not a good play
Jerome Reynoso	Where is patty mill game winner
im a Troll	Where wa the two missed free throw of Queen James It should have been top 1 why stop at no 3 and 2 smh
Chiminie Pabo has hella Jams in his Bag	fir time evel I disliked a video the goat is commenting But seriously where is patty mill That s some di riding at it s finest I m a LBJ fan but should have included his 2 FT s instead
Maaz Qamar	wheres curry shot on booker that shud be no 1
Deondre Clark	Gooood evening sweet world
Desi Reuben-Sealey	Victor Oladipo better on the scoop than Baskin Robbins ğŸ€ğŸ”¥
Mike Steevens	Luka Doncic double dribbled if u watch closely He dribbled stopped 4 the fake then did 1 dribble then passed it
Villanybalalajka	bismack with the big smack give this man a full time job
Roland DuSon	I would pay to get them to stop commentating completely
Rodney McGruder	Boucing like a kangaroo on the moon
Bhavya Singh	Where the hell is D Rose ğŸ€ ğŸ”¥
Johnny Flash	THE GOATMENTATOR IS BACK
Aundrei Gabriel Vallar	Drose froze a guy on a crossover on one play and made a pump fake in mid air before getting an assist on the other Patty Mills shot a game winner Kawhi made a ridiculous pas to Green for 3 But we get 2 open lane dunk from KD and Bridges How can that be considered a top play ğŸ¤”
Zach Dunkhase	Where curry saucing the sun and where party mill game winner
Armaan Sharma	I thought that Derrick Rose cross over would be here
UKFxVanDread	This is dumb Patty Mills game winner nowhere to be seen just like in previous top play Beals 3 point record wa on and not Jokics historic triple double that hasn t been seen since 1967 But i guess Beal can rhyme with more stuff than Jokic so that gave him automatic spot in top play
Justin Y.	Let s go Skeets with the mention ğŸ˜‚
Keans Algara	Patty Mills game winner This editor hate the spur so much ğŸ˜¡ğŸ˜¡ğŸ˜¡
Oliver Strubel	Maxi Klebers backdunk missin Much better a the boring forward dunk
Hani ali	never i have seen lebron doing that kind of fake the new manu ginobili maybe even better luka doncic 0 56
Biodynamik-Wien	Goatmentator straight ğŸ”¥
Lolll Jdd	1 should be Lebron choking the free throw
Nathan Rice	Patty get no love worst number 1 ever
Ram Ng	Goatmentator where is Patty Mills
Aaron Perez	Number 1 should be LeFlop Choking at free throw
Mr Logical	Somebody please check on the CRINGEMENTATOR I m worried about him he not answering his text or call I THINK HE GOT TOO DEPRESSED AND OVERDOSED ON HEROINE ğŸ˜¨ğŸ˜©ğŸ˜¨
Pedro Silva Pereira	Damn 2 LbJ highlight but no patty mill clutch If you wan na show LeBron that much just put his bigger highlight of the night you know the one where he choke from the charity strip
Nathz Villanueva	LeChoke
Vince Meng	I just come to see if Patty s last shot win the top 1 but guess what YOU BEAT BRON YOU ARE NOT GOING INTO OUR HIGHLIGHT OF THE DAY BRON NEED DA WIN
All Day Long	this is trash
Spicy Wings	WHERE TF IS PATTY MILLS
Francisco Baeta	Where are LeBron James missed free throw
Seweryn Janczura	NO 1 Should be rim protecting Spurs in last two FTs
Vuchina Vook	DonÄiÄ‡ explained
Phonomania Zwastika	Rigged
MartialMan	If yall did not have Patty Mills winner at least put LeChoke missed free throw at number 1 smh
loveja1234	Goatmentator should be a ghostwriter
Larry Fuqua	Don t need your top 10 if it s gon na be biased next time put in his 2 missed Freethrows UnsubscribeâœŠ
ragingfiip	Zach LaVine on the scene shining brighter than a moonbeam I feel like the Goatmentator just naturally rhyme when he talk Like he ll just be in a casual everyday conversation and he ll just rhyme every single line without even thinking about it Random dude Hey man how s it going Goatmentator Oh everything s fine but do you have the time Cause I got ta be somewhere at a quarter to nine
VASTOR	No mill game winner or D Rose crossover who the fuck is producing this garbage
Czebastian Aqi Mayor	a Platinum play button award from youtube for GOATMENTATOR
CB MIXTAPES	The one time patty mill ha a chance to be on the top ten they decide that an open dunk is better than his game winner smh
Brian Fantana	Usual suppa hot fire rhyme you got here Mr Goatmentator
San Anto	WTF Where is Patty Mills s game winner
Random Rob	Lebron missing his free throw should have been number 1
Paul Bryan Racines	Lebrons 2 Fts shouldve been the top 1 Loser ğŸ¤£ğŸ˜‚
SaveMe Jeebus	LeBron at 3 wa not a foul on Mills Mills get screwed twice by the Top 10 play
wusad	Doncic
Spider 11	Where the fuck is Patty
J L	No 1 is not no 1
Jose M. Jimenez	Where is mill here wtf with this top is Disrespect The effort of a team ComeOnMen
JT Luxx	This dude commentary made the video twice a good
Can we get 10,000 subscribers with 1 video?	NBA channel slowly creeping up on 10 Million sub
TheBeater 10	Overrated lebitch
Shamborg	How the hell is no 3 a foul LeBron run straight into Mills
da_resiak MC	Patty Mills game winner
BANAW 'Q	Serious for these where is the patty game winner shot Lechoke ğŸ˜‚
Jerry Lopez	Nba always looking for Lebron got top 2 and 3 What about P Mills Coz is a aussie Haisst
Gabby Baggy	Where is Patty Mills Game Winner ğŸ¤”ğŸ˜ğŸ˜¯
lance carmelo fortu	Patty mill
Jayr Agustin	Wowwwww no patty mill clutchğŸ˜‚ğŸ˜‚ğŸ˜‚
Freddie Lash	Lmaoooo how you gon na hold Patty Mills like that ğŸ˜‚ğŸ˜‚ğŸ˜‚ğŸ˜‚
Anthony Sanchez	Dont let these highlight distracted you from the fact that Anthony Bennett wa selected with the first pick in the 2013 NBA draft
Donald Allen	Why people get so hyped over dunk after all it the easiest shot to make if your at least 6ft tall and can jump that s what shaq did his entire career
Herbert Villegas	LeChocke miss 2 clutch free throw Lebron Go SPURS Go
Trung Pham	Number 1 play should be LeChoke s missed free throw
Mk fortnite	The speaker is a troll
Fatima AL-Enizi	1 should be LeBust bricking those two FTs LOOOOOOOL StriveForTrashness ğŸ˜‚ğŸ˜‚ğŸ˜‚ğŸ˜‚ğŸ˜‚ğŸ˜‚
xlynsanity BB	How can we make it to top 3 then choke the lead with 55 sec left in OT Smh if Kobe made two with torn achilles then how df LeBron can â€™ t make no free throw If he ain â€™ t that confident then why he went and took the pas if he know they â€™ re in the bonus He should â€™ ve let someone like Kuzma have the ball then shoot the free throw and most stupidest sh t I don â€™ t understand is why did he step back for long two instead of going to the rim hard and maybe get fouled At least he he got fouled they still got a chance winning it or tying the game with a free throw smh get y â€™ all sh t together Lakers Df is Magic doing signing these player like Lance and Beasley We can â€™ t shoot sh t and got no defense when it come to second unit
Aizya	GOATMENTATORRRR
IG Mylegasi	Fuck the NBA their commissioner Lebron
A A	More bounce then a kangaroo on the moon
legolas m	Who care about patty mill the goatmentator just said better on the scoop than baskin robin
Arexi Pukeniken	Why do you guy suck Lebrons peen so much
didnbens smsjs	Better on the scoop than Baskin Robins ğŸ‘ğŸ‘ğŸ‘
Alvin Bong Hui Min	All the super team are losing damn
The Rock	bias PATTY game winner shot should be 1
Gilbert Son De Leon	Patty mill
Phaedon Wallace	Where is Patty Mills s game winner
Kuqui-Is-Cool	Horrible top 10 I don t get why 3 and 2 are LeBron play and number 1 wasn t the game winning shot by Patty Mills the NBA put LeBron taking a crap at number 1 not hating but it just isn t fair plus why isn t LeBron missing to key free throw down the stretch at 1
Monsieur Biz	More bounce than a kangaroo on the moon nba we need a Top 10 comment from the real MVP GOATMENTATOR
Carl Austero	the game today are crazy
Odell Beckham	Everyone bitching about the Patty game winner Yes it s a shame but don t let that distract you from how good the GOATMENTATOR is
KULAS kulas	Patty mill should be number 1
Alan Brown	Finally my man back That chick wa boring af
Kim Jung Un	This top 10 wa boring
TaA Star	PATTY MILLS S GAME WINNER
Juan DelaCruize	Love the rhyme
will,	Not a single one of these line wa funny
robesch88	How the hell is Patty Mills game winner not in the top 10 First time in my life that I downvote the goatmentator
Michael Madrid	Where is mill shot
MicDubTV	My boy Luka making his doubter look a foolish a that defender O O
Francesco Gamba	n 1 should be James 0 2 from the free throw line and his last shot ğŸ”¥
Rob Diaz	Luka s 1
Barnawi	GOATMENTATOR at 1 5x speed
Kyle	God I m sick of this guy doing almost every single top 10 all he doe is recycle his past rhyme for each player it getting really damn old So overrated i wish they would just show the top play without any commentary if people truly love basketball the play will speak for themselves and won t need any tryhard commentary to make it interesting i feel like I am the only person who actually need to mute the audio when i hear his voice bc he make it so hard to watch the top 10
Jay's luggage	Think ya ll seeing dunk now wait till Zion hit the scene next season
Fabi Su	The DISRESPECT towards the whole Spurs Organisation and especially Patty more clutch than LeBrick Mills You wont brlieve it NBA
David BocandÃ©	more bounce than a kangaroo on the moon xD
Nicola Cenni	Where is Rudy
Zeljko Bogicevic	Goatmentator is on FIRE
Madara Uchiha	Goatmentator can kill everyone in the rap scene with his line
Basketball Never Stops	So we at the point of rewarding LeBron s game tying shot but not Patty Mills s game winner Smh
Ky Playa	the goatmentator
Packman	This man is a poet
YourManPyro	Goatmentor cadence dumb crazy
VegTheory	How did Patty Mills game winning shot get left off this list Whoever made the list must be a Lakers fan
Vair	more bounce than a kangaroo on a moon
ArXxâ„¢	Patty Mills
Brandon M	Everytime I watch these countdown I just turn the volume completely down because this fool voice annoying AF the shit he be sayin CORNY
Daniel Berri	1st
ichiro yuki	Don â€™ t let this distract you from the fact The NBA almost hit 10 million subscriber
Josh Brudo	lebrons two missed clutch free throw should be at no 1 ğŸ˜‚
WeThePeople018	Must be great sucking lebrons d all day every day how is lebrons game tie in the video but patty mill game WINNER not You guy are really making it obvious
NWS189	Kangaroo on the Moon
ãƒ©ã‚¤ãƒˆ	ã„ã‚„ã€ãƒ¬ãƒ–ãƒ­ãƒ³1ä½ã ã‚
adel gurgues	Where â€™ s curry cross on booker
Doyoan	Thats crazy
Sij Cecilio	Patty Mills shot that actually WON the game should be top 1 Steph Curry saucing on Dbook should be here too editor dumb
Chinnapol Ngarmjit	best commentator
Samuel A	when the GOAT doesnt do this my day isnt the same i legit look forward to this GOATMENTOR
Mikey M	Michael mcrudden just stick to one thing man
jester	Where s drose crossover
nandezomar	hold this L patty deserved number
Mr. G6	Who else didn t know that Goatmentators wa white He is better that 90 of the rapper nowadays
é€€å±ˆå¥	Where is Patty mill game winner
Nils Lunde	Bro Look at Zack Lavine at 0 23 who he think fouled him lol
kraziivan23	LOL JE Skeets wa the one who got Norman Powell a the no 1 play of the day thestarters jeskeets
ZMHighlights	NBA be like Patty Mills hit game winner i sleep Lebron tie game even though they still ended up losing REAL SHIT
Risky Prod.	No Derrick Rose ğŸ˜¢ğŸ€ğŸ”¥
AwkwrdW1llCmdy	I wa surprised they put Norman Powell posterizing Bridges on the list until I heard By request no doubt would have been Lebron making a layup in the first quarter otherwise
AC	Wheres patty mill at
Sol Anwar	Legendary commenting beyond entertaining
Russel Vasquez	The Goat Mentor Return Luka Doncic paralysis Justin Holiday s mind with his divine dime Wooooohoooo D but no patty mill game winner editor should be fair
Federico De Filippis	Lebron free throw should be number 1
Shareef Momand	I love the commentator ğŸ˜‚ğŸ˜‚ğŸ‘ŒğŸ¾ğŸ‘ŒğŸ¾
Christopher Emmons	lakers had this game
Ron F.	This is garbage No patty mill You should be fired for posting top 10 play and missing the best play in the game Oh and that s out of bound for Hart the ref tried so hard to get the first win for the lakers and still not enough
Roy Tutor	THIS IS A LIE Pipol who made this are dumbass You didnt inclue MILLS game winning shot While lebrons at number 2 How hard is that for lebron an uncontested shot YOU LYING NBA COM PIPOL Hope STARTERS wont do the same in their countdown u not motherfucker
SuperNASCARrocks	As a sun â€™ s fan 6 hurt â€™ s me Aw well I mean it â€™ s not like they had a chance anyway Aw well We â€™ ll move onto wednesday and the lakers I guess
childamnerd	gay block to lebron should be in top 10
Bonethigsify	Delivers the boom
Jakub 'Kubala' Janiak	TheStarters
John Paulo	LeChoke
Troy Asquith	So Patty Mills win the game for the Spurs and doesn t get a mention but LBJ get spot 2 and 3 for tying the game for the Lakers
kangaroo69ful	Weak top 10 but Patty mill hit a fairly open mid range with 6 second get over it
kobe bryant	Lakers 2018 2019 champ road to 79 3
Donald Trump	The Warriors will obviously win the championship but Toronto is their biggest threat Defense depth year upon year of potential to keep at it and most importantly no more Zaza to injure the Dub stopper himself Kawhi Leonard They will win 70 game this season
Tom Noonan	No love for my man Patty ğŸ‡¦ğŸ‡º
the king of cool	Work on your free throw Kobe
Theo Blanch	more bounce than a kangaroo on the moon God damn GOATMENTATOR W these metaphor
Malaki Cowboys	Yall need to include game winner yall on LeChokes nut ğŸ¥œ with two top 5 play and hyping it up when the ended up losing to a patty mill game winner
Simon Zou	Mills game winner They really don t wan na show any footage of Lakers losing smh
? ?	Where mah nigguh mill at doe
Arnonimus	with more bounce than a kangaroo on the moon hahaha GOATMENTATOR on fire
Almight Quen	Y did Lavine act like somebody fouled him
forsaken dota	MILLS game winner
Dylan Wickman	How is there no patty mill game winner lololol
Renz Eran Santos	First
#EyesDontLie Chosen 1	Hey you Yes you I hope you having a good monday night
JAI	First bitch
JOrdaniscoool	wow great video guy keep it up
Ğ•Ğ³Ğ¾Ñ€ Ğ¤Ğ¾Ğ¼Ğ¸Ğ½	
CÃ©sar Gerardo Millanes	ğŸ€ğŸ†
Morten Schmidt	3
