Raul Hood	Big Ãlbum hardwired Metallica for ever
Thor Thunderlungs	Robert s bass tone is total shit What the hell is he thinking
Matthew Clarke	I love this song and it made me incredibly happy when I saw them play it at the same venue two day later Great to see them still evolving and killing it live
MrDISTORT6	This song is better live
Nick X	Cool intro
joao rufino	Good
a fkin Potato	love the intro
Draizen Cato	8 42 so cute
K Dmitrich	Ğ•Ğ•Ğ•Ğ•Ğ•Ğ•Ğ•Ğ• ĞĞ°ĞºĞ¾Ğ½ĞµÑ† Ñ‡ĞµÑ€ĞµĞ· ÑÑ‚Ğ¾Ğ»ÑŒĞºĞ¾ Ğ»ĞµÑ‚ ĞºĞ°Ğº Ñ Ñ 2000 Ğ³Ğ¾Ğ´Ğ° Ğ½Ğµ ÑĞ»ÑƒÑˆĞ°Ñ ĞœĞµÑ‚Ğ°Ğ»Ğ»Ğ¸ĞºÑƒ Ğ¾Ğ½Ğ° ÑĞ½Ğ¾Ğ²Ğ¾ Ğ¾Ğ±Ñ€ĞµĞ»Ğ° ÑĞ²Ğ¾Ñ Ğ»ĞµĞ³ĞµĞ½Ğ´Ğ°Ñ€Ğ½ÑƒÑ Ğ¼ĞµĞ»Ğ¾Ğ´Ğ¸Ñ Ğ¸ Ğ·Ğ²ÑƒÑ‡Ğ°Ğ½Ğ¸Ğµ Ğ¯ Ğ¾Ñ‡ĞµĞ½ÑŒ Ñ€Ğ°Ğ´ Ğ¡Ğ»ÑƒÑˆĞ°Ñ ĞœĞµÑ‚Ğ°Ğ»Ğ»Ğ¸ĞºÑƒ Ñ 1989 Ğ³Ğ¾Ğ´Ğ° Ğ•Ğ•Ğ•Ğ•Ğ•
paweÅ‚	Ale gÃ³wno
Luken Struken	8 59 James is such a fucking troll hahahahhahah
Barry McNicholl	Why aren â€™ t Metallica playing uae They had a huge reception last time
ĞĞ»ĞµĞºÑĞ°Ğ½Ğ´Ñ€ ĞĞ¸ĞºĞ¸ÑˆĞ¸Ğ½	ĞÑ…Ñ€ĞµĞ½ĞµÑ‚ÑŒ ĞºĞ°Ğº ĞºÑ€ÑƒÑ‚Ğ¾ Ğ·Ğ²ÑƒÑ‡Ğ¸Ñ‚
Kevin Velasquez	Focking rocktarğŸ‘¿ğŸ‘¿
Fevaloution	The ending to this song ha to be one of my favorite it just so good \m
leandro vottano	Who mixed this song I think the sound of previous recital improved a lot
Axel Gutierrez	Good songâœŒ
David Knight	I wish I wa watching Metallica tonight
Pit G	6 42 little kirk mistake Hetfield smile hahahahhahahağŸ‘
L.A. Gengar	I love this song I really love it One of my favorite
R W	Greeny what a legendary guitar I m so happy Kirk decides to play it a often a he doe
Chad Worthman	I m happy Kirk is cool with taking that guitar on the road
gonzalo	me recuerda a Fear Factory Invisible Wounds se parece un poco al principio del
Esteban TroscÃ©	Obeeeeeeeyyyhhh
RodHammett95	6 56 7 13 Lars absolutely feeling it 3
Miguel Alejandria	James troll Hetfield
Drew Gibbs	Why doe James look like Ricky Gervais in the thumbnail is my question
Fluffy McFluffavic Meowski O'Fluffadopolus	â¤ï¸â¤ï¸â¤ï¸â¤ï¸â¤ï¸â¤ï¸â¤ï¸
Controle AcadÃªmico	Kirk nÃ£o consegue tocar o solo da mÃºsica kkkkkkkkkkkkkkkkkkkkkk
Gibrig Arkanu Gundala	Oct 22th 2018
T Timeler	Lmao James Messing with lars haha It really seems he enjoys playing these song more than he ha in a long time And he ha so much fun on stage more of a relaxed feel
Oilid	Gary Moore must be so proud of Kirk Hammett
VapingwithJan AndGoonther420	Happy anniversary lol
rocker4577	Stadium show suck
Pizza Sub	lmfao james with the drum stick save
David Naranjo	so many change in the tempo lars is getting really old
David Jarvis	Amazing show for my first Cant wait for Twickenham next year \m
Jeff C	Lars must ve been eating his Wheaties
Xylene	The solo on this song is so great
Mike D	Lars Kirk sound drunk lol last year when i saw them in Miami they all sounded great though metallica
Full Videos	3 25 Kirk finally practisedğŸ¤˜ğŸ»ğŸ¤˜ğŸ»
Cody Prickett	Cant fucking wait to see em in January
Zosia Szymczyk	Great
Joaquin Gea	METALLICAAAAA NOS VEMOS EN BARCELONAAAA
Bryan Thomas III	Just Awesomeness
joydreamwavercastles **********	Only one word wow at the drum kit It s purple with glitter like stuff Cool
Ronaldo Murphano	This song is the shit
Lucifer666	Vengan a Guaymas Sonora MÃ©xico para que toquen conmigo ğŸ˜‚claro sin Rober Trujillo jajaja
Andy M	Kirk s guitar is worth a million dollar incase anyone didn t know
mohamed bouhlel	OBEEEYYY 3
Alec Uys	I wonder what Lars tried to do with James at 8 42ğŸ˜‚ so awkward
Tammy Coates	Metallica and coffee for allâ˜•â˜•â˜•â˜•â˜•â˜•
Ronnie Smyth	6 54 that part of the song always give me chill Was insane seeing it live 3
Anounimous slash	Love this song Just wanted also wanted let comment people know to come sub to my boi Alex TV K he is doing a black ops 4 giveaway when he get 2 more sub
Noob Master	0 57 for it s permenantlyn t WHAT
VAIBHAV SINGH	8 41 made my day haha
Ğ’Ğ»Ğ°Ğ´Ğ¸Ğ¼Ğ¸Ñ€ Ğ¨Ğ¸Ğ¿ÑƒĞ½Ğ¾Ğ²	Ğ¡Ñ‚Ğ°Ñ€ÑŒÑ‘
Orhun Ates	8 42 wtf
cutesywootsey	So adorable these four men 3
ScorpionXII	Metallica s production crew really juiced up the quality of these video over the year I remember in the past you couldn t hear much base and Lars kick drum were inaudibe and Lars high hat were way too loud now all those issue are fixed
zack FURY	That intro wa lit
Luke's Channel	I wa here
Soulkeper1000	R I P mustage
Patrik Nessbo	Tbh James look better with the goatee but he look way cooler with the papastache
Orun Makarov	6 40 lol
Latner32	Uploading my favorite song AWESOME REEE
Dave Michael	Best performance for this song
Abimael Falaschi	Show â˜ ğŸ¤˜
Gagga Bylly	Holy autotune
ion po	Hetfield is out of tone
Marcia Paula	Amo rok
BruceScottKennedy	Solo is fucked up
Matt Wilson	James and Robert are the only good musician in Metallica these day kirk just winging it and lars constantly go out of time
Bartek Detrioux	8 59 I like when James interrupt Lars s cymbal muting them on purpose after a stick take This is really cute
Shallex	8 59
Death Wood	kirk soo bad guitarist
AndrÃ© LuÃ­s Alves Ferreira	Metallica vem pro Brasil Aguardamos vocÃªs
Ğ˜Ğ²Ğ¸Ñ†Ğ° ĞœĞ¸Ğ»Ğ¾ÑˆĞµĞ²Ğ¸Ñ›	Greath Greath Greath Metallica Greathings From Belgrade Serbia
El Judio Pijalarga	James always sings better
Noel Ndroid	Hell on fire
JBL	Kirk and Lars did a good job The bass can be heard and sound greatttt James is only getting better 3 52 4 02 How he held it In awe
Thomas VandaÃ«le	This bass sound 3
daras valadaras	COME TO ATHENS GREECE AND SOFIA BOULGARIA
Jose Antonio Molina	For fucking Christ FIX KIRK S GUITAR TONE ALREADY It just doesn t sound good and ruin thing like the intro to this song
Joshua Wynne	8 42 and 9 00 are why I love James and Lars
hide 59	Good Vocal
satamique	What a great performance
Nizar Odeh	Sounded like school band trying to cover Halo on fire plus is Kirk s guitar connected to Fuzz pedal at the beginning of the song pathetic
Hugh Jass	4 27 Yeah Yeah Yeah Oh I love James ğŸ˜‚ğŸ˜‚
puspa joshi	Love u mettalica band
Rendy Andrian	Does Kirk use greeny for this song
Brandy Kocincki	One of best song of HardWired
Ğ•Ğ²Ğ³ĞµĞ½Ğ¸Ğ¹ Ğ˜Ğ²Ğ°Ğ½Ğ¾Ğ²	cool ğŸ¤˜ğŸ¿
Augustin Tello	Me encanta
YaBoi Donkey	One more TikTok ad and i â€™ m Hardwired To Self Destruct
shurikeN	I wa there and it wa liiit ğŸ¤˜ğŸ»ğŸ’ªğŸ»
Lukas T	3 52 damn he really know how to control his voice nice smooth shift
Atheist Z	90 s James Obey Motherfucker
_Brodex_	Best birthday ever
FinPS	8 41 Hahahah
Andy Lopez	Whats up with Kirks sound O o
Dustin Hutchison	Death metal vocalist James hetfield at 3 52
bozz lp	Roberto Agustin Miguel SantÃ­ago samuel Trujilo Veracruz ğŸ˜€
pingÃ¼es beneficios	People who say metallica sold out are moron
T.B rjn	Metallica s new album come next year like if u knew
Estigma Peru	The 3 53 Obey wa awesome
Duhan Duman	Come to Turkey for god sake
Victor Ortega	Beautiful
DeniedHarbinger	Kirk really should use a V for this song He normally us a Les Paul for it but it tone doe not fit with the song itself IMHO at least
M Patrick 2	Sweet a ğŸ¯ â€œ â€ â€ â€ â€ â€ â€ â€ â€ â€ â€ â€ â€ â€ â€ â€ â€ â€ â€ â€ â€ â€ ğŸ
Jordy Manuel MartÃ­nez Guerrero	Jajaja 8 43
Jonalyn Ann Bandol	MetInMNL MetInManila MetInPH MetInPhilippines Pls
rejean comeau 77	Whoooooh Ooooooh ooh ooooooooooooh
Mohamad Akra	3 45 Devilish OBEY ğŸ¤˜ğŸ¤˜ğŸ¤˜ğŸ¤˜
Juan Rezende	6 55 Yeah Rob Come on
Lucas Mackenzie	Excelente performance Filmagem perfeita ğŸ‘ğŸ»ğŸ‘ğŸ»ğŸ‘ğŸ»
ĞĞ»ĞµÑ…Ğ°Ğ½ Ğ›Ğ¾Ğ¼Ñ‚Ğ°Ğ´Ğ·Ñ	Ğ¥ÑĞ²Ğ¸ ĞœĞµÑ‚Ğ°Ğ»Ğ» Ğ´Ñ€ÑƒĞ·ÑŒÑ Ğ²ÑĞµĞ¼ Ğ¿Ñ€Ğ¸Ğ²ĞµÑ‚ Ñ ĞšĞ°Ğ·Ğ°Ñ…ÑÑ‚Ğ°Ğ½Ğ°
Criss Metal	Hello Darkness say godbyeâ¤ï¸ğŸ”¥ğŸ¸ğŸ˜
ChildOfBodom666	fuck yeah this song is amazing
Junior Hanneman	Essa intro macabra deveria ter sido inclusa na versÃ£o de estÃºdio Halo Ã© a melhor faixa do album
jimbo chimbo	It is cool when rob always like to stand in front of lars and jam together
DEEMAN22100	3 52 I will never get sick of hearing that OBEY
Yael Gabay	I cant belive that pas one year since i been in my first metallica s contract thank u about a great memory ğŸ˜ğŸ˜
XenoPrym	Please do the OBEYYYYY thing on next album thanks james
karim sayed	A
Alejandro Lugo	Incredible how much James ha aged in one year
Ivan Ramirez	2 in the morning Been up all night listening to metallica
ElÃ­as B.	I love the slow intro 3
Ğ¢Ğ¸Ğ¼ÑƒÑ€ ĞœĞ¸Ğ·Ğ±Ğ°Ñ…Ğ¾Ğ²	Ğ’Ñ‹ Ñ‡Ğµ Ğ¼Ğ¾Ğ½ĞµÑ‚Ğ¸Ğ·Ğ°Ñ†Ğ¸Ñ Ğ½Ğ° ĞºĞ°Ğ½Ğ°Ğ»Ğµ Ğ²ĞºĞ»ÑÑ‡Ğ¸Ğ»Ğ¸
Yosra Haj Abid	ğŸ”¥ğŸ”¥ğŸ”¥ğŸ”¥ğŸ”¥ğŸ”¥
sreyas syam	James Hetfield is Chuck Norris â€™ daddy
Mauricio's P.	Aguante MetallicA
Franco Pereyra	The best solo of the album
LE wheels	Where the notif squad at
virotes tv	Wooowâ™¥ï¸â™¥ï¸â™¥ï¸
Manuel Becerra Ramirez	I love Metallica ğŸ’—ğŸ˜
Mendoza 616	DÃ©cimo comentario zdxd
Japili Axey	GDAMN
AD GR	How cool is Lars here That duo with James is really something unique and really big So big maybe that get the other member aside in the Metallica thing and decision Lastly those who underestimate Lars because they don t dig so much his character while it doesn t happen with James I have to say that James wouldn t have all these point in our heart and respect without Lars It s just the truth nothing more
Andrew B.	8 42 D
Hamad Taher	OBEY
MARIA KARENINA	OMG I m SO IN LOVE with this song Stunning LIVE
Mayo Neza	What a sound
adviser	Where are you guy Russia waiting for you
Dejan IljeÅ¡	7th
