Alexander Taylor	This announcer ha got to go
Zsa Tenorio	Jones jr dunk so awesome
Walang Magawa	Rondo punch should be no1
Joshua Strauss	I stopped paying attention to the highlight halfway through and just started listening to the goatmentator â€™ s fire
Young Stunna	Everyone want to be chris smoove like a bos ğŸ¤«
Geremy Rosario	They need a new voice for this I m sorry
JokerGuts	Are we just gon na ignore this man perfect flow
Pogi Kho	edjonmrak1999 24
Levi Johnson	Much better commentary
Giovanni Soranzo	love this voice who is this guy
J Haggerty	How did CJ â€™ s bucket not make the list
adrian strozier	I like how it showed no Raptors highlight oh well I guess we won so they can have the highlight Highlights don t win game
Trevor Rattling Leaf	Missed this
Matus	if my ma D rose wa flopping bitch like 90 of the league that no 3 would be charge
Lee Watanabe	Kelly Oubre â€™ s stare down wa gay a aid
ante ante	And still washington loses to my raptor
outoftime	gaymentator
Nedim Talovic	Hey dear loved NBA people For I delivered to you a of first importance what I also received that Christ died for our sin in accordance with the scripture that he wa buried that he wa raised on the third day in accordance with the scripture 1 Corinthians 15 3 4 Because if you confess with your mouth that Jesus is Lord and believe in your heart that God raised him from the dead you will be saved Romans 10 9
Pulse Livid	On the nba dot com Tahten
Francisco Viper DÃ­az	Number 1 slam
DefaultyChairman	DAMN
Mi-khael Quires	The GOAT will surely be in the Hall Of Fame one day
8040	NBA DOT COMMMMMMMMMMMMMMMMM TAHTE
Anthony Okeiyi	No LeBron on number 1 is this a fake video
Gregg Mirabueno	Shaking up Patty Mills like a fresh can of orange juice before getting loose Man Have you heard of this before GOATmentator
Veronn Oliveira	Song
six Houston	ğŸ‘²ğŸ½çœ‹ç¾å¥³éœ²ç‚¹ç§ğŸˆ²ï¸è§†é¢‘â•å¾®ä¿¡girL6393ğŸ§ ğŸ§ æ–¹æ³•è®©ä»–è´Ÿæ‹…çš„æé«˜u y
Ayazgul Temirova	NBA
Lufox 01	Love how he speaks
Martin Beezy Videos	I heard GOATMENTATOR doesn â€™ t write his own lyric ğŸ‘€
Jojo Viray	Yall know it the goatmentator when you see the like and dislike
Kevin Jackson	Look at fucking Kelly Oubre Jr What a fucking scrub Stares down Siakam for simple put back dunk after doing absolutely nothing this entire game Oh and what doe he do the next possession He give up a wide open three What a clown As long a Oubre Jr continues to be an immature scrub and stay on the Wizards the wizard will never amount to jack shit
nahum cheer	1 nasty
FM Wolf	Ohhh that s Kelly Oubre Stare thou Hanmered it down Yeahhhh
WhatWazDat YT	Where is Brian Scalabrines 360 fade away game winner poster on shaq
Johnny Shami	Jones Jr better join the NBA slam dunk competition this year Boy s got hop
StarkBR Games	yes http www youtube com watch v vci4yJpK2H4 t 3
Based God	The NBA Where overkill suspension happen
Edwin Ramos	The most annoying voice after the angriest black man in sport he know everyone personally Stephen A Smith
James Heymans	1 53 dennis smith jr pushed off derrick rose it shouldve been an offensive foul
Jefferson Hayward	A good week of NBA
Fred Fancy	Where is Derrick Roses reverse layup
Domen Zebec	Where is Doncic Dallas 25 point and nothing to show
rip jaws1738	1 11 to bad he couldn t do it in the postseason
Joshal Ouseph	Is it just me or doe Patty Mills look like J Cole
LeHenryCotton	If one of you guy could check out my Drose MVP mix and drop a like it d mean the world to me
Gilberto	Is this Kyle Montgomery I think this is GOATmentator
TTV_ Storm	Lol when JJ made that three the time ha his number 17
fjjdghrfigj	When there more shooting high light than dunk pretty crazy
A	Ingram had a nice shot
peaceroolz	Greg Monroe â€™ s reaction from the bench on the Kelly Oubre jam ğŸ˜‚ğŸ˜‚ğŸ˜‚
Oso	Fresh can of Orange Juice HA that one got me
OatsnHoney	I love lillard but CJ had a better crossover
David Himelfarb	what a fucking snub Vanvleets disgusting fading falling dagger on the Wiz smdh
Gu Xiaomeng	obure is hot
Malachi Washington	That commentator tho ğŸ˜‚ğŸ˜‚
Flow TV	Where is D rose
SFterps	Dennis Smith jr did the definition of a push off foul ahah poor Rose that â€™ s some bullshit Rose had a good game
Ernest Yanez	Rondo spitting on CP3 should be top play
Brad Lamb	Fire this guy
Iceman33	Drummond block on Bobby Portis is not here
danny youkhan	These highlight were trash
Articted	Deandre s block
Owen Burtt	Cg s stepback
Amadou Ndiaye	They need Chris Smoove on one of these
Alan KS	DJJ s dunk is worthy for a slow mo He wa so above the rim
Jonah Herschko	Who got a 2K19 ad
Christopher Emmons	Why isnt the duel on here
DeRozan MVP	vanvleet s clutch shot
The Finnisher	Dennis Smith Jr pushed off harder than I pushed my brother off a cliff
crazymonk3y1298	Jt kobe fader should have made it
Dusan Zec	You could have put jokic in here
Sai GANESH R	You got so many clutch shot today and we see 3 play from rocket Lakers and not even one of them is a punch pretty bad list
Geo Sal	Cool highlight change the annoying commentator
Artemus Ogletree	OFFENSIVE FOUL ON SMITH JR
R619ification2011	Announcer got bar tho
EzzaB	http youtu be 7obVI5ikUgQ
Joe Galligan	Oubre â€™ s putback wa nasty but I keep rewatching Greg Monroe lose his mind on the bench before remembering he â€™ s on the other team ğŸ˜‚
Warriors Inseven	First
jeremy brydges	I thought the vanvleet game winner would have made it The fact it didn t tell you how crazy the start of the season ha been
Regie balasbas	jonesJR IS floating in the wowwww
SPORTS KOPP	damn the half court shot by terrence floss 1 19
bubasmys	02 13 what a fucking disgrace You did good so get your filthy as to the defence line instead of taunting the opponent
TheMajinV	Van Vleet s off balance jumper nowhere to be found Pretty weak
rowdy brewer	The man push drose lmao
Tomas Keveza	fuccccck i missed goatmentator and the top play it gon na be a good year
Tyrone Cunningham	This dude is the best announcer bar none NBA never let him go HeatNation
Tug Wree	No raptor with all the good play they been having
Bipan Maharjan	Those dislike are for the commentary
camp Gemini	Mcgee s improving every game Still can t believe gsw let him go for cousin
Toxic Gd	This commentator reminds me of dr Lupo during the summer skirmish
Jaime Gonzalez	The guy talking wtf can we get someone different guy is annoying
JWill79	Ish should be top 5 this list is fucked
Weizenmehlund Zucker	76 disslikes next time another commenary 20000 disslikes Grow ups motherfucker
Chris. A King	2 is wack and lucky roll you stupid for that one
tranlanga mingo	Jones JR need to win the dunk contest
Sodgerel Enkhtur	Fuck this announcer
henry manahan	Push off Drose played the better game
ar che	Damn had to mute sound this commentator rhyme is tragic
wweecwwcwtnanba1928	The fight from the LA and Houston game should be number 1
Eric Brunton	RAPS get no Love despite the fact they won How the hell is FVV s off balance shot that iced the game not make it into this or OG s fake out 3
Super Fleymez	Ish smith and tatum clutch fadeaway definitely deserve a spot
SplashStar	best top 10 in a while
The Big Ticket	Jason Tatum should be number one â€¼ï¸
Aleksei Vladimirovich	Hot top
KDIV	This commentator need a raise
Sean	Much better when he repeat on to No only three time Try to reduce it to just once or twice plz
A1 Slaps	at 2 is blue face babyyyy onna dead locs
Fatima AL-Enizi	Why are the Miami seat always so empty
fruizm	GOATmentator went hard on this one
Lorenshyne	Derrick Jones is on a different planet then the others im disgusted that him and KJ McDaniels are always being traded
Thang Cin	Stfu with them commentary
Mac Bowie	Derek Jones jus made me load up 2k19 Sheeees ğŸ•µï¸2 19
Earl Francis	Ingram s right cross should be 1
santanaoutlaw	Harden 1
brooklyn savo	How you got all the Lakers and rocket highlight but don â€™ t have cp3 2 piece and sprite no ice ğŸ˜‚ğŸ˜‚
TwisterUpThere	Number one insane
Random Person	0 54 u can see harden check his nose if it bleeding again
Nader Hawchar	is it me or is the commentator annoying
Mouhamed 99	DSJ is a snake he pushed D rose
George Anto	Derrick jones jr is like the cheat in 2k when you put a 99 vert and a posterizer budge on a player
Joshua Manarin	Goatmentator
Duane Shadd	No D Rose highlight oh well
Israel Rojas	The rhyming can get a bit annoying tbh
Rawr5649	fire that narrator please
J.R. W	Never had a can of orange juice
surajsuresh9	D Rose in his prime had a similar step back game winner on Brandon Jennings circle of life
True Smith	Ross is no longer a bos Not even employee of the month
Yudi Peralta	Lakers go go
El Michelle	Oubre s Lethal Staredown
Wizzard Mane	So no Kemba Walker buzzer beater ğŸ˜’ on a night where he break the 10 000 scoring list This page show the Hornets no love bruh wtf
Bob Plank	Announcer terrible
RadRock	Where is victor oladipo when he wa all alone and dunked
Gunkfunkulous Munktrunkulous	If James Harden loses the final he should shave his beard agree or disagree
Warriors Fan Since July 2, 2018	Where s Rondo s straight left
Trent Kinsey	JJ out here turning back the clock
Silas K	Where s Tatum s Fadaway
St Pariah	This commentator is garbage
Brian Scalabrine	3 wa an enourmous pushoff
Peter Clark	Well deserved no 1 this time That kid got such incredible bounce
TarÄ±k Eren DoÄŸan	Someone kill this fuckin idiot
Joel MartÃ­n DomÃ­nguez ValdÃ©s	Kelly Oubre will dunk on you and get your bitch wet all in the same play
The Real D	2 14 that face D
AvEryBadApPLe	Ok who didn â€™ t skip the gordon hayward commercial
Ğ¤ĞµĞ´Ğ¾Ñ€ ĞšĞ¾Ğ½ÑÑ‚Ğ°Ğ½Ñ‚Ğ¸Ğ½Ğ¾Ğ²	what he say in the end of videoï¼Ÿ
Evan Duffy	There are about a million better play than number 10 like where is embiids Euro Other than that great top 10
JoyBox Trickster	Why wa Oubre staring like he wa sick lmao the Raptors handed them the 1st round exit L and they lost the game when KAWHI WAS OUT
_T LH_	Flop MVP James Harden
m hazey	1 wa crazy ğŸ˜¯
Knick Johnson	maxi kleber had a huge chasedown block but we all know nba dickrides lebron and his open dunk
ridikrossbitch	Lebrons no look wa good a well But yo this year is gon na be lit
Todd Hood	Where s Jayson Tatum s clutch
Jorgeous A	Those MF doesnt knw how to play ball
jowblaze30	you kidding me 5 4 3 should be 3 2 1 in the order lmao some average dunk better than clutch game winner
Paruhang Angdembe	Now what up with this assmentator
blastoi5e	SAVE THE GOAT FOR THE WEEKEND LETS GO GOAT
UKFxVanDread	Wait a minute You put Beals 3 point history shot but you didn t even mention Nikola Jokics historical 100 shooting performance with 35 point and a triple double game You must be kidding me Was it because the goatmentator can t find any rhyme for him I don t understand at all
Joel Parsons	Wesley Matthews jump into Teague and shove him No Foul Dennis Smith Jr push off on D Rose No Foul ğŸ˜‘
Oynot Po	No D Rose ğŸ˜¢ğŸ˜­
Alan Azur	goatmentator thanks u need to fire cringmentator
ì½”ì•Œë¼	number 3 play is obviously offens foul lol
Clayton Ives	Brandon Ingram come flying in saying What you mean you don t like my girly hair Here Bitch Slap Slap Slap Should be number 1
Pengcheng Luo	I love the ending
Salvador Emilio ArtÃ© Kuret	Where s CP uppercut
Vangidism C	GOATMENTATOR
David Marin	wow you guy left out luka putting Wiggins on skate
JustaBoy93 Heheh	Oubre save the play today okay can t you say ooshkahtay ğŸ˜‚ğŸ˜‚ğŸ˜‚
SAM 30	Look at the reaction of Greg Monroe 2 08
AIC1	bro why do other guy do that top 10 this one ha the most relevant voice for it
deon yang	cmon let s be real cp3 rondo fight should be no 1 punch thrown punch landed how often do we get that in the nba anymore
Imher Palaad	Oftentimes i just wan na hear his rhyme scheme Damn ğŸ”¥ goatestmentator
hamble	the king is back
thiam XuaN	2 08 to 2 11 look at the Raptor s bench reaction lul
Hamit aydÄ±n	Look at monroe s reaction Number 2
IamRafael	Wheres the vintage Rose at
Oyasumi Mirai	Talo naman lakers
TheZare96	Doncic Jokic
Czebastian Aqi Mayor	Goatmentator at it awesomeness
Mayo Hu	Man it s so nasty
Soundless	GOATMENTATOR need to go
Roland DuSon	I can t believe how bad this is Plus he get paid
Shaun Mcdowell	Damn rap and Celtics won yet no highlight for themğŸ˜´
Bacon sauce	nba com TOPTEN
Paffciu	Oh man Derrick Jones Jr O
JayVon Davis	Damn Derrick Jones Jr that vert and hangtime wa Vince Carter like my goodness
Ggr Aiace	Where is the Ish Smith game winning basket This top 10 suck ğŸ˜ ğŸ˜ ğŸ˜ ğŸ˜ ğŸ˜ ğŸ˜ ğŸ˜ 
Connman103	Bruhhhh cj had him leanin thooo
HA? DOG	Spiting on someone â€™ s face should be 1 also coming in with a left punch
grunermrk	Fred VanVleet crazy messed up inbounds shot should be on here
c137	fuck yes goatmentator
Daniel Johnston	GOATMENTATOR
Jacob Basilio	That look from kelly looked like he bout to rape someone
B. Astaire	2 08 2 12 Monroe tho xdddd
BALCK WOLF	Don t like the commentary
Barron Blade	where is j smooth
Good ass content	Nice defence lbj
bruce lau	GOATMentator TERRENCE ROSS like a bos
merc doob	1 Chris Paul v Rajon Rondo
Bryant Bee	Why cant you breathe on an offensive player a a defender but the ref allow the off hand push offs for separation by offensive player it an offensive foul but unless somebody fall into the 5th row they rarely if ever call it not fair to the defender dennis lol
Luc Wijngaard	Dennis Smith Jr show his clutchness
Doyoan	Wow
PAANO MO NASABE	DAMING KUPAL NA NAGCOCOMENT KAYU NLANG MAG LEBRON
Felix Nyabuto	a simple three shouldn t be at number 10
HikoSeijuroXIII	1 and 2 should have been Rondo s one two
Tobbles	Even the Toronto bench wa shocked 2 11 xd
Cole Fairbanks	LeBron not number one is a suprise lol Usually a LeBron layup will be number one over anything lol
David Jackson Jr.	Kuzma Slam It Down Baby Lakers
Pen Wednesday	Hahahaha oubre stared down siakam lmfao
VASTOR	Coming in at number 3 we see Dennis end this with the ridiculous offensive foul on the former MVP
Eliyah Thurman	The Shot Dennis Smith hit wa no doubt tough but it wa a bad shot selection and let â€™ s be honest he pushed off good defense by DRose and in my opinion a a ref you got to let this play be a no call or an offensive foul for the extension of the right forearm instead of bailing DSJ out with the foul because then if he would â€™ ve missed the shot that â€™ s still potential 2 point in a really close game ğŸ˜ª
lester honori	this goat i got chill on those bar
Alternate	Derrick Airplane Mode Jones Jr 2019 slam dunk champion already
Jose Munoz	Were is CP3s two piece on rondo ğŸ˜‚ğŸ’ªğŸ½
Gautam Sivakumar	Are we just gon na ignore CJ McCollum â€™ s anklebreaker
Samo KetiÅ¡	on nba dot coooooomm top 10
Josh Sinister	xxxtentacion can fly and those killer staredown lol
Josh Ecle	This is the best top 10 so far
CB MIXTAPES	I wonder who started goatmentator
Jordan A	Greg Monroe reaction to Kelly Oubre dunk ğŸ¤£
COLLECTIVE MINDS SQUARED	Like SUBSCRIBE I ll do the same One love
Pcorf Creations	GOATMENTATOR WITH THE SOUTH POLE SPIKE
vtecsux__	Ingram and rondo hit on cp3 should be 2 1 respectively
Chase Hilyer	Holy shit dude that DJJ dunk wa unbelievable
molodoy x young	Kelly do it so swaggy
Golden Surfer	Best Top 10 in a while NBA time goatmentator
Benjamin Pittman	1 04 who drink can of orange juice jw
KiddKlutch3420	Jayson tatum turnaround fade away
Malik Shuler	Lmao Raptors about to trade Greg Monroe for cheering for the other team
TC ENT	Rondo â€™ s jab should be 1
ASU PE	Why not Hadrden No 1
JustinR20	Jokic GOAT
ToysofArkham	Rondo â€™ s left hand finish should be number 1
James Yam-id	Brandon Ingram half court punch should be 1 tho
Ced Cuddi	Defense is so trash in today â€™ s nba u can â€™ t even hand check or even lay a finger on someone hand or it â€™ ll be a foul smh I â€™ m really hating the ref for calling it too hopefully it get better
Rafael Rodriguez	Hit the thumb up in le than a second at the moment i hear that voice
Frank Seal	JJ make the trey that decides the day this is why we love him
Dex Roman	Damn not every top comment is about the commentator for once
Zee S	Bars
John Paulo	Cp3 bout to go to the secret tunnel again
CaliCoins 28	First of all the narrator of this top 10 is the real MVP Other dude corny a hell lol
c j	Number one dunk will be top ten play of the year
yunix collin	Where s jokic perfect triple double
Labiang Jonathan	goatmentator ha too much bar ğŸ”¥
Å½ak Votren	Shaking up Patty Mills like a fresh can of orange juice aaaaand he is baaaaaaackkkk
Ethan Eardley	CJ crossed up Forbes
Reverse Prince	So I guess the pacer didn t play at all
Lee rea Kim	Still waiting for Chris Smoove s Lakers Rockets video
YHG	ğŸğŸğŸmentator
#EyesDontLie Chosen 1	Great game night
The GOAT	DSJ â€™ s Shot wa a pushoff
Hoodie Luke	Celtics ain â€™ t looking too good
Robert Williams Iv	They should have Chris smoove do these
B Killa	Im a simple man I hear Goatmentator I like
T-RX	That carmelo tough defense tho
TheZeroultra	Houston win the game ğŸš€ğŸš€ğŸš€ Gtfo salty Lakers fan Ingram and Rondo going to be ejected for some game now and that will make the Lakers keep loosing game ğŸ˜‚
Trudio Eldiablo	No 0 rondo with the left jab
Jordan M	derrick Jones always find a way to make the highlight reelğŸ’€
å“ˆå“ˆå“ˆå¤§ç‚®ä¸å“‘ç«	Can someone tell me what wa the last word please Tata
monearthe$	Drose get pushed off for game winner and it s in this top 10 ğŸ˜‚ wtf Y all ref wylin fr
Victor Carrasco	Knicks fan still think Frank better and ATL fan think they won the trade Mavs stealing from plummeting franchise
King	Guys check out my latest prank http www youtube com watch v LiQ9HAoqt5c feature youtu be
Ronel Leabres	Damian Lillard shaking up patty mill like a fresh can of Orange juice before letting loose on a Smoooooth little J to get number Six play DAMN THOSE LINES BITCH
Random Comment	where s CP s eye jab and right hook combo
Talent 3Point0	So we gon act like Dennis Smith Jr didn t push off
Adrian Michael Palma	Still Rose ain t joking ğŸ”¥
Chinnapol Ngarmjit	best commentator
Kang Kayan	ğŸ”´ Live NFL here ğŸ‘‰ ã€Š fox sport stream football ã€‹
DamianMaurice Leyy	the goat is baaaaack
comgamer 1	Push off by DSJ
Lavi Deep	fred s clutch and one
darkkanishi	Smith s shove d rose arguably an offensive foul
b3rtski	Drop a mixtape
Shiva the Destroyer	Goatmentator should drop a mixtape hell soon
Kron Pineda	Goatmentator got bar for day
Karen Smbatyan	Im from Armenia and I loooovvveeee NBA
TaA Star	Ish Smith game winner instead of Beal s 3
Quinn Mark	G O A TğŸ˜‚ğŸ˜‚â˜ºï¸
Savage Trey	John Wall and Kelly Oubre â€™ s HandshakeğŸ”¥
lowlw gaming	Wow no celtic highlight Wheres Tatums kobe fade away
Jermaine John	Imagine LeBron choosing to go to L A instead of Philly or stay in Cleveland Oh wait ğŸ˜‚ğŸ˜‚ğŸ˜‚
Jason Martyn	Thanks for GOATMENTATOR
LBJ 23	ãŠã¯ã‚ˆã†ã”ã–ã„ã¾ã™
Same_still	1 cp3 Vs rondo
Reventando CosasToGuapas	First
Miguel Mendoza	Where â€™ s Ingram â€™ s falcon punch on Chris Paul
Justin Y.	Rondo swinging on CP3 should ve been a highlight
Matias Koivuranta	Where the Rondo Rouseys left hook at
Stephen A Smith	Rondo punch on CP3 should be number one
Wojciech Plonski	First
BD Gaming	luv this game
