Datchayani MOUNIEN	Excellent work Every Sk brother sister proud to own him I m one among them SK follower showering love with wonderful art poem helping for social activity Always pleasure to watch all We admire him for his great value self discipled life simplicity core hardworker positive mind good hearted nature No hurddles can stop him May the hater ego jealous people raise against him but his growth can t be avoided or stopped His hater are not matured willing to accept his success Endrum Sk namadhu manadhil SEEMA RAJA dhan Intha patathai yarum etuka mudiyathu Muyarchi Munnertrum Mudhulitam ğŸ‘ğŸ‘ğŸ‘
Hafizah Thajudeen	Wow soooooooooo cute
sk hearts productions	Endha app le edit panninge bro supera irukku
Thalapathy Vijay fans	Masss
Harrish Chandra	supeeerrrrr sk
Muruges Waran	Brother unmailayeee sema super
Dennison Samuel	super na
Madhu Kishore	Semma ji video En uyir sivakarthikeyan ğŸ˜â¤
PADMA SHREE	A perfectğŸ‘edit to Sk anna sema massğŸ”¥Hardwork is a success of Sk anna i proudâ˜to say Sk anna fan he is inspiration for me
EMMANUEL JOHN	ğŸ‘Œ
Dubsmash world TAMIL	Masss edit anna super
logesh logesh	Semma mass ğŸ˜˜ sk
SK Pooja	A perfect editğŸ‘ğŸ‘ğŸ‘simply awesomeğŸ‘ŒğŸ‘Œproud skianğŸ’ª
Mersal Siva	Vera level â¤â¤ğŸ˜ğŸ˜
vp 1999	Selva bro Arumai
JoY FilM FactorY	Super
Girish manikandan	Super bro semma edit sk Anna my inspiration
JAHIR HUSSAIN	Awesome
praveen _pk _prince	Mass edit wow
Js Creation	Goosebumps Thalaivar hard work pakumpothu
PrinceSk Online SkFc	Thalaivanâ¤â¤
siva s	Super bro
Vinothcandy Vinothcandy	Sk Anna great ğŸ‘ŒğŸ‘ŒğŸ‘Œ
Gunasekaran Sivakarthikeyan Blood	Thalaivar video va paakum pothu mattum than Odambu Silurkuthu bcoz of his hardworkğŸ˜˜ Thalaivaaaa U r Teacher of u ğŸ˜˜ğŸ˜˜
R.Harish kumar	semma video mass panugaa troll star team keep rocking all d best gu
senthamizh selvan	Semma
Sai Krish	Fanstastic edit broğŸ”¥ğŸ˜ From 1 30 goosebump emotionally
Mg Vicky	Yeah Engaya pudichinga intha video Creator ra Semaya pandringa ya ellarum All The Very Best To Your Each And Everyone In TrollStarz TeamğŸ˜Šâ¤ğŸ˜ğŸ™ğŸ”¥
Harish Loveable	Superb Selva Goosebumps ğŸ‘ŒğŸ‘ŒğŸ˜
TIRUPUR SKIANS	Super Bro
RANDOM VIDEOS	01 33 02 06 ğŸ’—â¤ï¸ Only few have gut to say this I am not an extraordinary actor Thalaiva nee vaa ounaku nanga errukom ğŸ˜
Shakti Nattar	Verithanam overloadedğŸ”¥âœŒï¸
muthu kailash	Entire samaniya makkal prideğŸ’ªğŸ‘ğŸ‘ŒSiva Anna
Arun Siva77	Verithanam ğŸ˜â¤ï¸
Thani oruvan hari	ğŸ™ ğŸ™á´›Êœá´€ÊŸá´€Éªá´ á´€
