Chaze Rivera	NCT cheering for NCTZens is the most precious thing ever ğŸ’šğŸ’šğŸ’š Grasses we so luckyyyy ğŸ€
ReRe EXO	Ø§Ø·ÙØ§Ù„ÙŠ ğŸ˜­ğŸ’šğŸ’šğŸ’šğŸ’šğŸ’šğŸ’š
pearlpower17	the look on their face really say it all
Riee Chan	Before Dreamies v BTS and finally dreamies got 2nd place but they are still happy Congratulations boy ğŸ’•ğŸ’•ğŸ’•ğŸ’•ğŸ’•ğŸ’•ğŸ’•ğŸ’•ğŸ’•
Vanessa Alba	I didn â€™ t understand anything but I could just tell that wa a good explanation
Pinkrevenge101	The first thing they sing for the encore â€œ I â€™ VE BEEN BANGIN WITH MY TEAM â€ Jaehyun did THAT Iconic win on yutas bday never forget
RoseSmith11	This make me so emotional
Quyen Pham	0 33 0 40 Junguwu really wanted to cry Some one give him his shoulder so he can cry They must be tall like Lucas LOL cause Uwu is 1m80 ğŸ˜‚ğŸ˜‚ğŸ˜‚ğŸ˜‚ğŸ˜‚
Vaisravana Prajnadhira Ahimsa	boa looking enormously proud her baby brother are having their moment
Multi-fandom Enthusiast	Boa wa hyping them so much omg Sm baby
clara lanica	They are so cute hot and handsome in same timeğŸ˜ğŸ˜¶
Sevin Kurniasari	I Love them NCT ğŸ’šğŸ’šğŸ’šğŸ’šğŸ’šğŸ˜ğŸ˜ğŸ˜—ğŸ˜—ğŸ˜—
Sora K12	ğŸ’šğŸ‘
YT 127	NCT127ğŸ’•FIGHTNGâœŠ
Ayu Agustini Uzerli	Taeyong best leader ğŸ‘ğŸ»
Lzenìœ ì¬ì¬	Yuta s Braaahâ¤
Xing Xing	ğŸ’šğŸ†ğŸ‰ğŸ’š
uwunim	My baby ğŸ˜­ğŸ˜­ğŸ˜­
Indira Sari	Uwuuuuuuu
Farin Rahman	They really love u so much ğŸ˜­ğŸ’š
farihah eha	K nctzen are so luckyğŸ˜­ğŸ˜­
Pichaya Srisuwan	congrats you guy really deserve it Seeing you happy and smile is one of my fav moment keep practicing trying showing talent and you have my word i will keep loving you NCT
indira parcial	is this thier 3rd or 4th win
I am super ultra mega alpha bored rn	My man Sicheng barely doing anything because of the lack of his line I think I m boutta bust a nutâ€”
Andrea Garcia	Me dieron unas ganas horribles de llorar c
Irene's Tunes	WinWin is really out here SNATCHING THUMBNAILS â¤ï¸â¤ï¸â¤ï¸
yunoh's girl	i love how they re not cry or at least tried not to but you can feel how thankful and happy they are it s so fulfilling
nabilahsalman	When you guy happy I â€™ m happy too
Victoria Angeline YÃ©pez ProaÃ±o	So proudğŸ’šğŸ’šğŸ’šğŸ‘ğŸ‘ğŸ‘ğŸ˜¢ğŸ˜¢ğŸ˜¢ğŸ˜­ğŸ˜­ğŸ˜­ğŸ¤§ğŸ¤§ğŸ¤§ğŸ¤§ğŸ’šğŸ’šğŸ’šğŸ’šğŸŒ±ğŸŒ±ğŸŒ±
Young Nguyen	ì¶”ê°€í•´ â¤ï¸â¤ï¸
A J	jungwoo look so uwu
Ayu Putri	ğŸ˜ğŸ˜ğŸ˜ğŸ˜ğŸ˜
ë¯¸ ë¯¸	ã‚¸ãƒ§ãƒ³ã‚¦ğŸ’ğŸ’ğŸ’ğŸ’
Beautiful Maknae Chou Tzuyu	WHy iS nOboDy taLKiNg abOut WinWIn The thumbnail is SHININGâœ¨ğŸ¤©ğŸ˜
Mae B	1 05 a happy BBRRRAAA lol
Chimieee Park	1 14 that wink tho dy YUTAAAA
kimkey1991	Taeyong and Boa hug twice
Dara Nadine	The thumbnail is my life ğŸ’œ
NCT nians	2 35 they were chanting NCTzen NCTzen I m about to cry I m so happy that I m part of this fandomğŸ˜­ğŸ’šğŸŒ±
iHearteu BTS	The way taeyong hug jaehyun ah so soft UwU 0 24
Hani x	jungwoo bby â¤
Kiplen	Yuta is so handsome bruh wtf ğŸ˜ğŸ˜ğŸ˜©ğŸ˜©ğŸ˜©ğŸ˜©â¤ï¸â¤ï¸â¤ï¸
Prdsdef.taeil	Our sensitive Taeyong â¤ï¸
1026æ‚ 	æ‚ å¤ªã®ãŠèª•ç”Ÿæ—¥ã¨ï¼‘ä½ã®ãŠç¥ã„æœ€é«˜éãã¾ã™ğŸ’•ãŠã‚ã§ã¨ã†ğŸ‰ã“ã‚Œã‹ã‚‰ã‚‚å¿œæ´ã—ã¦ã„ãã¾ã™
Anne ELF	Kings
karla seasonie orbit	Congrats to our baby
It's Personal	Yuta stop ğŸ˜
Iman Ahmed	YAAAS THEY DESERVE EVERYTHINGâ¤ï¸â¤ï¸ğŸ˜­
Kate CÃ³rdova	Thanks for uploading this video ğŸ˜ğŸ˜ğŸ˜ğŸ’šğŸ˜­
Ethar Alwattar	PERFECT THUMBNAIL BTW
Adoring Kookie97	2 01 the love of my life â¤ï¸â¤ï¸
Venus Ofiana	i m so happy for my boy
H. B.	THE BEST THING I SAW TODAY
Hesti Utami	Really congratulation NCT127ğŸ’ğŸ˜
Maria Fernanda	Johnny is so sweet he went to Jungwoo to pull him closer
Liberated Rapunzel	BoA representing NCTZens reaction V at least mine Little big dude you deserve the world and you will have it D
Yarely Rojas	YASSS MY BOYS ARE THE BIGGEST HIT
AB Shii	I love how genuinely happy they re ğŸ’šğŸ’š
Xuxi King	You guy deserve it ğŸ˜ğŸ’š
Marion Elise Brillantes	So happy to see them happy ğŸ’šğŸ’šğŸ’šğŸ’š
â€¢ exoluar â€¢	ìˆ˜ê³ í–ˆì–´ìš”ğŸ’šğŸ˜­ i proud of you so much ğŸ’šğŸ’šğŸ’šğŸ’š
xuan haha	They all looked so overwhelmed and their eye are all watery These boy really deserve the world
WINCTAE	0 32 0 39 Baby Junguwu ğŸ˜­ğŸ˜­
VÃ¢n Anh Nguyá»…n	OMG Taeyong
ELF *NCTZEN	JAEYONG ğŸ’š
darl ing	Thank you for uploading this precious moment for u who didnt got the chance to see their encore stage Congrats NCT127 You deserved it You ve been working hard Were so happy for you guysğŸ’šğŸ’šğŸ’š
Breen	ğŸ˜­ğŸ˜­I love them so muchğŸ’šğŸ’šğŸ’š
Tannya Aditya	THAT LOOK OF DISBELIEF IN JUNGWOOS FACE 0 55 YES BABY YOU WON ğŸ˜­
Vie Vie	I love them all
park SLAYoung aka JOYsus	Mama BoA is proud âœ¨
Saniscara Yasmin Izdihar S	Taeyong uljima You guy deserved it Uljimaa ğŸ˜­ğŸ˜­ğŸ˜­ğŸ˜­
Shimx Zap	ğŸ’šğŸ’šğŸ’š
Itsyuri yow	wow thank uuuu
Elli	i m so happyğŸ˜­ğŸ˜­ğŸ˜­ğŸ™ğŸ™ğŸ™
jie anis	boa being hyper at the back is the best thing ever
Teddy Allfiss	Precious moment ğŸ’˜ğŸ’˜
Rh. Official	ğŸ’ğŸ’ğŸ’ğŸ’ğŸ’ğŸ’
Febrina AB	I ve been stanning this group for these passed 4 month and a a kpop fan I can say it s one of the best decision I made after being an Eris for 6 year lol So proud of my baby boy Keep going higher you guy ğŸ’š
Shou Ryn	Haechan sing live perfect â¤â¤
Nitzan Anavi	Look at how proud BoA looked IM SOFT
Polen Bides	Congrats mahh boy im sooo proud of them
Alessia xx	THEY ARE SO CLOSE TO CRYING OMG
Hando Pangestu	MARKHYUCK WITH 2 BUCKET FLOWERSğŸ’™
Paloma	1 15 i saw that wink Yuta
heol daebakk	Thank u
dragonamu	that s great moment they win in music show in yuta s birthday
PEACH TEA	Haechan shirt remind me of Malaysian Batik traditional Malaysian attire haha Any Malaysian NCTzen hereğŸ‡²ğŸ‡¾ â¤ï¸
HANA NURHAYATI	0 25 OMG JAEYONG
Being multi is GREAT #ComebacksAreNoJoke	If they cry I cry Simple
L. Hasna	winwin a thumbnail bless
Hera Kharisma Suandi	ğŸ’šğŸ’šğŸ’šğŸ’šğŸ’šğŸ’šğŸ’šğŸ’šğŸ’šğŸ’šğŸ’šğŸ’šğŸ’š
Nur Aisha	Taeil look taller for once with the party hat ğŸ’šğŸ’šğŸ’š
cisly myr	I love you congratulation NCT 127
cinderellaboy	that jungwoo s cute little high pitch voice
Ana hoho	2 34 did nct just do a fanchant for nctzens ğŸ˜­ we dont deserve them ğŸ˜­ğŸ˜­ğŸ˜­ğŸ˜­ğŸ’š
á´…á´€ÊŸÉªá´€á´  ÊŸÉª	JOHNNY YOU ARE SO PRESIOUS â¤ï¸â¤ï¸â¤ï¸â¤ï¸
Alicja Lis	So proud ğŸ’šğŸ’šğŸ’šğŸ˜­
cik Kinnik	I love they are not the cry type Except for JungWoo I can t imagine the other 127 member cry in public
NCT NCTzen Channel	Why did they just upload this video by now Well better late than never
xxFlor Solxx	Amo verlos tan felices ğŸ’šğŸ’šğŸ’šğŸ’šğŸ’š
Shara Sema	They look so hottt
ì„ ë°±	ì—”ì”¨í‹° 1ìœ„ ì¶•í•˜í•´ğŸ‰ğŸ‰ğŸ‰ğŸ‰ğŸ‰ğŸ‰ğŸ‰
TY Track Nctzen	ğŸ’šğŸ’šğŸ’šğŸ’šğŸ’š
monday blues	they deserve this and so much more my talented hard working baby ğŸ’š
Cherry Peach	Congratulations ma boy
Buffaylo	wig
Husnul Hotimah	Yessssss Finally I Love So Much NCT 127 NCT 127 the best always and forever ğŸ˜ğŸ˜˜
blossom 252	Jaehyun why u so handsome ğŸ˜‚ğŸ˜‚
A. tiny girl87	congrats ğŸ‰ğŸ‰ğŸ‰ğŸ‰ğŸ‘ğŸ»ğŸ’š well deserved win ğŸ’šğŸ‘‘ğŸ’šğŸ‘‘ğŸ’šğŸ‘‘ğŸ’šğŸ‘‘ğŸ’šğŸ‘‘ğŸ’šğŸ‘‘ğŸ’šğŸ‘‘
be quiet don't cry	Congratulations nct and nctzens
Alluring Scene	Brrraaah
baekkie is mine	Mark looking double good in those clothes
N NN	Perfect moment in a perfect time ğŸ˜­ Congratulation boy you really deserved it Dont mind what hater said bout ur achievement finally all of your hard work paid off 4th win We been knew that ur journey since the beginning wa never easy lot of hate bad rumour Just like Mark said let walk together dont run just enjoy every moment that we made To hater I like shining you be lyin I be grindin you waste time Know you wan na roll with me Cause you know I put it down When I show up I m the one and only No no no No no Yeah pull up in the Jag Haters gon be mad NCT127 2018
ametrine	1 40 zeus ğŸ˜…ğŸ˜…ğŸ¤—
talented visual group? it's NCT	Seeing them won in a major music show is really happy Like so happy That s why their reaction wa so surprised They didn t expect it but yet you guy really deserve it
Nanami	ãƒœã‚¢ã•ã‚“ã‚ã¡ã‚ƒãã¡ã‚ƒå¬‰ã—ãã†ğŸ’— ãã—ã¦ãŠã‚ã§ã¨ã†ğŸŠ
Gaia Montero	1 15 YUTA S WINK IM NOT FINE DUDE
Jima Ayekpam	Congrates boysğŸ‘ğŸ†ğŸ†ğŸ†ğŸ†ğŸ‰ğŸ‰ğŸ‰ğŸ’šğŸ’šğŸ’šğŸ’šğŸ’šğŸ’šğŸ’š
Rezmalia AerisTzenie	ğŸ˜­ğŸ˜­ğŸ˜­ğŸ’šğŸ’šğŸ’š
å¨œå®‰	I m not cry y all
BANGTAN & ARMY WILL STAY FOREVER	proud of my boy ğŸ˜­ğŸ‘
usernamemaybe	3 well deserved
farexofan loveexo	Double winwin
jungcook's timberland	Jaehyun s yay in the beginning omg
el safir	really really thanks for upload this video â¤â¤â¤
Ramsha A.	ğŸ’šğŸ’šğŸ’šğŸ’šğŸ’šğŸ’šğŸ’šğŸ’šğŸ’šğŸ’šğŸ’šğŸ’šğŸ’š
-Stay With Taeyong-	TAEYONG LOVE YOU SO MUCH YOU ARE THE BEST ğŸ’ªğŸ’ªğŸ’ªğŸ’ª
Aira Dela Cruz	0 33 doyouuung â™¡
evakingstumblade	they deserved this and much much more so proud of you boy
veryverylucky	so proud of NCT 127
atinkerfairy	Well deserved my precious son
Articles Faith	great you boy deserve to be winner every time
Hello~Johnnyyyy	THANK YOU FOR UPLOADING THIS ğŸ’šğŸ’šğŸ’šğŸ’š
Moon Taeil's Other Half	I thought we get the clip wherr Taeil kissed Mark on cheeksğŸ˜”
Azi Shagnal	What wa it filmed withğŸ˜° Anyway thanks for uploading and congratulation NCT ğŸ‰ 181026 is the best day ever
ì—‘ì†Œ xí˜œë¦¼	1 54 that BRRRRAAğŸ˜‚ğŸ˜ğŸ˜ Mr Nakamoto OMGğŸ’–
Vocal Legend Moon Taeil	Taeil and his tongue ğŸ‘…
Lovie Soul	1 48 taetae being rude
No need to know	CONGRATULATIONS AGAIN ğŸ’šğŸ’šğŸ’šğŸ’šğŸ’š
Rizkii av	Proud ğŸ’šğŸ’š
you could be my only star	I ve been thinking about this Thank you
jeon kysoo12	waaaa
Joy Cha	Taeyong s tongue action boi I felt that
Helene T.	Boa and Taeyong hug Boa best sunbae ever
Mitsuyuki-Hime	NCT WON CONGRATS MY BOIS ğŸ‘
mark tuan can't relate	Jungwoo s 4th win with 127 Regular s 4th win ğŸ’šğŸ’šğŸ’šğŸ’šğŸ’šğŸ’š
Nurman Winasi	Taeyong cry ğŸ˜­
kyxngin	THANK YOU SO MUCH 3
ã¾ã—ã¾ã‚ã¾ãã‚Šãƒ	The quality of the video is awful but I still like it
Mss m	jaeyong hug ğŸ’šğŸ’šğŸ’š
NCTzen child	Babies
jeon FIys	ğŸ’šğŸ’š
