Daniel Rodriguez	Why doe lewis almost sound sad to win the championship üòÇ
El Emperador92 Vloks Vloks	go through my channel you will find video about the grand prix event of mexico 2018 you will like
TachyonKing	REMEMBER INDEPENDENCE DAY LEWIS REMEMBER WHEN I PUNCHED THAT ALIEN AND SAID ‚Äú WELCOME TO EARTH ‚Äù IT ‚Äô S JUST LIKE I TAUGHT YOU LEWIS YOU BEAT THE GRAND PRIX JUST LIKE I BEAT THAT FUCKING GREEN ASS ALIEN MOTHERFUCKER
kaleab amare	I wanted to hear stoffel he finished 8
Euan Findlay	Hartley What a bunch of amateur Oh the irony
FusDy	jivanatzi is idiot
Skyrocket888	HARTLEY need to fuck off back to F3 the cocky prick
DESTROYER67732	Your telling me lewis won the bloodys f1 world championship and he sound like he reading a school textboook
Elia Waeber	Sorry guy but this is f1 Just poor guy complaining about some sh t ooh he drive in the middle of line oooh Amateurs wheres the f ckin racing
harry sivri	It isn ‚Äô t racing if you ‚Äô re told to slow down Wtf
Shivam Vaid	That wa kind of an insult to alonso when he said it s quite unusual but you are p1
A. A.	Thats how you cringe baby
Adam Brough	Hartly bunch of fucking amateur How can he call anyone an amateur
Don't light your own cigarettes.	So many child who didn ‚Äô t get the Bad Boys reference Also y ‚Äô all mad a big star isn ‚Äô t your friend or what He wa congratulating Lewis for winning the championship lmao
Obito Uchiha	Hartley calling people amatures lol
Foley48	For a guy who just won the world championship he doesnt even sound that happy Probably sulking about not winning the race
everyday life	Could ve said something better for his 5th title
j4ck	I m actually going to miss Alonso he s an absolutely amazing driver with arguably the best race craft on the grid he ll always be in our F1 heart
Santhosh Prabhu	Who else find Hamilton annoying
Mr. Sparkly Pants	Man Fernando sounded very sad
Matteo Moretti	Come si fa a dire a un pilota di rallentare perche fa il miglior tempo dio can √® per questo che vanno tutti a vedere la moto gp
–ú–∞–∫—Å–∏–º –•—É–¥—è–∫–æ–≤	Why they always say ‚Äú Copy that ‚Äù ‚Äú I save it ‚Äù What doe it mean
ericsbuds	I had a feeling Daniel s car wa gon na break down Wish it hadn t
P√©ter Nagy-Mikl√≥s	The background music is unusually good here Most of the time I find no joy in F1 video background track in this channel to be fair
wouter haaksma	MAX VERSTAPPEN
KurkkuMopo	You realy take Will smith voice over to this Cring Dddddd
Phillip Muchiri	Brendon Hartley calling other driver Amateurs is the funniest thing I ve heard today Will Smith clearly did not watch Verstappen s drive no wonder the guy he taught how to drive wa 4 second from being lapped
Me Me	Glory thief that s or will smith is he still think he is the prince of bell end I mean bell air
The Gamers Channel	Daniel Riccardo did a great job I m saying a an Australian
Sailing Channel Marinus	http youtu be addme pbk3FJ YjPAkN5UJyhEjONgZ0Q7HjQ
Âπ≤„ÅóËäã	What is P 0 P 1
Owen Simpson	Will Smith is a great guy but let s be honest he doesn t have a fucking clue about F1
Chang Freddy	Now I hate Will
Patrick Nancanha Seidi	Max going too fast again üòÇüòÇüòÇ
wert freund	What the f ck happened to Ricciardos Renault engine I want Charly Whiting to investigate on data Secondly where is Ocon driving F1 next year it got to be in F1 s Liberty s and Chase Careys natural interest to keep such an excellent driver in the series who outrode his teammate Perez A L L SEASON although Perez hounded him badly several time without any real consequence Is that the message F1 want s to send out to all the Young viewer drive fair and ambicious and get kicked out of the sereies cause the guy who drove unfair to You teammate most of the time kept his seat really
ZER0 DR	Just turn it down please Max please
Power Plant Zone	Just like I taught you Taught him what How to work a Instagram account smh
BlastForward	Purple is nice üòÑ
Jeremiah Jarrett	Will Smith wa crazy plus Lewis never swears have you noticed that
Mister Xav	Nice
Edski F1	Go away will smith
Schwar tz_	Will smith lol
ZAIN worldwide	http www youtube com channel UC9TTo5lSdvuspGG3INhFEEA
RRoJ	Man Alonso don t deserve to leave F1 like that
Amin Hafdaoui	Fernando wa cry
JM	Liberty Media ha such a hard on for celebrity Europeans don t go that mad for celebs thats why we don t have half time show during football match
Charles HD	I hope that Vettel win the championchip in the next year
shivam chaudhary	Lol Hartly calling other driver amateur theb what s he
Vectro666	This is officialy the most anticlimatic championship in the history of F1 with LM trying to be funny at the cost of emotion and pure reaction Why the cringy team radio This isnt a fucking kid show Grow up LM and give u what we want
Martin Horvatiƒá	So arrogant from Hartley
Hauptsache Puls	Every Mercedes official and Hamilton himself did not sound happy like they should in a title winning moment One bad race stand out more than a title Just impressive Ferrari and Red Bull should be aware for next season
BrettJones27	What the hell is Will Smith doing here FFS A down vote just for the shameless pointless insertion of a hollywood star when he ha nothing to do with the race or hamilton s success Just utter crap
Kyle Parkins	You can hear the sorrow in both Alonso and his engineer ‚Äô s voice when he is told to stop the car
A or Ta	The race where Lewis almost got lap d by Verstappen
Nico RosbergFan	I wonder why they didn t pit Fernando
ŒöœâŒΩœÉœÑŒ±ŒΩœÑŒπŒΩŒøœÇ ŒúœâœÅŒ±ŒπœÑŒ∑œÇ	Woaaa Wait a minute Did Hartley just say what a fucking bunch of amateur Hartley üòÇüòÇüòÇüòÇüòÇüòÇüòÇüòÇüòÇ
That Dude Over There	Hartley calling people amateur Yikes
Shravan Pammi	Hartley Givonazi is an idiot Engineer copy thatüòÇ Hartleys engineer is my favourite of all team engineer
Jones	i love Best Of Team Radio
The Old Fart	Come guy you missed some Epic radio Ok that s a decent cushion so let s match lap time with the car behind Was that ok Yeah Hamilton lap time 21 8 What wa i doing 21 6 how doe it feel slow
nes suno	Ruined by you American Liberty Media clown with that 1 race old Will Smith recording PROMOTE TRUE FANS AND FUTURE RACERS not these hollow and shallow VIPs
M3nt2 R3pr3z3nt	That s how you supposed to drive to a man coming in fourth xD Verstappenn is a beast MORE forzakubica
Flamecrest	That s how you do it baby Just like I taught you Will Smith never professionally driven a race car to Lewis Hamilton 5 time F1 World Champion Cringy a fuck
JC Whats	I like that American sauce over the Formula 1 just like everything they take what isn t there s and put that F ck yeah USA USA USA over it stupid fresh prince and so on
H.I 21	Please upload in 4K
Kaito	engineer will always say copy that
Logan11thMEU	thats a real shame what happened to Daniel
GroundInactiv XD HACKED	people are saying that Will Smith made a reference to the Bad Boys movie but why in a Mexican GP where Lewis got 5th place
Lontong Gaming	So wE aRe P1 pUrpLe iN eVeRy SecToR
Pixels DXL	Hartley said a bunch of ameteurs but he is also an ameteurüòÇ
Matƒõj Mac√°k	1 50 feel so bad for Ricciardo
Ameer Qayyum	no one care about max
Vadim Kropotin	nice music
Nihar Bendre	Hartley calling the guybin front an Amateur üòÇ GG
Daniel Matthiesen	Love listening to Hartley getting fired up
deathmetalshredify	I understand having Will Smith a a backup for the sport is advertising it What he said wa incredibly cringy though
Adam Janik	slow down max Nice to see how f1 turned over last few year From being fastest on the track to being most effective with tire and fuel Just put diesel in it those have some nice MPGs
Unpanda Rouge	Lewis doesn ‚Äô t heard Will Smith anytime
Santo72	Alonso P1 wot
THE NOTORIUS SAL	Hartley is ridicolus
Raiez njr	Daniel can t wait to get out of that Redbull once and for all
ÂáåÊº™ÂÖ¨‰∏ª	hat‰πüÂ•ΩÊÑèÊÄùËØ¥Âà´‰∫∫Êñ∞Êâã
Erik Vernarsk√Ω	hartley talking about amateur which are better than him D
slavmart	Lewis this is Will
Sparkie raven	Just hearing Ricciardo about to cry üò°üò°ü§¨ü§¨üò≠üò≠üò¢üò¢
Doodlebug YT	Great job Lewis Your now considered one of the great I like Sebastian but still amazing job on being a 5 time world champion üèÜüèÜüèÜüá¨üáßüá¨üáßüá¨üáß
jianh1989	Dear Liberty that thing with Will Smith stop it
moddok	im so sorry for daniel
cocabeer	That Will Smith thing wa aweful Just like I taught you Is this guy nut And Lewis drove like shit last Sunday so it s double messed up
Jenny Gavin-Wear	Never heard Lewis sounding so tired after a race
Jack Bauer	GTFO with celebrity pre recorded message No one buy the bullshit that it s live and that they actually love the sport
Alexander King	Hartley to stay in Toro Rosso please
Thomas Ning	So doe anyone know why alonso had to retire the car
Aykut	Did Lewis not know it wa Will Smith or wa he just not thrilled for being P4 why no reply
WiseGuy02	The message from Will Smith wa the most cringeworthy thing I ve heard over the radio
Gustavo Santos da Silva	Ahhhh those where some great battle Michae Schumacher Mika Hakkinen and Will Smith Best driver of a generation
GloomGaiGar	Hartley going full savage Meanwhile Gasly start from P20 finish P10
mini696	Who thought it wa a good idea to get Will Smith on the mic
Roland Lee	Soo Will Smith taught Lewis how to drive And he is supposed to finish 4th wtf pure cringe
Sofyan Nanda Fahrurrozi	P1 purple in every sector ü§£ü§£
kickinbackinOC	Will Smith Pure shmaltz Lewis is a hero to me maybe the only one I have But Will Smith is nothing to me sucked to hear his voice just then Like Will had a shred to do with anything
potato911	Alonso and Ricciardo two of the better driver that don t deserve what s coming to them
General Almirante Presidente Aladeen	Hartley saying amateur that s funny
Mao A	I m a Will Smith fan but ugh that wa embarrassing It seemed so out of place
pritam cv12	It would have been really nice if Lewis Hamilton had mentioned Ron Dennis atleast in some part of his speech He and his father worked tremendously for their dream But Ron Dennis deserves atleast a thanks for his company s funding
george langan	No wonder Riccardo s leaving Red Bull It won t even be a downgrade if his car manages to actually finish a fucking race
Adam A	Wtf with the will smith message Why Soo annoying and embarassing Does he need air time that badly Argh I m offended
Armchair Racer	Will Smith 5 time world champion driver coach apparently
BigBoyMcEvoy	stop hating on will smith lol
Nicholas David Hutabarat	WILL SMITH CHEQUERED FLAG
Jorge Gonz√°lez	Will ‚Äú cringe ‚Äù Smith
Matheus Pereira	Man Max is an incredible driver Too bad that he s in the wrong team This boy have a brilliant future in F1
Sebastien Tuscano	hartley message lmfao
Imran Nadal_ CR7_Khyber Pakhtunkhwa	some stupid people are copying each other by saying will smith sounded cringy not at all i loved it i think they dont undertand afro american humour
Robert M	People saying that the Will Smith pre recorded message telling Lewis he taught him how to drive is acceptable because it s a movie reference are being ridiculous What next At the end of Will Smith s next movie we get 30 second of random footage of Lewis Hamilton driving That s the level of irrelevance we re talking about here
nismo007	WIll Smith giving driving advice is like him giving marriage advice OH WAIT
Antonio Gallagher	Ricciardo Alonso Hartley cursed
DugBingo951	Really calm radio message
Oyi 87	Will Smith ha no business doing that radio comment He ruined the moment
Santi BD	missing a radio team boah better than 4th position
Suresh Kumar	I m wondering where would Hamilton be without Will Smith He taught Hamilton everything What a DOUCHEBAG
Zlatan ibrahimoviƒá	At first i thought it wa jeff gordon that wa talking to lewis because jeff wa a special guest at the mercedes garage I thought to myself while the radio message wa played daamn jeff gordon must be a hardcore lewis hamilton fanboy because he want to sound like a black man so bad hahaha
beetle juice	Hartley is one annoying cry baby
Just Simon	Poor Alonso sad to see him leave the race right at the start
Hugo Seelen	2 19 That wa purple in sector 2 and 3
Carlitox b	2 17 my new favorite driver hahaha thats how a champion think
Ethan Roberts	That wa Will Smith ‚Äô s voice
JJ4824	Angry Aussies and Saddened Spaniards
Erik Coronel	Ricciardo üò£
SilverRonald	Which team doe this Will Smith drive for
Ivan Plis	Raikkonen wa napping all race long how the fuck did he finished on the podium Typical Kimi race weekend
james manson	29 comment down to find any mention of the WDC You guy salty a fuck üòÇ
Andy Lee	Max s engineer pleading for him to slow down Classic
DaylightDigital	Bad Boys
tarksable	Just because Will Smith is a gun at F1 2011 and the two time champion give him no reason to say that
David Pyles	Um Will Smith wa the Worst of Team Radio So silly and contrived
yz249	Hamilton nearly get lapped Will NoW tHaTs hOw yOu DrIvE
Ryan Fong	alonso cant give a shit at this point
Insane Racer	It s funny how they tell Ricciardo and Alonso how to go to P0 when they have so much experience doing it I feel sorry for them both
William Stephens	Who wa Max s fellow dutchy on the podium
GhaV jGRite (jeaHAvee)	I know you don t hear this very often so we are P1 purple and every sector
SennaRossiFan46	You have to feel sorry for that poor guy Ricciardo
Rude Boi	Liberty F1 fan do not care for celebrity it is cringey
Justice Warrior	Ohhhh yes Will Smith really taught Hamilton how to drive What a joke Cringe level is insane Why doe Will still speak Wakandian when it doesn t make any sense and it s stupid
Luke Wallace	Hearing Danny like that wa gut wrenching I really do feel for the guy
PhantomUniform0	Great race also whats the music in this
AlectriczOfficial	Brendon Hartley is getting furious about amateur but he is still one of them It s his first season so he offended himself hmm
ramesh anand	Ok Mercedes the YouTube comment have spoken Keep will smith off team radio
Subi_fan	That Will Smith part wa pure cringe
Zaac Spencer	What race wa will watching
allawee1991	Looks like Will Smith doesn t know shit about the sport That s wa one of Hamilton s worst GP
Adam Advocaat	Well I guess we can all agree that Will Smith isn t a racing driver Probably better off just getting jiggy wit it
Casper Due Hansen	Disappointed with this one Where wa all the Hamilton cry About losing a second a lap been given the wrong tyre and what not üòÇ
Elroy lobo	Hamilton not a worthy Champ great wat he ha achieved but dude come on your team mate ha to slow down twice in one race Instead you driving Give Toto to drive and you claim the point F ¬£in joke
Ricardo Bespalhuk	Leave Max alone He just want have the taste of having a great engine and going purple in all sector
thebanhammer1	Will Smith wa cringe a hell Get it through your skull Liberty nobody wanted it
ER BE	XDD ‚Äô
Fr35HPR1NC3	8 DNF for Daniel this year and almost all due to mechanical failure Get away from that toxic team and get to one who isnt going to sabbotage your chance Makes me sick Redbull always seem to give him the le reliable car in 2018
Mister Conan	1 15 wa Alonso cry
Hugo Stiglitz	Will Smith is such an annoying cunt
Khin David	I feel for daniel riccardo The guy just cant catch a break
DJ AidonYG	What happened to Fernando
Rasta Man	Me Hi 2 33 Ok
Mansch007	Who s that Smith guy Never seen him in any competitive racing
Denis Kudlik	That Will Smith fake radio message is among the top 5 worst thing my ear have ever been exposed to
Micka√´l Dorvidal	Hartley Bunch of amateur Engineer look at Franz Tost rolling his eye
Martijn Vv	Team radio s are now recorded in a bathroom
Simon der Weduwen	Wait should we rewind a bit Alonso ‚Äù I did Some donut practice for next year ‚Äù üòÇüòÇ
VANITY80	Jesus Will Smith is so cringeworthy üò∑
my name	Why all the censored message Fuckin idiot
Kevin Papenburg	This weekend had everything Happiness relief but also salt arrogance cringe heartbreak frustration Really enjoyed it Did I mention cringe
pls team	an almost lapped car just got 4th
Pedro Silva	Next year im cheering for Vettel just to hear the message recorded by David Hasselhoff
Benjamin Puljak	hartley calling others amatuers lmao
Psyclone The Seahawk	Brendon Hartley calling people amateur Yeeeaaaaah
MUZZAMMIL BOLTMAN	Apparently Will Smith taught Lewis how to coaster an F1 car till the end
machine bomb	will cringe shit smith
BWOAH	That s how you supposed to drive So you re supposed to finish in P4 78 second off the lead Interesting
Schadows77	Silly Verstappen he should know by now a F1 is not meant to make purple sector and attacking It s made so you can look after your tire look after your engine look after your gas consumption all while making sure you re not surprised by those guy running in F1 5 on the same track a you
Harold2018	Im confused when Dan wa out Max wa saying on the radio turn down the engine so why is he doing purple sector on lap 65
Ali Aljoubory	How come I didn t hear Hamilton s team radio at the end of the race I just heard Will Smith
Manuel alaminos dominguez	Heart breaking listening to Alonso and Ricciardo They were both sould broken
Pratyush Kamboj	You didn t often see the engineer swearing
Karpia	0 25 xDDDDDDDDDD
MIAthe305	Lol take it easy Hartley you ‚Äô re gone in 3 race so how about you serve yourself a slice of humble pie
Alen Ozim	Hartley is talking about amateur but he is an amateur lol
Andrew Small	The cheesy American style will smith audio wa awful STFU
–ú–∏—à–∞ –°—É—à–∫–æ–≤	1 18 SO SAAAADDD
Nikhil Menon	It would have been great to hear someone from Lewis family congratulate him on the title at the chequered flag Instead will smith Cringe
Baran Yavuz	Respect Lewis
MrSgtScotti	Will Smith need a off switch
SuperMechguy	Red Bull messing with Ricc
Savannah M3	Damn I didn t know Will Smith wa a world champion and taught Lewis That s the perfect idea for a documentary about Lewis Sitting in a class while Will Smith is teaching him how to drive
Mik Davies	I could not see the point of the Will Smith voice over totally unnecessary totally cringeworthy typical American must get involved at all cost rhetoric
denmark39	I hate celebrity
Liam Savinainen	1st time alonso doesnt get mad over p 0
Cp Gautam	pretty sure ric is screaming just a loudly a in quali after the race
kbst84	In 25 year of watching F1 there are only two driver I would consider myself a real fan of Senna and for whatever reason Brendon Hartley I want him to stay so badly in F1 And I m not from New Zealand not even close
Duckingtanker	Hartley talking a lot about people with confirmed seat next year
Grin Wakiin	What is P 1 then P0
The Marauder	Why didn t they just pit Alonso and remove the carbon from Ocon s car instead or retiring Also Hartley really man you re also a rookie Just because you got a seat with Toro Rosso it doesn t make you hot shit on the track a you re mediocre at best
tommobeast2	Hang on a minute when did Will Smith ever teach Lewis Hamilton to drive
Simracingnoob	What wa that echo on some of the radio message
Max 33	1 ham 2 verstappen 3 alonso 4 ricciardo 5 vettel 6 Leclerc 7 ocon 8 hulkenberg 9 perez 10 gasly 11 Sainz 12 bottas 13 grosjean 14 kimi 15 Mag 16 Hartley 17 Ericsson 18 stroll 19 sirotkin 20 Van Thoughts
AVP ‚Ä¢	Will Smith wasn t even part of the race the most stupid radio message F1
Lucky Luke	Vettel should hire Will Smith to coach him how to drive
Sharmik Thakar	C R I N G E S M I T H
TheFikri136	I know Will Smith spoke in radio But his name in 3 07 Honestly wtf is going on
michael williams	Ricciardo having terrible luck along with alonso lately cant get passed the 1st lap without someone crashing into him or hitting debris
Mr Rayquaza boi	What is the background music
blackAngel	That s how you supposed to drive 15 second from being lapped xD But I agree so maybe next year Vettel get the Title We don t need it but it s nice It is indeed Now to more serious stuff What happened to Alonso wa there still a bit of wing stuck in a crucial place And Ricciardo Engine failure
Cbr 3	see thumbnail dislike
Andika Tansir	Vettel In 2017 Mamma mia 2018 Well done
Teoxx	3 22 to skip Will Smith s message
KleiberFan	Complaining about Will Smith cringe is not a substitute for a meaningful contribution to the comment section
Mauricio Bastazini	Please dont let celebrity who dont understand shit about the sport speak on the radio Now we gon na have to listen to fucking Will Smith every time we rewatch lewis being 5 time world champion thats how you drive probably Lewis worst race this season
Elliott Wardle	That ‚Äô s how you supposed to drive to p4 and 60 second off the lead üòÇüòÇ
Joe Molineaux	Lewis is boring af
ŒíŒ±œÉŒØŒªŒ∑œÇ ŒîŒ∑ŒºŒøœçœÉŒ∑œÇ	Hartley talk about amateur What a joke
Lyionis	This race wa really similar to the race in 2017 Max win after great start and is slowed down by the team at the end Ricciardo after good race retire with car problem Hamilton ha problem during almost whole race and win championship arriving at further place
Angga Pratama	the HungarianGP curse ha been broken
Pedro Delgado	2 Things A Where Is The Radio Of Sainz s Car Issue B Is Brendon Hartley Getting Fired From F1 And Moving To Indycar Next Year I Want Artem Markelov With A Seat In F1
Kandarp Vyas	Well background music is just dope Anyone know it please reply
Craig Hamilton	5 TIME WORLD CHAMP Congrats my brother Woo
TheIVY321	Really glad you had the exchange between Lewis and Bono the Will Smith attempt at comedy wa completely out of place
El Chaval Duro	Will Smith is starting to piss a lot of people off The older he get the nuttier he becomes Motherfucking nigga say thats how you drive If Lewis drove like that the whole season he d be below even Verstappen in the driver standing
capitao rex	Poor Riccardo
alessandro lagi	Hartley ha to be penalized that it ‚Äô s not the language that he can use to talk about Giovinazzi
Mat√≠as Tadeo Rossi	What doe p1 and p0 mean in these context
Lucas Gomes,Tamba	WILL SMITH
Tongankakarot 66	Fuck red bull
Klenex	why is brendon hartley calling giovanazzi amateur so is he
RED Productions	I don ‚Äô t know why you guy callin will smith cringy it ‚Äô s a bad boy reference he a baller regardless he can say what he want ü§™
Jens Pl√∂ntzke	Ricciardo ‚Äò s race engineer wa so unenthusiastic about P1 in Qualifying because he knew his car wouldn ‚Äò t make the entire distance anyway So sad though
Maketsu	Just here to tell that the pre recorded Will Smith radio message wa one of the cringiest thing ever The post race interview come close though Come on Liberty You re trying way too hard
D R	obviously RBR test some part on ric car same wa with webber 2013 when vettel broke all record we are not blind and stupid
Carpy Fernandes	Will smith wtf is he thinking
Sergi Monserrat Mascar√≥	Hartley bunch of amateur The irony
FRFM00	Hey Daniel it hard to win race without having a safety car and fresh tyre eh yeh get it girl get it get it fckin loser you couldn t even beat Wickens
mufc gamer	Hartley very angry atm sign that he know he been given boot
Timi Akinlonu	Ricciardo sounded like he wa gon na cry Man I can feel the pain he s going through
Kevin Parks	Poor poor Daniel I would be so fucking mad at my team
Rob Finney	Will Smith pre recorded message C mon Liberty What the hell That wa about the stupidest thing you could have done
Rocco Cingolani	Biased championship 5 race with an irregular solution for Mercedes
I Don't Know	A random question but what ‚Äô s a pre start
Csaba H.	HAM wa great this year but will smith wa a joke a prerecorded crap Just how I taught you dumbass
Zoa Khiangte	There ‚Äô s a conspiracy against Daniel Eighth DNF of the season It ‚Äô s a fucking joke
pc_da_ one_84	Hartley bunch of amateur Ricciardo No u
Wole Oyeyele	Is it me or the reliability of the RB14 s engine are Red Bull s fault I mean I know they re Renault engine but Renault and McLaren almost never have the issue that Red Bull is having The engine of the Renault and McLaren seem pretty damn solid and never blow up like on Ricciardo s car and never behaves in such a weird manner like on Verstappen s car I think that s no coincidence and Red Bull push the engine to destruction and want to extract every drop of performance without giving a damn about reliability That s not how to use an engine IMO if they treat the Honda engine the same way it s going to be just a unreliable
M Q	wwg1wga
Billy Bollox	YAWN
OdySey PyRo	You don ‚Äô t simply tell Verstappen to slow down
–ù–æ—á–Ω–æ–π –ü–æ–∑–æ—Ä	Alonso s breath say everything
Sir_Flankalot	I honestly feel soooooooo freakin bad for Alonso man that guy is just in the eye of a storm right now everything is looking okay and all of a sudden boom either engine either another driver cough cough Stroll in USA or some other thing Next year without him will be so strange
AMG	On what Verstappen said he is a proper racing driver
tycoon	I hit the front wing from ocOn D D fernando s killing me with his accent everytime
Daniel G.	So ocon wa able to pit on lap 1 for front wing damage why wasn ‚Äô t Alonso allowed
Shoxy	Last season when Max wa having all the issue Ricciardo said maybe he s too hard on his car and everyone jumped on Max for it Why is nobody saying that maybe Daniel is too hard on his car this year Because it wa taken a the reason when Max wa doing all the retiring
Han Solo	Thank you Liberty Media for putting on Will Smith Trying to make F1 more American That Will Smith thing wa so disrespectfull to Lewis and also to F1 in general Why put Will Smith on the radio Man o man Why And also what an arrogant and disrespectfull cunt Will Smith is It is a shame for F1 that this happened Never do this again
Nicolai Kystaubayev	0 32 v 1 48
all_is_bball	Lap 61 so sad
coaster323	ironic how hartley is calling amateur to other driver
Atje	Will Smith That s NOT how you supposed to drive
Blaise Hope	Driver of the day go to Will Smith
HojozVideos	Ricciardo s reaction on Sunday sum up mine
TTTMusic	Whats up with the mercedes radio sound They talking in a tin can
J W	it s strange during the race Lewis audio quality seems to be veeery bad a a non native speaker you I cant barely understand anything But when he celebrates suddenly it s loud and clear
Burak Uƒüur Cantekin	Frustration in the sound of Alonso
Dean Campbell	That dude complaining about his tyre life the whole race and you said thats how you drive Look Will i know you are now kinda popular in Youtube because of your helicopter jumping but man cringe ha a limit
F1 fan	Poor danniel and Carlos always bad luck to them
Mohar Ikram	Still weird why Hamilton radio on his tyre are not here These tyre are dead man
Jes√∫s Zarate	Checo noo C
Elvi≈´ga	Thank god we didn t hear another Get in there Lewis
VIEIRA!	ricciardo situation broke my heart
Steven Cohen	Hamiltons grandfather would have been proud to see him take the championship a for vettel I heard that he had family problem and it made him spin round 3 time In 3 race Ricardo dark cloud won t leave him alone and Alonso I have an idea but rather not comment
Marko Zivanovic	The Will Smith pre recorded message wa pure CRINGE
mohand prince	Max yaaaaaaaaaaaaaaaaaaaaaaaaaaaaaaaaaaaaaaaaaaaaaaaaaaaaaaa Aaaaaaaaaaaaaaaaaaaaaaaaaaaaas
Martin Zlatev	Any one that heard a Big Smoke on the radio
Phet Suwankhajorn	OHHH MAN from Ricciardo broke my heart
Starigniter Wanders	What do purple yellow and green sector mean
cynicalobserver	Please no more Will Smith
Gandhi's Flip-Flop	Will Smith WTF That is an asshole who doesn t know fuck all about racing
/H√∏w≈Çƒ±t…ô/ /JackTheEmerald/	I ll save it Fuck you RBR
ŒõŒùDŒóŒ£Œ£	if hamilton supposed to drive the whole season like today he will not be world champion will smith blo on banget
RcNumbers Mr.Crash-a-lot	No one is even mentioning the fact that stoffel wa complaining about people driving with slow pace in front of him Were talking about the trash mclaren here
Sven Netherlands	Don t do that Will Smith thing anymore It s fake They like this kind of fake stuff in the USA Keep it there IndyCar etc but not in F1
hornetluca	Who knew that Will Smith taught Lewis to drive
ShenkieJ	Fuck off with the pre recorded celebrity shit Liberty We want to hear the engineer etc don t Americanize F1
Sergio Ferreiro Oro√±a	1 03 üò¢üò¢üò¢
Lightening McQueen	I never even realised that Will Smith wa there and talked on the Mercedes team radio
Attila Kov√°cs	Cringe Smith
MajorKitten	The frustration in Ricci s and Alonso s voice make me so sad
Stone Draconis	Niye arkada Yaparƒ±m Bilirsin √ßalƒ±yor mk Koyacak ba≈üka ≈üarkƒ±mƒ± bulamadƒ±nƒ±z
Federico Innocente	What a fuck is Hartley saying üòÇüòÇ He is the worst driver ever he ha nothing to do with F1and he even blame the other guy What a stupid
Thijs	hahahaha But it s nice hahah
Keerthi Sagar .B	I m still confused Does the championship belong to Lewis or Will Smith
Kieran Bennett	Vettel giving ricciardo all the room in their 1v1
MiXA28	Gutted about Ricciardo But hold on 2 more race mate after that you ll be happy
Cloxxki	Bit Senna esque purple sector when not needed It s going to end in the wall or gravel from the lead eventually
Meka Vijay	Brendon Hartley talking about amateur üòÇüòÇüòÇ
Nina Van Wijk	Fernand deserves so much better too
Country Music Hall of Famer	Man there s a bunch of miserable fucker who watch this sport People whinging on the qualifying video because of a child dancing in the grandstand people whinging on this one because of the Will Smith audio not to mention all the other trivial stuff they ve whinged about this year
Donyx	That s how you supposed to drive Am I the only one who ha heard That s how you smoke the drug
Sadistic Ninja	2 38 what s the meaning of this
Jason Kuy	Always happen to danny ric DNF Fuck you redbull
SmittenTheKitteninMittens	Congrats Lewis well deserved 5 time only 3 to go to be the GOAT
FreeOnGoal	Helmut marko is messing with Riccardos car 100
Emilio X	SEB pole position GRAZIE RAGAZZI MACCHINA GRANDE MACCHINA ROSSA LEWIS ‚Äú GET IN THERE LEWIS VALTTERI HAHAHA YES DANIEL YEEEEEEEEAAAAAAAAAAAAAAAAAAAAAAAAAAAAAAAAS KIMI thank you
Victor Hedgehog	Giovinazzi is idiot ok wat
Ashutosh Sharma	I don t want Ricciardo to become Alonso
TiroweE	Hartley bunch of amateur Please remind me Brendan how are you fairing in the Championship compared to your team mate
Jun Alexander Shibata	Brendon poor man he wa just so unlucky
Conner of Dill Creek	Will Smith congratulating Lewis ruined the whole experience for me
AngoNL035SD	Will Smith dont know shit
Struuf	Will Smith s message wasn t played to Lewis it wa only played to the viewer Fucking stop it Liberty
Murderus	I like will smith a bit le now he taught Lewis ZERO
Udha Single	Poor Ricciardo
Super123456789Kuba	Will Smith s Message is a refence from Bad Boys movie from 1995 I hope that Lewis didn t cringe at that Though xD
TonyUo Games - Clash Royale - Mobile Leyends	So sorry for Daniel I apologise he leave 8 time
yoni isra	Heir Max Verhstuffen is so cool unt RedBull is Talents Killers Miss Hamilton is a robot ja like Vill Smiths I Am Robot Hamilton personality is zero charizmatic boring unt so his drive not exciting like a robotn Ich been sorry to say but miss Hamilton the robot ist Killing Formel 1 Ich will be happy if he retire soon so maybe more exciting driver Max Verstrtuffen will go to Merecdes unt give u ppl more fun so if u see this Hamilton please go to Le Mans or Naskar where other boring driver are
Dani	That reaction from daniel when he got pole He wa so so happy And then his engine leaf him My heart is so broken His reaction from pole got so many feeling in it
Snowman11	Nando really sound sad and then hearing Danny after that a well
Firemarioflower	Sirotkin wa a proper asshole this weekend ignoring blue flag for Vettel a well stupid turd Williams must get two new driver next year
URsuckishATlife	Lewis didn t deserve to win the championship Will Smith did
DINHO2004 GAMING	hurtley say giovazzi amauter when he is rookie Say what I mean that the hurtley rookie tell giovazzi very good amauter
Wiseboy	Hartley bunch of amateur currently 19th with 4 point and a team mate on 29
Avais Hussain	Brendan is frustrated He know his fate Or at least feel what ‚Äô s coming He ‚Äô s improved the last few race And had bad luck but red bull don ‚Äô t give 6 shit about that So sad really
Ali Taimoor	Ok P 0 That break my heart to hear Alonso saying it that way His last year in F1 and he tried his best with a much slower carüíî
Josh Flynn	Thing said by will wa from movie he wa in called Bad Boys Calm down guy
Motorsport Tube	Ocon did his own damage imo
Daan de Roon	Uhmm max your are going to fast slow it down pleaseüòÇüòÇüòÇ
J D Atristain	Bad Boy of the day Will Smith
Duarte Rodrigues	Where is kimi
Dutchy-NED	my heart just instantly broke hearing Daniel after his car broke down
Lume	Thanks Will Smith for teaching Lewis how to drive otherwise he wouln t be a 5x World Champion now
jah d	if you leave red bull they will take your wing sorry Dan
Szybka Cebula	Riccardo nearly cried And seriously I start to think that Red Bull have something into this DNFs
Suzuka 82	2 38 the best
Matthew Wu	P8 for Vandoorne
Sh0ckw4v3	i can tell that it wa a very difficult race for alonso and riccardo he deserves p1 but his engine had to fail
JustMikoo	So will smith taught lewis how to drive a formule 1 car üòÇüòÇ what a yoke
MAL 9000	haha Will Smith should teach Vettel how to drive
Gene W	So Will Smith taught Hamilton to drive And coasting around in 5th position is the way to do it
Florian Pike	So Will Smith make it to best team radio but not the neeeooww guy A Yoke
Enkosi Bono	Feel so bad 4 Danny Ric
Optimus prime	Will Smith s a bitch
Kiwi_91	anyone giving Hartley shit for calling them amateur need to be aware he much older raced in other category and is a 2 time WEC champion So he know basic race craft
TheNostr4	hey F1 please no Hollywood shit here PLEASE i like will smith a a Actor in film u know
Matt Birkett	I know that F1 read these comment so please note that clearly NO ONE liked the Will Smith message Never repeat this tacky sort of thing again please
Khristian Gillespie	That wa just epic
242turbo	2 05 That is a broken man
William Costa Da Silva	The Championship is over now it s work for 2019 season
Mortlock	Seeing Fernando Alonso s final race ending in DNF s with no fault of his own is really heartbreaking
That Guy	Mclaren Ruined Fernando Alonso And Red Bull Destroyed Daniel Ricciardo I think red bull are playing favourite with max
Wesley Lemayian	Imagine Will Smith teaching Lewis how to drive üòÇüòÇ
ALFA WOLF	3 15 So Will Smith taught 5 time World Champion Lewis Hamilton how to drive I highly doubt that
Nitish Daniel	So that s where Jaden Smith s stupidity come from
Jerry Gilbert	that Daniel s celebration on 0 37 to utter dissapoointment on 1 58
[PL] Max 59	When you finish 20 secounds after Kimi and Smith tell you THAT S HOW YOU SUPOSED TO DRIVE Logic
Sky Watcher Risey	Will Smith s message wa hmuh excuse me that wa a bit of sick in my mouth where wa I
TomMY	If i wa lewis i would get myself a more funny radio man this guy is a flippin robot no emotion what so ever
MCL32	use me a a dislike button for will smith
karthikeyan shanmugasundaram	Am i the only one feeling bad for Daniel üò¢
Kritz	Hartley need a break man Hope he ha another chance next year
gabriele forti	I d say Red Bull ha done all it could to sabotage Ricciardo That s only what it look like they treated him like garbage I hope he ll make Renault a even more competitive car and beat Red Bull
Vasuki Sivaharan	When hartley call giovinazzi an amateur he s basically calling himself an amateur
Marcis Viksna	Brendon Saltley
Tom Reid	Am I the only one who liked the will Smith message üòÇ
AARRextremz 2000	I have never seen Alonso this sad üò™
Snowcone Guy	Bye Bye Brandon nobody will miss you
Niels Steen	Hartley is the amateur
IceCranberry	Daniel on Saturday all smile Daniel on Sunday frustrated
RaptoR	Respect for Will Smith for teaching Hamilton how to drive lol
AwesomeExpress	Hey Liberty I know your a bunch of old guy in suit who thought it would be fresh to have Will Smith congratulate Lewis over the radio but if you could stop shoehorning a bunch of cheesy bullshit into F1 we would all appreciate it Not only doe it fail at attracting a younger audience but it alienates existing fan You can attract new fan to F1 by emphasizing what is already cool about F1 and transitioning to a more accessible viewing model part of which you have done with the F1 youtube channel overhaul Those are the only thing you need to do stop all the other pointless change
Sabuj Chatterjee	Where is turn down my engine from Verstappen s radio
Tom Yang	Oh shit I didn ‚Äô t know Will Smith taught Lewis how to drive I wonder how many championship Will ha
zRackez 21	Hahaha Hartley hate everyone
Arturo Vidal	dont forget that will smith taught lewis how to drive so half the credit go to mr will
Nemchand Inderman	Lewis Hamilton champion 5title
Adam Tryzna	I am Red Bull fan and I wasn t able to enjoy Max s victory after Daniel s retirement I just can t Thanks Renault
jskkage	Why don ‚Äô t Will Smith comment on every race F k yeah
ReV_DeatH	0 42 YAAAAAAAAAAAAAAAAAAS
Da bro	Always look forward to this
Hal Williams	ya ll honestly need to do a playlist of the music behind these radio message
Hea Mees	Imagine winning your 5th world championchip title and then hearing this cringy prerecorded shit
Cormageuh	I m really sad for Alonso I know he deserves so much better from his team but ending like this He sounded really hurt
AngW Alo14	Poor Fernando he could break the record
Fannie Nel	Cheaters
Luke Bassett	a bunch of amateur from him
Joshy B	I don t understand why ricciardo didn t cover the inside on lap 34 Vettel wouldn t have been able to go around the outside a the backmarkers were there Am I wrong
Kojum	dislike for will smith
Carlin	Will Smith is so overrated
Sourav Mishra	I like how Max hater are under a rock now No I ain t a Max fan but that s what I noticed
Mister Jeffa	the will smith part is afwul and it wa prerecorded afaik it suck dont do it anymore
Dave Tanzil	Daniel doesn t need any of this
Lutfi J C	eh hearing that on Lewis s radio made me cringe the first time and it s still making me cringe First Brian Tyler and his Fast and the Furious copy pasta ings then this crap Darn O
soupe2000	I hoped Verstappen would have some empathy for Ricciardo but he must still be angry against him for taking the pole
Adam1401	Real sad boy hour for Ricciardo and Alonso
datzitteezy	Cringe Cringe Cringing Cringy Cringe worthy
Stephen Taylor	Hartley went complete savage there when he start swearing you know he s angry Ocon s radio message wa quite refreshing and brutally honest
teamspirit5	I guess a lot of people here haven ‚Äô t seen Bad Boys üôÑ
effisjens	2 15 someone give ricciardo a hug
Kyle	Imagine how many World Titles Will Smith could have won if he didn ‚Äô t choose to do acting
Gautam Vijay	Please give a Reliable car to Daniel for these 2 race Please üò≠
Trung Le	Pause at 1 06 You could see the BWT logo on Fernando s right front wing
Bj√∏rnar Iversen	Will smith is a f ing twat
Alex Wiggin	The Will Smith message RUINED that moment completely for me It sounded like some motivational script he wa given not genuine
Renze Koper	where is the verstappen turn the engine down plz etc
ll-Legacy-ll	We all want to hear what Max said after the qualification
MysteryCarlos	Will smith cringe Also don t forget that Jeff Gordon wa there
„Ç¢„É¨„Ç≠„Çµ„É≥„ÉÄ„Éº ‰ΩêËó§	Hartley F cking bunch of Amateurs FACEPALM
Ralonso	I M P R E S S I V E Will Smith
KeeperOfPork	Nothing against Woll Smoth himself but man didn t his insincere radio reaction completely ruin the moment
persezyra	Max s spirit everything the sport need
Carlos C√©sar	yea we dont need it but it nice Verstappen legend ahahahahaha omgggg
Antonius vd Klis	We don t need it but it nice That s typical Verstappen he want to go always the fasted it in his gene Only Renault cant give him that
matyskowa	Max true racing driver attitude
daniel miranda	That Ricciardo radio wa the saddest one ever
Laksonik	One day F1 will be back I hope
Daniyal Rehman	Loving this fired up Brendon Hartley üî•üî•üî•
Dom VR46	Will Smith 5 time world champion confirmed
Flashy	Lmao fellow Dutchy
Jouwy Master	Smith is idiot
Bad Bobby Z	Ham bitchin on his radio No Ok
MrPetersilius	I watched the Race Replay on F1TV and I can tell you the Will Smith thing wa fake and Lewis never had this message in his cockpit
Malwontae	You d have thought Seb would have taught Daniel the good old Blue Flags catchphrase during their year together
Jason 10K	So im just curious what EXACTLY ha Will Smith thought to Lewis Hamilton about racing
MUFC0161 MUFC0161	That s how you drive he came 5th mate
jody 107	Bad boy mike lowery now that s how you drive lol
eylence	Fuck you kamran
jamie islin	Well done Lewis H
Mitra Das	Wish Alonso could atleast complete his final 2 race LegendAlo14
Mohammed Azar	Will Smith is cringe Please don t bring ignorant Americans who don t give a shit and who like driving in rectangle to f1
ScrewCaptain27	Hartley having the man period
Roger Mason	I bet Lewis did not agree with Will Smith s comment that s the way to drive Sounded pretty stupid given that Lewis limped around on worn out tire and wa cruising at 70 pace at the end I m sure Lewis did not think that s the way to drive
Anas Nurhafidz	Cruising Max üî•üî•üî•
EarlCursed	You can really hear how Ricciardo wa sad He really need to go to Renault a fast a he can
sadman hoque	why didn t they bring Hamilton s Dad or something who actually supported him through his racing career quit it with the celebrity bullshit Smith didn t do shit that I know of
TheKing	Wait WILL SMITH THOUGH LEWIS i thought they were referring to his dad or something
Diogo Braz	Ok so wa I the only the who thought Ricciardo s Engineer said Honey you re P1 after he got pole
Mertolinho	Brendon even Stroll have more point then you
Sergeant	3 06 Try to be an actor somewhere else üòÇ
Cockmaster9000	Hamilton 99 of the race ‚Äû omg tyre ‚Äú 1 yeah championship
Chinmay Chinnu	Shut the fuck up Will Smith
esponcio	season of solid work and some fkin great driving
Carlos Guzman	Have you guy noticed every race Max lead to victory his Engineer is like ‚Äú Max slow the fuck down ‚Äù and Max is like ‚Äú Im just crusing bro ‚Äù üòÇ Max is the best
Farhan K	we all have to remember that will smith taught lewis how to drive
ariel verger	What Horner I think it wa Horner meant by saying don ‚Äô t get on fire on the podium
R4pt0r64	Someone in Lewis family died before the weekend so it wa indeed a tough weekend
Andi S	Will Smith taught Lewis how to drive
haziq	Ricciardo is so helpless
Alan YeLLeZ Rostovtsev	Brandon Hartley speaks like he s a 8 time world champion
BaasB 2	Like will smith know how to drive
Peter Brennan	keepwillsmithawayfromradio
Stefano Del Pistoia	Hartley suck
Arthur Moreira	That P1 wa remarkable
kshv	All the credit should go to will smith he is the one who taught lewis how to drive
scottiemcnichols	TO THE MAX
Fatlum Hamza	After what Hartley said it would be funny if Giovinazzi had a seat next year and he didn t
LisztyLiszt	Just like I taught you Ugh someone need to teach that clown how not to speak like a moron over a radio being listened to by million Cringe
reelkena	What s worse hearing Will Smith or Lewis getting handed another undeserved title
Amir Hakiem	Alonso ha no pain for retirement But still mad if someone crash to him
Wildfire	They shouldn t allow celebrity anywhere near the mics to the driver at any point during a race weekend Most of these non F1 knowing cunt wouldn t know an apex to save their life
Adrian Wong	YOU ARE THE MAN Bono Lewis Engineer
Aditya S	Danny Ric is second Alonso
jens schouten	The whole race there wa a bit of panic in the red bull garage
Azhar Alvi	Seriously fuck Will Smith
Xchloe playsX	HAMILTON‚ù§Ô∏è
s.uguaaa	Brendon mate
bhgf fgig	Where are all the message of hamilton about the hole
Lars Agerb√¶k	Dats hauw U do it my Nigga
John Luu	Feeling so bad for Alonso and Ricciardo Can t catch a break
Marquez is a complete  jerk	3 08 u dont see that often in team radio compilation D
Reicky Tcharles	Sounds like the driver are talking inside a bathroom
Marponsa	the defeat in ricciardo s voice hurt my heart
Abysmal Luck	When Max ha a title contending car we can expect a lot more of these slow it down comment on the radio üòÇ He s just cruising make me wonder why they d even ask him to slow down if it s not harming the engine
Igor	Honda of the day Renault
iliovecaRS	Thank you for will Smith for teaching Hamilton how to drive without the help of our Lord and savior wheel Smith we wouldn t be where we are today üôåü§≤üëÉ
IsDitGerben	The audio is all messed up from 2 50 onwards
52 Hz	Will Smith Liberty Media that wa enough
Tiger Costa	5 time champion he is a LEGEND
Dan	Riccardo after Qualifying OOOWAHAHAHA WOOOOOOO Riccardo during race FFFFFF KKK
Chuyew	Lewis should be wanted by FBI
Tomas Pinto	I know you dont hear this very often even Mclaren know their car is shit
Sgarky	Hearing Ricciardo s Quali reaction make me so sad because of how the race went
Amir Mursyidin	Lmao Will Smith
KoRnBulleT	I wish Will Smith taught me how to drive
Pierre Cousin	Any ideo of the music
the destroyer	He doesn t deserve this 5 time world champion I wanted to win Sebastian vettel but I m sad that he didn t win üò≠üò≠üò≠üò≠
Sathwik Atluri	Anyone else see Daniel going mad on the bike I feel so sad
Gor Qiwi	Harley talking too much for a guy who already lost the place lmao
eming 0	Ricciardo now have more DNF in this season than Bottas in his whole career Like what the hell is happening
Henry whatzal	Anyone focusing on the battle for the P3 in the championship between Kimi Bottas and Max
Antonio Bonutti	What a ridiculous kid named Hartley
Prithak Shrestha	The disappointment in Ricciardo s voice after having to retire after getting pole wa saddening
MRsebav1 `	P0Alonso P0Ricciardo
CurtisBooksMusic	That s brutal listening to Ricciardo
Mali Mali	In halloween mood some driver fear Hamilton Best fan becomes the worst fan Vettel Ragazzi Where s the grazie Bottas Valtteri it s James
GURken	Lewis finishing 4th 20 sec behind Kimi Will Smith That s how you supposed to drive
xGeoThumbs	Poor Daniel
Rubium	1 03 hearing Alonso so sad almost make me cry he deserved so much more
JustViggo 64	hahahaha ricciardo retiring again i don ‚Äô t hate daniel but i hate all those spoiled aussie who shit on Verstappen eventhough the Verstappen fan are cheering for ricciardo if he win
XoniC	Ricciardo said Gasly could take his car for the rest of the season o
Hans Knobel	wtf is with the sound quality at the end o
Zainul Hazim	Still cringing at Will Smith talking a if he could do what Ham did
Mr Random Guy	Hartley going back to his insensitive emo phase
Sem Kempkes	The Will Smith voice over wa so cringy That s how you supposed to drive my man nearly drove his tire off the fukc
LeviD15	I know you dont hear this very often so we are p1 üòÇ
Car Guy	0 43 DNFüò£
Manjunath Chatradhar	Alonso got purple in every sector because he wa first man out on track
Lukas	I feel so bad for Ric he isn t even angry about it anymore he just sound so depressed and still manages to stay professional in these kind of situation even though it the 8th time this season already
Jonathan Law	Lewis won his 5th But the happiness felt weird after I saw Daniel s situation P1 to DNF Alonso gone down a well Heart wrenching
G√∂rkem G√ºzel	That pre recorded Will Smith radio message may be the most cringest thing i have ever seen
JBaly	i didn t now will smith is in f1 üòÇ
Thirza	2 18 What an amazing conversation hahaha show that he s a pure racerüí™üèº
Uƒüur	Will Smith ‚Äô s radio comm wa cringeworthy He had nothing significant to say and he repeated the same thing over and over again for the sake being on the radio Ten year old form better sentence
Tanay Patil	Feels bad for Ricciardo
Ian Huizenga	Will Smith wa cringe tbh
Titan FX	TRIPPIN MAJOR NUTSACC
Unlucky Benny	Poor Danny man You can just hear all enthusiasm leave his voice
Ashwin Mascarenhas	Atleast Gionovazzi ha a seat for next year Hartley is bang average Marko ha gone a bit soft should ve been out mid season
BuschcamperHD	Will Smith Cringe moment of the day
Ed von Schleck	Hahaha this Will Smith quote is so awkward Love it
Huenii	yea we dont need it but it nice lmaoo im dead hahahah
Tristan van Heest	Almost Everyone is cursed in their home race Monaco Lecletc DNF Canada Stroll DNF France Ocon and Gasly DNF Great Britain Hamilton ha a collision Germany Vettel DNF Italy Ferrari with problem Mexico Perez DNF EDIT Austria Ricciardo Red Bull retirement USA Haas Magnussen DSQ and Grosjean with problem Weirdü§î
sifonick	It wa awesome to see Danial R get P1 in Q3 but the next day wa so so sad
Bastian Arcbast	Freaking W S is in there
Luuk	Thank ya
Amazing A The Dreamer	Daniel my friend I honestly wouldn t have blamed you if you wanted to swear and shout for all you re worth and you are worth so much more than all these bloody problem If I could do something to directly cheer you up I would I really would
Heli Kopteri	Damn Hartley going full savage
OLI KING	P0Alonso
Batikan Eyiboglu	Smith wa so cringe
Rohan Prasad	I feel so bad for Ricciardo Can t imagine what he s going through
bYvYkToR	Brendon is godlike he deserves to stay
Syarief Nizar	Well
CopperTFox	early squad boy
dank ramadhan	forza Ferrari
riemannx1	Alonso for life
C CStabell	0 31 LOL
Walter Haller	COOOOOLLL LOV IT
Arczan95	Hartley calling other driver amateur What an irony
Amit Kumar	Danny deserves better
Harshin Mehta	dammmm
Rendra Wisnu A.	First i guess
