emsie em	This squad's making their own name through their talent and passion (all over the world). I mean, who wouldn't want to have this kind of relationship? They're pulling each other up, heading into their goals together without letting one down. They are #SQUADGOALS
Kedebon Colim	James Reid is legendary in the making
L Mija	Come to Oakland!
Dolly Acut	â¤â¤â¤ğŸ‘ğŸ‘
Haide Aris	Love love ğŸ’‹
Klein Cabilla	â™¥â™¥â™¥â™¥
yu Yu	5:04 butta b goin mainstream
Tummie Delos Santos	Can't wait na makilala na ang mga artist ng CMM sa internationalğŸ˜ğŸ’•
archelyn	Yazzzzzz
Jnnyna Lcp	I love CMM! Myghaddd!ğŸ˜ğŸ˜ğŸ˜
ready2run2006	ğŸ‘ğŸ‘ğŸ‘
Donamil Dumasis	Im happy for james!!! He deserved all the blessings because his hard working and humble.. thank you for always inspiring me always.. that is true your my inspiration.. You and Nadine... im 28 yrs old now but i want to do more  and there is nothing impossible.. yeah..
kinda soft	Okkk this is so fucking lit
Cha Rose	Englisk paka man sila oy . ğŸ˜­ğŸ˜‚
Sofia Balaqui	Sino yung DJ? Bat ang cutee
Mayvelyn Saquiton	Wow!
Pinkeu Peach	JAMES: WHERE'S MY BABY?  NASA SINAPUPUNAN NI NADINE, HEHEH
Lyn San Joaquin	ang likot mo tlga sa stage bretito !! napaka cute mo hahahha
Geneveve Baguio	More power MMC JADINE LUVLOTS
James Tahil	ğŸ‘ğŸ‘ğŸ‘ğŸ‘ğŸ˜‰
Reign Gutierrez	Damnnn!!!ğŸ’•
Darrie Queen	I jsut discover this channel! May i know the tittle of the 1st song?
mariÃ© kaye	ğŸ’¯ğŸ’¯âŒ
Kate Kristine CostaÃ±as	Wait where's my baby? Hahaha gaon u James ha
Yu Zu	Yo Congrats CMM ğŸŠğŸŠ
Cinderella Candaza	ğŸ˜ğŸ’™
Bb. Buhangin	This is Lit! ğŸ”¥ğŸ”¥ğŸ”¥ Please upload more! Love the Careless Squad! ğŸ–¤
Nathan Hawkins	i-release nyo na kase yung On Top
zacrtzy	This song is so lit
Iloiloâ€™s Best: Original Biscocho Haus	.
Lanie Grace Carpentero	Kakilig
Rima Andriana	James has everything... That's why haters hate him because they're jealous...
Shamine Antoni	love you!
Jaded Mars	YOU DA BEST JAMES! I loveyouuuâ£ï¸â£ï¸â£ï¸
mychell malupa	â¤â¤â¤
Christina Aninayon	So lit CMM!!!! ğŸ’–ğŸ’–ğŸ’–ğŸ”¥
Mixxie Rams	CMMğŸ˜ğŸ’never been this attentive, this mixtape is amazingly cool and I never knew that I will actually love this genreğŸ’â¤
asyh mstf	Really love this! Editing is âœ”ï¸ğŸ’¯ Keep making this kind of video please. And to the Mr CEO, Congratsâ¤ï¸ we are so proud of u! Lots of love from MalaysiağŸ‡²ğŸ‡¾
lorjean iza foronda	i see my baby right thereğŸ˜ğŸ’œ
Elaine Bueno	I soooo love the vibe of this vid! If possible, I do hope na sana more vids like this pa on every gigs/ any ganaps pa from CMM! Any how, kudos to Team CMM!!! More international gigs to come!!!
my president is nadine lustre ***	We need more of this CMM.. And may I suggest you make studio versions of all the songs from the mixtape? Yung parang chill chill lang na jamming session with all the cmm artists. And Tagalog songs is a MUST I mean you're trying to reach out the international market but in order to do that you should be able to cater the Filipino masses first of course without losing the cmm formula/beat/vibe whatever you call that. Fly high cmm ğŸ™Œ
van Alex	More videos pa careless plss.
Christine Teves	Way to gooo Team Careless! â¤ğŸ‘ğŸ”¥
Ailyeen Auxillo	THE BEST..
Babydoll Rivera	ğŸ˜ğŸ˜ğŸ˜
Kimberly Estrada	ğŸ‘ğŸ‘ğŸ¤©
Jasmin Lustria	ğŸ”¥âœ¨
Eyababeee Erbin	We Careless! We Careless! GREAT VIDEO!!! Please watch everyone and let people know to watch it right here on the CMM YT channel.
Nanatruce	Love this vid Careless!!! Keep it coming!
MC Gatmen	I want that careless shirt huhuhu
camille libres	Yâ€™all deserve thaaatâ¤ï¸â¤ï¸â¤ï¸â¤ï¸
Van Buenaventura	aHhhhh this is soooo lit!!! CMM team!!!!
Arlene Dela Cruz	Congrats to the creative and hardworking peeps behind #CMM here's wishing you more success and local and international engagements
Jackline Palas	praying for CMM's success cuz they indeed deserve that ğŸ˜­ğŸ™ğŸ»ğŸ’›
Mister Gabbywaps	â¤ï¸ğŸŒ¹ğŸ¥€ğŸ’¥âœ¨âš¡ï¸ğŸŒ™
siti anisa syakira	ğŸ˜ğŸ˜ğŸ˜ğŸ˜ğŸ˜ğŸ˜
Louella Anne Gonzaga	AaaAaaaaaaaAaaAAAAAaaaA!!! ğŸ˜ğŸ˜ğŸ’–ğŸ’¯
ë¯¸ë ˆìŠ¤	*BIG THUMBS UP FOR CMM*
niko reyes	congratulations CMM ğŸ¤ŸğŸ‘ŒğŸ¤˜
Kate Hyacinth	PROUD OF YOU GUYS!! CONGRATS!! â¤â¤
MAMA MIA	James Reid = Yang Hyun Suk (YG ENT.) both are talented CEOs
Ana Marie Maghanoy	pang international ang mga talento...love u sam c...
gine deukkie	congratulations careless!
Phia Bautista	Congrats! God Bless to the team!ğŸ˜‡ğŸ˜‡
sxzy __	u make us happy too,so thank you so much!â™¥â™¥â™¥
hallowrela	Congratulations CMM!ğŸ’•ğŸ¤˜
Allaisyaa Balqis	C CA CAR CARE CAREL CARELE CARELES CARELESS CARELESS M CARELESS MU CARELESS MUS CARELESS MUSI CARELESS MUSIC CARELESS MUSIC M CARELESS MUSIC MA CARELESS MUSIC MAN CARELESS MUSIC MANI CARELESS MUSIC MANIL CARELESS MUSIC MANILA CARELESS MUSIC MANIL CARELESS MUSIC MANI CARELESS MUSIC MAN CARELESS MUSIC MA CARELESS MUSIC M CARELESS MUSIC CARELESS MUSI CARELESS MUS CARELESS MU CARELESS M CARELESS CARELES CARELE CAREL CARE CAR CA C  ğŸ”¥ğŸ”¥ğŸ”¥
just shar	Upload also your performances at different places also how do you make songs and behind the scenes
empress royalty	They always made Filipinos proud! #JaDine
Jen Carino	Swabe
Mitzi Chicano	ğŸ’œğŸ’œğŸ’œğŸ˜ğŸ’œğŸ’œğŸ’œ
jelly ace	thank you guys for sharing this ğŸ’•
Angel Lynn Ylaya	Keep rising up, Idols!! ğŸ˜˜ğŸ˜˜ğŸ˜˜
peachesncream	CONGRATS CMM! AAAAHHH ğŸ’œ
Samantha Kusain	Upload more videos, please. Specially Mr. CEO's videos ğŸ˜ğŸ˜‚ we wish for the success of CMM and its team and again, especially the CEO â¤ğŸ˜‚
yhanna_ xD	congrats team CMMğŸ˜ŠğŸ˜Š
Conner Navarro	Here before 1M views
Jeah Carmela Caasi	Congratulations Careless especially to you Kuya Jamesâ™¥ Yiieee. Waiting for more of your workğŸ˜ğŸ’“ Lovelots
Cole Sprouse Army	Congrats JaDine & Team CMM. â¤ï¸   #JadineSince2014
Cams Cabanayan	This video givin' me life ğŸ”¥ more of these pls!!! ğŸ’•
Allison Tran	Waiting for the day Careless Manila holds a world tour and comes to the USA. By the way, I'm not Pinay but Vietnamese American. Been a fan of JaDine since OTWOL days. Much love!
My Melodss	ğŸ’œğŸ’œğŸ’œ
Donna Rio	Solid edit damnnnnnnğŸ’•
Megumi Nikifrov PTBFUJOSHI	Stay Careless
Sarah Ekawati	congratulation james,sam, and kingwaw  I like your musicğŸ–’
Danny Cajes	More vids like this pleaseee!!
Haney Mae	Congratulations everyone ! Yow nailed it â¤ï¸
BumBum Reideu	Goosebumps the whole time! Proud of the success of CMM!â™¡
minSWEAG	I ENJOYED WATCHING THISğŸ˜ CAN'T WAIT FOR A BIG CONCERT HERE IN PHILIPPINES!!!!! CMM WOOOH!
Tina Banque	now this is contentğŸ’œ
Jo bell	CMM IN NEW YORK!!!
Ciarra Ebesate	Team CMM conquers the world ğŸ™Œ this is just the start âœŠ
arienne mesina	You guys are amazing! ğŸ˜ğŸ’•
Matt Almine	this is so lit <3 thank you CMM
Abby Maisog	4:42 ğŸ˜­ğŸ’œğŸ’œ
Rio Rose	â™¥ï¸â™¥ï¸â™¥ï¸
Marie David	Graveee super kilig kayo ğŸ˜
Jenny Balo	Great video editing. ğŸ‘Œ
Jerose Dalisay	Congratulations guuuuuys!!! â¤ï¸â¤ï¸
Saawiyah Maruhom	Nice and more videos of CMM please!
Rookie Manalo	CARELESS MUSIC MANILA                       IN                  MILAN!!
milarose bechaida	Wow! Vocals! It was nice to see how they enjoy what they're doing. Lovely Naddie is soo pretty inlove â™¥ oh well careless team is totally amazing!
My Wyunwoo	The squad that all talented..Sam voice nakaka inlove..
perlene enero	Congratulations to the squad ğŸ˜˜
Rai Ragas	Congrats Team CMM. ğŸ”¥ğŸ”¥ ğŸ’•ğŸ’•
Andrea Kristel Abuyo	ğŸ˜ğŸ˜ğŸ˜
Nadya Valdez	ğŸ˜ğŸ˜ğŸ˜
Mico Josh Rejuso	Tagal Kong nag abang Nito,congrats careless..james and squad...
Rio Nietes	I love you so much james and nadine..congats team CMMğŸ‘ğŸ‘ğŸ‘
Malou Manalo	ğŸ˜ğŸ˜ğŸ˜ğŸ˜ğŸ’‘ğŸ’ªğŸ’ªâ¤â¤â¤â¤â¤
Immafe Decena	The world will soon know your music, but as of now kami kami muna ğŸ˜
Myrna Hader	Thank you for sharing, I had fun watching it.
Ubeng Cmon	I love you all big time
Louisa Ardiente	I'm so proud of you james!!! ğŸ’–
Lieann Cartajenas	â¤ï¸â¤ï¸â¤ï¸
raven claud	Nakalimutan ko tuloy yung isesearch ko dahil ditooooo
Andy A.	â€œWhereâ€™s my baby?â€ -James  Wala na finish na gilingan hahahaha
Rako Super	THIS IS JUST A FIRE ğŸ”¥ğŸ”¥
Miles Away	Congrats #team cmm please keep posting video's especially behind the scenes.
Love ALR	Pilipinas ğŸ‘Œ
Anylin Estocado	Congrats Careless Music Manila
ms sali	Mga LodiğŸ˜ğŸ‘
Maria Angela Cosme	Proud â¤ï¸â¤ï¸â¤ï¸â¤ï¸â¤ï¸
Mg W. Andrade	Fudgeeee they bond with Minzy too! So proud of CMM!!! NEXT MAMA /ASIA SONG FESTIVAL !!! PINOY PRIDE! IBA PA RIN ANG ATIN! lalo na kapag sumikat yung Balenciaga song sure lit!!!!
Beatrix L	â¤ï¸â¤ï¸â¤ï¸
Antonia Kate	Love all the songs of CMM ğŸ˜ so lit ğŸ¤™ğŸ¼
Rina Teodoro	Any CMM merch?
AmeLLia Lubi	Congrats CMM family...God Bless you all..ğŸ˜˜ğŸ˜˜ more show to come local and international ğŸ™ğŸ»
Joy Padao	Congratulations ceo James and president Nadine and to the whole cmm family ..  More bless
Jayne O	ğŸ‘â¤
iâ™¥JaDineForever	Sooooo proud of you James & Nadine and the whole Careless Team!!! â™¥â™¥â™¥
Vanessa Asong	We careless! We careless! Please come to Thailand!!! ğŸ¤—
Kim Chloe De Jesus	THE TEXTS AT LAST!   CARELESS MUSIC MANILA Bring PH music around the world! So excited on where will be the next
Asher Adventures	More mamiiiii
Camille Juego	The bestğŸ’“
sb82	Congrats CMM! Such talented group. Can't wait for you to conquer the world. Super proud fan here ğŸ’œ
Marvi Purillo	Congrats careless music manila..God bless always!!!
Theraiza De Ocampo	Careless Music Manila is everything, mad talent all over!!!  ğŸ¤©
Jovelyn Pabalate	ohmygod im a fan ğŸ™‹ğŸ˜­ğŸ˜ğŸ˜˜
Hanna Rose Roque	CMM IS SO LIT!
Kaye Musume	CMM goin global! Yeah mateee
angelita urbina	Careless hoodie please ğŸ˜
Rolyn Java	Daaamn so proud of you guys! Your music needs to be heared! ğŸ”¥ğŸ”¥ğŸ”¥ ğŸ‡µğŸ‡­ğŸ‡µğŸ‡­ğŸ‡µğŸ‡­
Yasser Bacaro	More documentaries from CMM please. ğŸ˜
Georgina Villordon	Yess more vlogs bts about this wonderful team
Editha Miguel	Go go team CMM!! Hope more  events !!!! Be inspired and motivated!!
arhami rahman	Wawwww keren sekali â¤â¤ğŸ˜šğŸ˜šğŸ˜šğŸ˜š
Cynthia Cabotaje	Congrats for the SUPERB performance!!!!!!!!  LOVE IT!!!!!
Jet TV	Last part is shookt. Omg minzy ğŸ˜.  World tour na ba this ? Congrats CMM !!!
eksenemerci	This is what we called "Pinoy Pride" ğŸ˜ğŸ˜ğŸ˜
karl brondial	Congrats James, Nadine and Team CMM!!! More of this...International Performance!!!
Fumiko Shann	Lets get careless ! ğŸ˜ğŸ’•
ocelana edits	I fell in love with James Reid more. . . ğŸ’–
Juvy Llena	So proud of james! Ang confidence level nya iba din. Congrats!ğŸ˜„â˜º
Kimberly Nava	Love this ğŸ’•ğŸ’•ğŸ’• Congrats team CMM ğŸ‘ğŸ‘ğŸ‘
Siti Adillah	CCMğŸ˜ğŸ˜˜
Perlyn Hinahon	ILOVEYOU SOOOOMUCH GUYS! ğŸ’•
Joe Cillo	go bigg!!
Jericho Leonardo	LIKE FOR CMM ğŸ˜
hunnuh mazinggg	thanks cmm for uploading this. friends x music x passion. love this label!!! more music, more jamming and kewl times for these awesome people. real, legit talent... this squad is lit! congrats james, nadine, bret and sam!!
Marites Bigcas	c0ngrats team CMM jadine nd friendsâ¤ï¸â¤ï¸â¤ï¸
Marcel Irish Dato-on	omggggg iloveyouuuuu guysğŸ˜
Geneva Tamse	wait, where's my babyyyyy???
marigold kylie	OMGGGGGğŸ”¥ğŸ”¥ğŸ”¥ğŸ’œğŸ’œğŸ’œ
LEN YU	That was really lit ğŸ‘ŠğŸ’œ More power CMM ğŸ‘
Elmar Dale Bermudez	c0ngrats CMM @jadine nd friendsâ¤ï¸â¤ï¸â¤ï¸
may guia tugao	I LOVE YOUU SOO BAD Nadiee and Jayme ğŸ’–ğŸ’–ğŸ˜­ğŸ˜­
aubstacle	I feel like I'm actually there with you guys while I'm watching it. I enjoyed everything in this video!!! I am smiling all through out the video & I feel like I'm the proudest momma in the whole world aaAAaaAA :((( Congrats, CMM!!!! â¤ï¸â¤ï¸â¤ï¸  uhm  can we just talk about the quality content? it'S SO DAMN AWESOME!!! KUDOS TO LOXPROD FOR THIS AMAZING PIECE!!!
Revy Lyn	Ahhh love love this music ğŸ˜
Madelyn Santos	ğŸ’œğŸ’œ
Kim Caliag	YAAAAAAYYYYYYY
thatha novi	Hope to "Careless in Indonesia" soon ğŸ™ğŸ˜‡ "Because Indonesia So In Love With Careless" ğŸ˜ğŸ˜
Rin	Next? Indonesia. ğŸ‘ŒğŸ™„
rhen dears	Congrats CMM ğŸ˜
hazel saldivia	Woaahh!!!
Vanessa Saren	Just wow. Keep going team cmm
Jaissa Curay	Congrats CMM ğŸ˜ğŸ˜
Always SASSY	ang lalandiğŸ˜
Jaye Wolf	Hiiii! Just wanna ask something. Where can we find the lyrics of the songs in the mixtape? Thank youu
simataFM	Love from NZ ğŸ’œ
Fatima Cadiang	ğŸ‘ğŸ‘ğŸ‘
Joy Gonzales	aww this is lit!!!!!!!
Jerlyn Emboltorio	CMM ğŸ˜ğŸ˜ğŸ˜ğŸ’•ğŸ’•ğŸ’•ğŸ’œ
Jammy Bangtan	I miss your musiiiicğŸ˜¢ğŸ’•
Ines Dwisa	Congrats James, Nadine, CMM Team.. it's amazing and always Love CMM â¤ğŸ’• Sending love from Indonesia guysğŸ˜Š
joy cortez	CMM going places!
Cherry San Juan	ğŸ‘ğŸ‘ğŸ‘
salma fauziah	I love the squadğŸ˜˜
Lala Dela Cruz	A song made for love and passion with a mixture of company and friendship ğŸ˜ğŸ˜ŠGod bless. You made us always proud of you all
Karina Nunez	Bravo who did this MV! Far cry from 16B which I only watched once and never again. Keep the quality up Team CMM!
LOUIZZLLE	nice video! good job Careless! ğŸ”¥ğŸ”¥
Merly Mamalias	Wow congrtas team CMM proud fan here. ğŸ’œğŸ’œğŸ’œ
Hannah Cacay	5:18-5:21 OMG I SEE MYSELFFF AHHHHğŸ˜­ğŸ˜­ğŸ˜­ PLEASE COME BACK CARELESS TEAMMMğŸ˜­â¤ï¸ Lots of loveee guyssğŸ˜­â¤ï¸
Alexise Ruiz	Love the CARELESS Team â¤ï¸â¤ï¸â¤ï¸ More Blessings pa ğŸ™ğŸ™ğŸ™
Jenny Balasbas	I will always love you James.
Elaine Cipriano	ğŸ’œğŸ’œğŸ’œ
Ysabella Val	Daaaamn. CMM!!! ğŸ™Œ
Josephine Olino	Wowww ğŸ˜ğŸ˜ğŸ˜
Mj Payno	Jaaaaaames ğŸ˜
Shabnam Choudhury	Love from Indiaâ™¥ï¸
red manila	i love this music label, i love these legit humans, please keep creating. All of you are an inspiration. sml ğŸ’–âœ¨
Lory Gabriz	Grabeh kayo careless, whoooo galing! Congrats to the cmm team, png international ,png buong universe, goodluck and more more blessings to come. To james,bret and nadine you made jadines all proud, you made all filipinos proud ! Jadines supports you hanggang dulo.
Psalm Banasihan	Who edited/made this video??   So ganda! Very artistic!  We ğŸ’– you CMM  Keep up the fantastic works of art!  Thank you for giving us great music we all deserve.ğŸ’–
Balsy Mclelland	More videos pls... Nadine's "I Like it", and "Summer" of James & Nadine
War Machine	we careless!! :D
Shemsua Abrahman	So exicted for more of cmm nusic and tour lov u guys lov u jadine
Savannah Alexzandrea Beatrice	CMM ROME !!!!
Haize Nathalie	IT WAS LIT FAM ğŸ”¥
Sari Puspita	James ried , sam , kingwaw ILOVEYOU BOYS
Jie Flores	Careless is LITğŸ’•ğŸ’•ğŸ’•
Tina	Congrats â¤ï¸â¤ï¸â¤ï¸
Mica Pascual	We will support CMM!!!
erika mae atienza	ğŸ‘ğŸ‘ğŸ‘
kurnia rahma	proud ğŸ’™
Sukma Ayhu	Wahhh...Good Job Team CMM ğŸ™ŒğŸ™ŒğŸ‘ğŸ‘ğŸ’ƒğŸ’ƒğŸ’ƒğŸ˜
Eleona Jean Mag-aso	Nakaka proud team CMMğŸ‘ğŸ‘ğŸ˜­
Zheena Marie Berroya	super love it! ğŸ˜ğŸ˜ğŸ˜
Jeremy Sion	Pinoy pride! Talented artists, singers, song writers, producers, and team! Wow, you guys deserves everything, all of these! â¤ So proud of you James, Nadine, Bret, Sam and the rest of the team!   I Careless, We careless!
insert name	Come Thru has problematic lyrics. The man is basically blackmailing the girl to "come thru" or else he'll tell her man. First of all, that's male entitlement right there. Male entitlement is basically when a man feels like a woman owes him something because he has done this and that for that woman, this robs the woman of her independence, a woman doesn't owe that man anything just because the man feels something for her. Second, it's not "just a song" problematic ideas like this manifested in pop culture contributes to the problem. Please be mindful next time when writing lyrics and don't take things like these lightly. As a last note, I'll quote: "Women should have the unequivocal right to say no. Women should have absolute dominion over their own bodies. Women should not, as I have so many times, apologize for rejecting a man." In case you wanna read more please see: https://thebodyisnotanapology.com/magazine/we-belong-to-ourselves-on-male-entitlement-and-womens-right-to-say-no/  Thanks for listening.
megan Martin	7.10 part is that Minzy from 2ne1 Congrats guys
Nicole Andrew	I'm turning up! ğŸ¶ğŸ’–
BlckjckVIPBoiceStar1	Yay! We need more vids like this! Thanks Careless!! I wish i-upload din yung buong performance nyo or sana magkaroon ng Careless concert dito sa manila waaaaaaah!!! ğŸ˜
Cheaper Cheaper	Nakaka proud CMM
Anna Thea Magbanua	CMM you rock! ğŸ’•ğŸ’ª
Love Miracle	Thats my idol james ried.
Quira Marie Llagas	I purple youuuu ğŸ’œ
pmpkinlve 0211	Great job CMM!!  Hoping for more international gig!! ğŸ˜
saricha07	Please get Sam C. ğŸ˜­.
Meecha Toverada	Stressed reliever! Keep it up CMM! ğŸ™Œ
Exo x Bts x Blackpink	SO LIT ğŸ˜ğŸ˜ğŸ˜
Ag Beautyrose Sakamaki	Love itğŸ˜ğŸ˜ğŸ˜ğŸ˜
Nuniek Nurwendah	Good job team CMM ğŸ‘ I hope always succes for the future ğŸ™ğŸ’•
Marjiliana Garabiles	We Careless We Careless ğŸ”¥ğŸ”¥
Vherkis Muharram	I love CMM ğŸ˜
Sheynn sheyn	come too dubaiiiğŸ”¥
Angeline Joyce Alpeche	SheeeetğŸ˜
Madz Andosay	Aahhhhh WHERE TO NEXT?!!! ğŸ™Œ
Ahsi Shancai	Congrats CEO James Reid ğŸ˜‰
Allison Argent	I hope and pray that CMM will go bigger and all the artist in it will get the recognition they deserve. Seriously they're all ttractive and talented.
Mc Ft	Thanks for the upload ğŸ˜˜
kyle pensaber	ğŸ˜ğŸ˜ğŸ˜ğŸ˜ğŸ˜
JaDineKissLonaDaraGon Shipper	CMM ğŸ”¥
Veronica	Love this!
Justiine	DAMN!!!! ğŸ”¥ğŸ”¥
XASTRON	EPICCCCC!!!
Kathlene Riazonda	CMM ğŸ˜
Josefina De OmaÃ±a	ğŸ‘ğŸ‘ğŸ‘ğŸ‘ğŸ’œğŸ’•â¤ğŸ‘ğŸ‘ğŸ‘ğŸ‘ğŸ‘
Klare Montefalco	ğŸ”¥ğŸ”¥ğŸ”¥ CMM. Hoping for more videosğŸ˜˜ğŸ˜˜
Lyn Rubico	Next Australia plz! ğŸ™ğŸ»ğŸ™ğŸ»ğŸ™ğŸ»
Safit	Proud of you James!ğŸ˜
Threisure Francisco	ğŸ˜ğŸ˜ğŸ˜ğŸ˜my babbbbbyyyyyyyyyğŸ˜ğŸ˜ğŸ˜ğŸ˜
Angel Marie Melchor-Montefalco	YESSSSS ğŸ’œ
Shania Kate	nakaka hyyyyyyyype!!!!!! luv u babiezzzzz ğŸ’œ
Jeniffer Balasbas	Congrats James and to your no 1 inspiration Nadine. Always love each other.
Laila Turrovikoh	ğŸ’œğŸ’œğŸ’œğŸ’œğŸ’œ
jessabelle Flores	Congrats Team CMM ğŸ˜ ğŸ”¥ We Careless!!! ğŸ”¥ nice video high ğŸ™Œ More Videos like this soon please â˜º
wiga saya	super proud fans here ğŸ˜ğŸ˜ğŸ˜
Ramiro Catapusan	aww nice one
Aldeeaz	Because Careless Does Macau Right! Ang witty ni JamesğŸ˜‚
kginmyheart	Nice! Please keep this page active and upload more vids. Congrats CMM! Hoping for more gigs abroad.
Meeka Pioquinto	Wow CMM!! ğŸ”¥
Michael Sabilao	ANG LUPIT NG CMM.... SANA MARAMI PANG PLACE CLA MAKA PAGPERFORM.... CONGRATS TO ALL PF YOU ğŸ˜€ğŸ˜€ğŸ˜€
Carl Bacat	pang international talaga yung talent nyo no?
Norazimah Jamil	Malaysia love Careless Music Manila!!!
Giulia Martinez	love from milan italy!! please perform here too, we deserve a concert from CMMğŸ’”ğŸ’”â¤â¤.
Arlyn Llenado	WAAAHH CONGRATS CMM FAMILY!!!! ğŸ’•
Lea Marie Castillo	I super love the editing!! â¤ï¸ğŸ‘ğŸ‘ğŸ‘
JadineMovie	Congratulations James, Nadine and Team CMM!!! ğŸ”¥ğŸ”¥ğŸ”¥
lotuahofono1	#Careless ğŸ”¥â¤ï¸
Patty M	group of talented individuals. congrats to the very successful mixtape, CMM! Praying for the continuous success! Continue sharing your world class talent!
Shalmahanie Compas	BREEEEEETTTTâ¤
kate bandong	Wheres my baby ğŸ’•
JM Mendoza	ğŸ’–
Tinker Mary Notes	keeeleeeg akooo haha
Sandy Tabuclin	They upgrade like if u agree
Quinn Tuesdays	Yesssss!!!!!!!!!!!!! ğŸ˜ğŸ˜ğŸ˜ğŸ˜
Paula Reyes	And they're awttttt
