Ø³ÙˆÙ…Ø§ Ø§Ù„Ø­Ø±Ø¨ÙŠ	ğŸ’œ ğŸ’œ ğŸ’œ ğŸ’œ ğŸ’œ ğŸ’œ ğŸ’œ ğŸ’œ ğŸ’œ ğŸ’œ ğŸ’œ ğŸ’œ ğŸ’œ ğŸ’œ
Jin Jin	Like father like son
í•œë„ë¡œí…Œì•„	JinğŸ’œ
Keyza Simmer Simmer	Salanghaeyo BTS!!!!
Jessa De Jose	I seoul uğŸ’œ JinğŸ’œğŸ’œ
Alice	JiiiiiiiiiiiinğŸ˜ğŸ˜­ğŸ’ğŸ’
Tae 1jimin	ê¹€ì„ì§„ ğŸ’œ
Percy Jackson	I really want to study Korean history and try all of this, but I'm afraid people are gonna call me a koreabooğŸ˜‚ğŸ˜¤ğŸ˜­
Rouse Ramos	fantastic â™¥â™¥â™¥â™¥ i love you kim seokjin!!!ğŸ’•ğŸ’œğŸ’œ
Cecil Lim	Good one.
mimi dore	Worldwide Handsome Jin â™¥
ljoivne nijkoes	my Jin's VOICE king seok jinğŸ’– I Seoul u loveğŸ˜ğŸ˜ğŸ˜
jsrjvjj b	ğŸ’œ World Wide HandsomeğŸ’œ Jin ğŸ’œ
sunny j	My lovely world wide handsome JinğŸ’œ
ì¹˜ëª…ì¹˜ëª…í•œê²€	ì„ì§„ì´ ì§„ì§œ ì˜ìƒê²¼ë‹¤. í•œë³µì´ë‘ ì°°ë–¡ì„ğŸ’œ
Hanny Merciani	Jin you smart i love you
ì§€ìœ ì •	Everyday  SaranghaeyoğŸ’œ ì„ì§„ ğŸ’ğŸ’ğŸ’
ã“ã“ã´ã‚ˆã´ã‚ˆ	Jin is so beautiful
yooshin kim	SeokjinğŸ‘ğŸ‘ğŸ‘ğŸ‘ğŸ‘
Only Jin	ê¹€ì„ì§„ ê¹€ì„ì§„ ğŸ˜
YS L	I love jin~â™¡
Betta Ds	that's Kim Seokjin!
Ñ•Ğ¼ol Ğ²eÎ±É´	AS A JIN STAN AND A HISTORY MAJOR WITH A MINOR IN ART HISTORY IM QUAKING
ggcd	Jin is so beautiful. If Seoul is as beautiful and amazing as Jin is I want to visit it TODAY
Simone Kao	Jin is soo beautiful
Jarukan Rassiri	Which museum is that? I wanna visit seoul and live seoul again after watching this video!
ì´ë¯¸ì˜¥	7 member ì¤‘ì—ì„œ ë°œì„±ì´ ê°€ì¥ ì¢‹ì€ ì‚¬ëŒì´ jinê³¼ rmì…ë‹ˆë‹¤. Â â€˜historic Seoulâ€™ì´ë€ ì£¼ì œì™€ jinì€ ê·¸ì•¼ë§ë¡œ â€˜ì°°ë–¡â€™ì…ë‹ˆë‹¤.Â  jiní•˜ë©´ â€œEat Jin"ì¸ë° ì˜ìƒ ì£¼ì œì™€ ë©¤ë²„ì˜ ë§¤ì¹­ì´ ì˜ëª»ë˜ì—ˆë‹¤ê³  ì•„ì‰¬ì›€ì„ í† ë¡œí•œ ê¸€ì„Â ë³´ì•˜ìŠµë‹ˆë‹¤.Â  ê·¸ëŸ¬í•œ ì „ëµì€ ê¸°ì¡´ì˜ íŠ¹ì • ì´ë¯¸ì§€ë¥¼ ê³ ì°©í™”ì‹œí‚¬Â ìœ„í—˜ì´ ìˆìŠµë‹ˆë‹¤.Â ì˜ˆë¥¼ ë“¤ì–´, ì§„ì˜ ê²½ìš° â€œì´ ì¹œêµ¬ëŠ” ë¨¹ëŠ” ê²ƒ ë°–ì— ëª¨ë¥´ë„¤!â€ê°€ ë˜ì–´ë²„ë¦°ë‹¤ëŠ” ê±°ì£ .Â Â ë©¤ë²„ë§ˆë‹¤ ì•„ì§ ëœ ë³´ì—¬ì¤€ ì ì¬ëœ ì¬ëŠ¥ë“¤ì´ ë§ê¸°ë„ í•˜ì§€ë§Œ ê°€ëŠ¥í•˜ë©´ ë‹¤ì–‘í•œ ëª¨ìŠµë“¤ì„ ë³´ì—¬ì£¼ëŠ” ê²ƒì´ ë°”ëŒì§í•˜ë‹¤ê³  ë´…ë‹ˆë‹¤.Â Â  jinì€ ë…¸ë˜ë¥¼ ë¶€ë¥¼ ë•Œì˜ ë°œì„±ë„ ë°œì„±ì´ì§€ë§Œ, ë‚˜ë ˆì´ì…˜ ë°œì„± ëŠ¥ë ¥ë„Â ë§¤ìš° íƒì›”í•©ë‹ˆë‹¤. ì´ë¯¸ ë®¤ì§ë¹„ë””ì˜¤ ì† â€˜ì„ì§„â€™ì˜ ë‚˜ë ˆì´ì…˜ì„ í†µí•´ ëŠ¥ë ¥ì˜ ì¼ë‹¨ì„ ë³´ì—¬ì£¼ì—ˆì£ .Â í•˜ì§€ë§Œ ì§€ê¸ˆ ê·¸ì˜ ë°œì„±ì€ ì§€ë‚œë‚ ì— ë¹„í•  ë°”ê°€ ì•„ë‹ˆê²Œ ë°œì „í–ˆì–´ìš”.Â  ë˜í•œ ì§„ì˜ ìŒìƒ‰ì€ í–¥ìˆ˜ë‚˜Â  ì–´ë–¤ ê·¸ë¦¬ì›€ì˜ ì •ì„œ ê°™ì€ ê²ƒì„ ìê·¹í•˜ëŠ” ì•„ì£¼ ë…íŠ¹í•œ ë§¤ë ¥ì„ ì§€ë‹ˆê³  ìˆìŠµë‹ˆë‹¤.Â Â Â  ë§ì€ ì´ë“¤ì´ ê·¸ì˜ ëª©ì†Œë¦¬ë¥¼ ì‚¬ë‘í•˜ì§€ë§Œ,Â  ê·¸ ëª©ì†Œë¦¬ê°€ ê°€ì§„ ì¬ëŠ¥ì€ ê·¸ì˜ ë›°ì–´ë‚œ ë¹„ì£¼ì–¼ë¡œ ì¸í•´ ì˜¤íˆë ¤Â  ì¶©ë¶„íˆ ì¡°ëª… ë°›ì§€ ëª»í•˜ê³  ìˆë‹¤ëŠ” ìƒê°ì„ í•´ìš”.Â  Â jinì€ ë¯¸ë””ì–´ ì‹œëŒ€ì— í›Œë¥­í•œ storytellerê°€ ë  ìˆ˜ ìˆëŠ” ì¢‹ì€ ëª©ì†Œë¦¬ë¥¼ ê°€ì¡ŒìŠµë‹ˆë‹¤.Â  ì–¸ì œê³  ì‘í’ˆì„± ìˆëŠ” Documentaryì—ì„œ narrationìœ¼ë¡œ ì°¸ì—¬í•˜ëŠ” ê·¸ì˜ ëª©ì†Œë¦¬ë¥¼ ë§Œë‚  ìˆ˜ ìˆê¸°ë¥¼ í¬ë§í•©ë‹ˆë‹¤.
Lilboy Me	I Seoul u too
a mom of 7 babies	Our worldwide handsomeğŸ’œ
sejun P	I love jinğŸ’•
sarang Jin hae	I  Seoul  U ğŸ’œğŸ’œğŸ’œJin is gorgeous
BANGTAN TUBE	HIS VOICE IS SO CUTE
Veronica	ì–¼êµ´ ëª©ì†Œë¦¬ ë„ˆë¬´ ì™„ë²½í•˜ë„¤ìš”^^ ì§„ ìµœê³ 
rania kn	ì„ì§„ì´ëŠ”  ì™¸ëª¨ë§Œí¼ì´ë‚˜ ëª©ì†Œë¦¬ë„ ë„˜ ì¢‹ì€ë“¯ ì§„ì§œ ê°„ë§Œì— ì„œìš¸ ê°€ê³ ì‹¶ì–´ì§€ë„¤ğŸ˜ğŸ¤©
í”Œë£¨í† 	ë„ë ¨ë‹˜ ì§„~ í•œë³µë„ ì°¸ ì˜ ì–´ìš¸ë ¤ìš”
Michelle Ng	Historic Seoul def suits him most!!! What a sweetheart!!! ğŸ™ˆğŸ˜
yoongs_oppar_bts	yes jin represent seoul
Rosmery Navarro	SEOUL ğŸ’œğŸ’œ
day love	ë©‹ì§€ë‹¤. ê³ í’ìŠ¤ëŸ½ê³  ì•„ë¦„ë‹¤ìš´ ë¶„ìœ„ê¸°ê°€ ì§„ì´ë‘ ì˜ ì–´ìš¸ë¦¬ë„¤.ğŸ˜ğŸ’œ
ìœ ë‹¤ë‹ˆ	The intro reminds me of RJ calmly sipping his tea amidst the chaos around him ğŸ˜‚
Khaleeza Khalid	Wow.. that's art right there
BTS	ğŸ’œğŸ’œğŸ’œğŸ˜
Saranghoe_	YES I WANNA LISTEN TO YOUR SOUL JIN
xxjinn	My seokjinieeeeâ¤ï¸â¤ï¸â¤ï¸
Nurul Anggreini	KiyooooğŸ˜
uyen nguyen	â™¥ï¸â™¥ï¸â™¥ï¸â™¥ï¸ It's so great
Jenni Zhao	jinâ€†jinâ€†jin
Shilaxem _	So handsome
Scarlet ARMY	my jin
fofo kookie	Arab army love you jin ğŸ˜­ğŸ˜ğŸ˜ğŸ˜ğŸ’œ
ì˜¥íƒ„ì´	ê³ ë§ˆì›Œ ì„œìš¸ì„ í™ë³´í•´ì¤˜ì„œ..
jin jin	JinğŸ˜ğŸ˜ğŸ˜ğŸ˜ğŸ˜
chimo	Ahhhhh......Jin ğŸŒ¸ğŸ‘‘ğŸ’œ
Jinnie&Epiphany	Me encantarÃ­a tener la posibilidad de poder conocer algun dia SEOUL y parte de su historia...  SeokJin tendrÃ­a que haber  aparecido mÃ¡s... el se ve increÃ­blemente sofisticado y hermoso pero necesita mÃ¡s escenas porfavor
Stella Jo	ì§„ì§œ ë„ˆë„¤ ë„ˆë¬´ ë©‹ìˆë‹¤ ã… 
young jin	Jin ğŸ’•ğŸ’•seoul
ê¹€ì€í˜•	ì´ë²ˆ í™ë³´ ì˜ìƒ ì˜ ì°ì€ë“¯.  í•œêµ­ ë¬¸í™”ì— ìë¶€ì‹¬ì´ ëŠê»´ì§„ë‹¤.
nixkorea	wow~~
bahanu	ê²€ìˆ  ë©‹ìˆë‹¤.
ì‘¤ê¸° ì‘¤ê¸°	ì—­ì‰¬ë‚˜~  ìš°ë¦¬ ì§„ì´ëŠ” ì¡°ì‹ í•œ ì–‘ë°˜ë‹˜ì´ì—ˆì–´~ã…‹ã…‹ğŸ’œ
ì›”ì™€í•¸ì‚¬ë‘í•´	JinğŸ˜˜ğŸ˜˜ğŸ˜˜
Sunday Rose	Jinnie ğŸ˜ğŸ˜ğŸ˜ğŸ˜ğŸ˜ğŸ˜ğŸ˜ğŸ’œğŸ’œğŸ’œğŸ’œğŸ’œğŸ’œğŸ’œ
JJin RJ	Jin..love you â¤â¤â¤
fatt Mohsen	ğŸ’œğŸ’œğŸ’œğŸ’œğŸ’œğŸ’œ
ul lul	ëª©ì†Œë¦¬ë„ ë„˜ ì´ì˜ì§€ ì„ì°Œë‹ˆ
kim yuri	ê·¼ë° ì´ ë©¤ë²„ ì„œìš¸ì—ì„œ ì¼ì‹ì§‘í•˜ê³  ìˆëŠ”ë° ë˜ë ¤ ì™¸êµ­ì¸ë“¤í•œí…Œ ì¼ì‹ í™ë³´í•˜ê³  ìˆìŒ. ì´ëŸ° í™ë³´ë¬¼ ì°ì–´ì„œ ë” ì´ìƒí•´.
Just another ARMY	This is still trending in koreağŸ˜­
yunmi Kim	ì´ë¯¸ì§€ë‘ ì°°ë–¡ì´ë„¤ìš”^^ ê¸ˆë°œì´ì§„ ë©‹ì´ì§•ğŸ’œğŸ’œğŸ’œ
SeHaryu	Just like RJ, he drinks tea with such calm beauty and grace.....
Min Dada	I seoul u !! Been captured by your culture for years now and i love it so much.
asdfgh jimin	this is mf trending in my country YAS KIM SEOKJIN
Angel Plora	Wish I could see Jin in any historical drama soon jaeba...ğŸ™ğŸ™ğŸ™ğŸ™
ARMY ka	Imagining Jin in a Historical drama... atleast it came true this way :D hope to see you in  a drama soon Jin! <3
OZMM.	#37 at Korean TrendsâœŒğŸ‘
ss t	Jin voice & face is the bestğŸ’•
Bananananana	honestly one of my favorites (if not my top one) of the seoul commercials
ì•„ì¬ê°œê·¸ì•ˆí•˜ë˜ì‹œì ˆ	ë„ˆë´ í•´ë³´êµ ì‹¶ì°Œ!?
siyke kid	I love koreağŸ’œ
Music Cubscout	history and food def got me to want to visit soon aside fr BTS ofc.
Meherin Afrin Pihu	King of Seoul ğŸ¤´
jeon seokjin	ğŸ˜»ğŸ˜»ğŸ˜»ğŸ˜»
Kim Seokjin	â¤â¤â¤â¤
laurent levia	Kim SeokjinğŸ˜˜ğŸ˜ŠğŸ˜™â¤
olivia kim	Jin~~â¤ğŸ’–ğŸ’—ğŸ’ŸğŸ’ğŸ’ğŸ’œğŸ’›
ë¬¸ë¸”ë£¨	ì˜¤!!! BT21  RJ ì°¨ë§ˆì‹œëŠ” ì§¤ìˆëŠ”ë° ë˜‘ê°™ë‹¤!!!
succ jin	OUTVISUALED EVERYONE
....sh	ì„ì°Œë‹ˆ ì¡¸ê·€ ì•Œì œì´ë‘ ì¡´ë˜‘
Bunny J	I want to experience living in one of their historical houses ğŸ˜¢
Jimin Park	00:02 miren eso, no estÃ¡ para un drama histÃ³rico? dios, necesito a Jin debutando como actor tanto como respirar
kimkhue90	Proud up you, angel ğŸ€ğŸ€ğŸ€
Jenny Lee	ë‚˜ì²˜ëŸ¼ í• ë•Œ ë„ˆë¬´ ê·€ì—¬ì›Œ ì§€ë‹ˆì§€ë‹ˆì§€ë‹ˆ ã… ã… 
ìŒíŒŒí•˜ëŠ”ì•„ê¸°ìƒˆ	ê²½ê¸°ë„ ê³¼ì²œì‚¬ëŒ ã…‹ã…‹
Euphoria iminsuga	This reminds me of RJ.
Jn P	Jinâ™¥ ë„˜ì˜ì–´ìš¸ë¦¬ê³  ì´ì˜ë‹¹ ëª©ì†Œë¦¬ êµ¿êµ¿â™¥â™¥
ALLADIN Khan	my lovely jin worldwide handsome ğŸ˜ğŸ˜ğŸ˜ğŸ˜ğŸ˜ğŸ˜ğŸ˜ğŸ˜ğŸ˜ğŸ˜ğŸ˜ğŸ˜ğŸ˜ğŸ˜ğŸ˜ğŸ˜ğŸ˜ğŸ˜
jin Jin	Jin  ì˜ìƒì˜ì— ê·€ì—½ê³   ê¿€ë³´ì´ìŠ¤...  ìµœê³ ë‹¤ ì§„ì§œğŸ‘
jinë©‹	ê·¸ë˜ ì§„ì•„~ ì§„ì´ì²˜ëŸ¼ í•´ë³´ê³  ì‹¶ì–´~â™¡â™¡
ì„ì°ê³¼í•¨ê»˜ë¼ë©´	JINâ¤ï¸
ìš©í‚¹	jinğŸ˜ŠğŸ˜ŠğŸ˜ŠğŸ˜ŠğŸ˜Š
BTSíšŒì „ë¬¸	ìê¾¸ ì•Œì œì´RJê°€ ì˜¨ëŒë°©ì—ì„œ ì°¨ í•œì „ í˜¸ë¡í•˜ê³  ìˆë˜ BT21 ì• ë‹ˆê°€ ì—°ìƒë˜ì„œ ì›ƒê²Œ ë˜ë„¤ìš” ã…ã…
Yanina Gimenez	Yes yes yes
Ciao 1130	Love ğŸ’œ
ìì—°ì¸	ë‹¹ì¥ ì„œìš¸ go go~ ì§„ ì‚¬ë‘í•´ìš”â¤
ë˜ë¯¸	ë‚˜ë„ í•´ë³´ê³  ì‹¶ì–´ ì§„ì•„â£ëª©ì†Œë¦¬ ë„˜ ì¢‹ì•„ğŸ˜­
Alice Flowers	*cries* i wanna go to seoul....
Surfer and Snowboarder Jin	Jinnie in a historical drama pleathe
Arwa BTS	I am happy to tell you a thousand times less sweetâ¤ï¸â¤ï¸ğŸ’•
juno L	Worldwide handsome jinğŸ’•ğŸ’•ğŸ’•
Jessica Deias	Kim SeokjinnieğŸ’œ
Nabila Dwi P	Kim RichJin!!
ari jin	JinğŸ˜ğŸ˜
gwjin k	jin~~~ğŸ˜ƒ
hy P	ì‘ ì‘~~ ë‚˜ë„ í•´ë³´ê³ ì‹œí¬~â™¡
ì•„ë¼ë³´ë¼	ëª©ì†Œë¦¬ ë„ˆë¬´ ì¢‹ì€ê±° ì•„ë‹Œê°€ìš”ğŸ¹ğŸ’œğŸ’•
ìš°ì£¼ì™€ì¼ë“œí•¸ì„¬ì§„	ê´‘ê³ ë³´ê³  ë°”ë¡œ ì„œìš¸ ê°€ê³  ì‹¶ì€ ì¶©ë™ì´ ã…ã…ã… ì™€ìš° ì–´ë””ì„œë‚˜ ë¹›ë‚˜ëŠ” ì§„ì´ğŸ˜ğŸ˜
Jane Choi	Beautiful Jin & beautiful SeoulğŸ’–
iqbal Wafiy	Jin,,aaash ğŸ’–ğŸ’–ğŸ’–ğŸ˜
Gigi Lee	Seokjin cute! !
endless love	its trending on south korea youtube, wbk nations son in law, vocal king, official visual, actor visual, worldwide handsome, manner dol ğŸ˜ğŸ˜
You Nice, Keep Going	0:26 My heartue ğŸ’œğŸ’œğŸ’œ SeokjinğŸ˜ğŸ˜
Francys SaldaÃ±a	Jinnnnn te amooo
Moon Light	ğŸ’™ğŸ’šğŸ˜˜ğŸ’œğŸ’šğŸ’™ğŸ’œğŸ’™ğŸ’šğŸ’šğŸ’™ğŸ˜˜ğŸ’œğŸ’™ğŸ’šğŸ’œğŸ˜˜ğŸ˜˜ğŸ˜˜ğŸ˜˜ğŸ˜˜ğŸ˜˜ğŸ˜˜ğŸ˜˜
Haaru :v	Why in the end when they say I Seoul you ... It sounds like they are saying I sold you :vvvv
Alicia L	I Seoul You, Jinâ¤ï¸
Lilibeth Brendy Hidalgo Zambrano	jin esta demasiado lindo en este video , ya me enraron ganas de ir a SEUL  , pero mis monedas no alcanzan aun -.-
imen brkani	mr world wide handsome ğŸ’œğŸ’œğŸ’œ
ì„love	JinnnnnğŸ˜ğŸ˜ğŸ˜
Jiaxuan Zhao	Jin's voice at the beginning T.T
jin youarethebestofme	ëª©ì†Œë¦¬ì— ê¿€ ë°œëë‚˜ ë´..ì € ì˜ìƒê¹€ì€ ë˜ ë¬´ì—‡...ì„ì§„ì´ ì–¼êµ´ë§Œ ë´ë„ ì„¸ìƒì—ì„œ ì ¤ë¡œ ì¬ë°ŒìŒğŸ’œğŸ˜ğŸ˜˜
Crisber Medina Castillo	Quiero ir a SeÃºl ğŸ˜ğŸ˜ğŸ–¤
ì •ì†Œë¦¬	ë°©íƒ„ì´ ê¸€ë¡œë²Œ ìŠ¤íƒ€ê¸´ ìŠ¤íƒ€ì¸ê°€ë¶€ë„¤ ëŒ“ê¸€ì´ ì£„ë‹¤ ì˜ì–´ë„¤.. ì´ì˜ê²Œ ì˜ìƒê¸´ ë©¤ë²„ë„¤..
reshma vargheese	yesss jin
Crystalsnow	As an aspiring historian, I wish I had history lectures at my uni like Kim Seokjin! ğŸ™ŒğŸ¼
Sheida Mk	omgggg proud of our Jin ğŸ˜­ğŸ˜­â¤ï¸â¤ï¸â¤ï¸lovely JinnnnnğŸ˜­â¤ï¸â¤ï¸â¤ï¸â¤ï¸i love him so muuuuchğŸ˜­â¤ï¸â¤ï¸â¤ï¸kind cute handsome. the bestğŸ˜­proud of  BTSğŸ˜ğŸ˜â¤ï¸ğŸ‘
Mysterygirl7777	I want to experience this Seoul, Kim Seokjin you sold meğŸ˜ğŸ˜Š
Liliana A	Jin que  bueno la historia de seoul es muy interesante me gustan las historias antiguas â™¥â™¥â™¥
Erze Holmes	Awww algun dia irÃ©... Jin se ve perfecto y sofisticado ğŸ˜ğŸ’œ
Zeren Uykun	BTSğŸ˜ğŸ˜ğŸ˜
Karen Calisaya	Me voy a coreaa ya
young miah	ì„ì§„ì´ ëª©ì†Œë¦¬ ì¢‹ë„¤. ë°©íƒ„ ë³´ë¼í•´
Sophia K	Worldwide handsome Jin ğŸ˜
Jy	my jin~â™¡
Amy	NICE
ë¶€ë†ì„ì°Œ	ë„ˆë„ í•´ë³´ê³  ì‹­ì°Œ?!<<<<ê°œê·€ì”¹ê·€
60cmSeokjin	I love you baby Jin! Seoul is beautiful, just like you. ğŸ’œ
íƒœíƒœë³´ë¼í•´	ë°©íƒ„ ë³´ë¼í•´ ğŸ’œ
Demios Zhirvalian Althemphires	Worldwide Handsome Kim Seokjin!!
gardenia chang	I have been Seoul last monthï¼Œbut my baby jin not in Seoul that time. sad
December Jinter	How the korean history looks so interesting ğŸ‘ğŸ¼ and jin is so handsome ğŸ˜
Sophie xx	â¤ï¸â¤ï¸â¤ï¸ Jin
Kim Shin	JinğŸ’“
Hye_jin	Jinâ™¡
Sophie	ğŸ’œğŸ’œğŸ’œğŸ’œğŸ’œ
mistayrious cupcake	nation's son
Sajani Hirushika	Wow this is trending in South Koreaâ¤ï¸
ì§„ì¸ì‚¬ëŒ€ì²œëª…	ì˜¤ì‰? ì§„í•˜ë©´ ì‡ì§„ì¸ë°... ìŒì‹ìœ¼ë¡œ ë‚˜ê°”ìœ¼ë©´ ë” ì˜ì–´ìš¸ë¦¬ì§€ ì•Šì•˜ì„ê¹Œ ì‹¶ìœ¼ë„¤ìš”.. ë¬¼ë¡  ì´ê²ƒë„ ì˜ ì–´ìš¸ë¦½ë‹ˆë‹¤. ì§„ ì´ì¦ˆ ë­”ë“¤..^^ ğŸ’œ
Hope Wesley	Go bts
Thanh Mai Thá»‹ Nguyá»…n	SeokJin so sweet â¤
Daerin Kim	Suddenly my mind traveling back to RJ drinking his tea ._.
taejin child	This video just made me want to leave my own house and abandon all of my responsibilities in this damn house. I'm on my way to seoul, seokjin.
Carla Lauber	I can't wait to back to Seoul next year!! It is so beautiful!!! Already learning Hangul! Jin be my tourist guide lol!!
Aakruti Ruia	Jin is amazing! So handsome and love it! ğŸ’œ
jing Angle	jinï¼ï¼ï¼
Diana Huiza	JIN ğŸ’œğŸ’œğŸ’œğŸ’œğŸ’œğŸ’œğŸ’œ
Humaaa	I love you with all my heart
Ugne Dvar	Jin, thank you for this, now I feel very interested in Korean history! â¤ï¸ Jin, you are so handsome and I love you so much!!!! â¤ï¸â¤ï¸â¤ï¸ğŸ’–ğŸ’–ğŸ’–ğŸ’‹ğŸ’‹ğŸ’‹ğŸ’‹ğŸ’—ğŸ’—ğŸ’—ğŸ’—ğŸ˜ğŸ˜ğŸ˜˜ğŸ˜˜ğŸ˜˜ğŸ’“ğŸ’“ğŸ’ğŸ’ğŸ’
Y SuMin	RJ?
juno3548 lee	ì„¸ìƒ ë‹¨ì•„í•˜ê³  ì´ì˜ë‹¤ğŸ’œğŸ’œğŸ’œ
Army 4Ã«Î½Ã«Ñ	*Ø¹Ø§Ø§Ø§Ø§Ø§Ø§Ø§ ÙˆØ¯ÙˆÙˆÙ†ÙŠ ÙƒÙˆØ±ÙŠØ§Ø§* ğŸ˜­ğŸ’œ
juhee won	ìš°ë¦¬ ì„ì§„ì´ ì–¼êµ´ë„ ëª©ì†Œë¦¬ë„ ì„¸ê³„ íƒ‘ì´ë‹¤.
bts lovelyjin	My JinnieğŸ˜ğŸ˜
Maryam Ahmad	OMG handsome king.. Jin is my man.... I love this lil chaotic baby soo much ooh lemme protect u!!
Sanju Gurung	Jinie  ğŸ’œ
zaynxjaan	Lo amo.
krish jagiya	jinjinjaaaa
ì•„ë¦¬ìŠ¥	JINğŸ’•ğŸ’•ëª©ì†Œë¦¬ ë„ˆë¬´ì¢‹ì•„
ì¬ë¯¸ìˆëŠ” ì¹´í†¡	1ë“±
simran chawla	There's my jin and then there's history my most favorite things about life..ğŸ˜ğŸ˜ğŸ˜ğŸ˜
l'amour dessert	King Seokjin ~ I seoul(love) u I really miss hanbok JinğŸ’œğŸ’œğŸ’œ
jinnies lamp	Jinâ™¡â™¡â™¡â™¡â™¡
Sailaja Srivani	#ISEOULU
Yuui Nguyá»…n	Like father like son :(((( Jin with his son RJ OMGGGGGGGGGG
jimin sssi	jin drinking that cup of tea is so :(
JIN EPIPHANY	My love jin ğŸ˜ğŸ˜ğŸ˜
Lirio Akarui	ğŸ’–ğŸ’–ğŸ’–ğŸ’–ğŸ’–ğŸ’–ğŸ’–ğŸ’–ğŸ’–ğŸ’–ğŸ’–ğŸ’–ğŸ’–ğŸ’–ğŸ’–ğŸ’–ğŸ’–ğŸ’–ğŸ’–ğŸ’–ğŸ’–ğŸ’–ğŸ’–ğŸ’–ğŸ’–ğŸ’–ğŸ’–ğŸ’–ğŸ’–ğŸ’–
hyun jung	Jin...
jj ll	Jinnnâ¤â¤â¤
Aminah Amar	I SEOUL YOU TOO ğŸ˜˜ğŸ˜­ğŸ˜­ğŸ˜­
AYAT HASSAN	ğŸ˜ğŸ˜ğŸ˜ğŸ˜ğŸ˜ğŸ˜
Vanessa	:0 este es el que mÃ¡s me ha impresionado
Nora Virydiana Velasco Vazquez	me antojaste el te..... i love you....
sinta pramida	BeautifulğŸ’œ
syer syahirah	Seoul historic place...will be on my listing for visiting Seoul...
Carmen Cruz	Nuestro mundialmente guapo jin asiendo cerÃ¡mica asÃ­ si voy
kkoms	ì•„ ì–¼êµ´ ì§„ì§œ ë½•ì°¬ë‹¤ã…‹ã…‹ã…‹ã…‹ã…‹
Kim king	KING SEOKJINâ™¥3â™¥
HPAI Bandung	JIN and RJ enjoy the tea
Captain	0:11 damn what a man if he's not taken by seokjin then i'll take him
Kartika Maryadinata	Yash i wanna live with you Kim Seokjin Oppa ğŸ˜ğŸ˜ğŸ˜ğŸ˜ğŸ˜ğŸ˜ğŸ˜™ğŸ˜™ğŸ˜™ğŸ˜™ğŸ˜šğŸ˜šğŸ˜šğŸ˜šğŸ˜šğŸ˜š labyu to the moon and back the sunshine of my life ğŸŒ»
xxJust_Catxx	All of these videos are beautiful ; uwu ğŸ’œ
í•œí¬ë¦¬ìŠ¤íƒˆ	ì‚¬ë‘í•´ğŸ™ŠğŸ™Š
abu minhloc	Jin oppa â™¥ï¸â™¥ï¸â™¥ï¸â™¥ï¸â™¥ï¸â™¥ï¸â™¥ï¸â™¥ï¸â™¥ï¸â™¥ï¸
í—¤ìŠ¤í‹°ì•„ì§€ë‚˜	í•˜ì•„ ìš”ì¦˜ ì• êµ­í•˜ëŠ”ê±¸ë¡œëŠ” íƒ„ì´ë“¤ ë”°ë¼ì˜¬ ìê°€ ì—†ë‹¤
Min gloss	Omg
Hifa Bulut	I purple you ğŸ’œğŸ‘‘
Priya Negi	ğŸ’™ğŸ’™ğŸ’™ğŸ’™ğŸ’™
ÙƒÙŠØ¨ÙˆØ¨ÙŠÙ‡ Ù„Ù„Ù…ÙˆØª suga	Ø§Ø¬ÙŠ Ù„Ø³ÙŠÙˆÙ„  Ø¨Ø³ Ø§Ø¨Ø´Ø±Ø·    ØªØ§Ø®Ø°Ù†ÙŠ Ø¬ÙˆÙ„Ù‡  ğŸ˜ğŸ˜
are you smarter than kimseokjin	*KING SEOKJIN*
Orange Chess	Te amooooo Jin ğŸ’œğŸ’œğŸ’œğŸ’œ
Viviana MuÃ±oz	I love Jin â¤â¤â¤â¤
Meryy Flowers	Jin ğŸ˜
Purple means Trust and Love for a very long time	Historic is amazing and cool
Kim Altra	Ø¬Ø¹Ù„ Ù…Ø§ Ø­Ø¯ ÙŠØ¹Ù„Ù† ØºÙŠØ±Ùƒ
é˜¿ç±³ä»¬çš„ä¸–ç•Œå¼¹	Worldwide Handsone
Emilia Br	Seria um sonho ir a seoul? Claro que simğŸ˜
ìœ ë‚˜ì´	ğŸ’œBTSğŸ’œ
ç‹ ç‹	Baby so cutie
i love tae with kookie	Why didn't I bron in Seoul ğŸ˜­ğŸ˜­ğŸ˜­ğŸ˜­
E M	History, arts, sword-fights, and Mr. World-wide Handsome, himself? I wish I could give this more likes! â˜†â™¡â˜†
janeth janeth	seokjin i love you so much
alice christi	JIN love U
Anandita Tiara Kusmayadi	jinnnğŸ˜ğŸ˜
Wings And TEARS	Of course... I will come to visit Seoul and it's historic sites, I don't watch historic kdrama and listen to kpop for nothing.
kpop lover	Look how far we've made it ğŸ˜­ğŸ˜­â¤
lana taylor	these ads are so short tho
wonder jjk	This really suits jin
Noel	ì˜¤~ ì˜ìƒ ì£½ì¸ë‹¤~
Natalie Zardiashvili	I ğŸ’œ U
Hobi SunshineOwO	Handsome boy
Davine VX	King seok jin fits historical Seoul
Viv Angel	this is prince seokjin fight me
ruth olfi	Jin's voice is so soft to me I love it.
Lu Mar	You made the best choice!!! Indeed BTS are the best ambassadors. There are many people from other countries that want to travel to your beautiful country due BTS.
ì„œì€í¬	JinğŸ˜ğŸ¤©
hye J	ì§€ê¸ˆ ì„œìš¸ì— ìˆì–´ë§Œì„œë„ ì„œìš¸ì— ê°€ë³´ê³  ì‹¶ì–´ì§€ëŠ” ì˜ìƒì´ë„¤ìš”!!ã…ã…ã…ê·€ì—¬ìš´ ì§„ì´
IDOL-OVE MYSELF	OOF I WILL LISTEN TO YOU ALL DAY LONG
ì´í˜„ì •	íƒ„ì´ë“¤ ë°ë ¤ë‹¤ ì•„ì£¼ ë½•ì„ ë½‘ëŠ”êµ¬ë‚˜. ë½‘ì•„. ã…‹ã…‹
Sesie Mari	I SEOUL YOU KIM SEOK JIN!!!!â¤â¤â¤
Glleyce Brazilian ARMY	PrÃ­ncipe ğŸ‘‘  BR
52ì—ì¼ë¦¬ì–¸	ì§„ì²˜ëŸ¼ í•´ë³´ê³  ì‹¶ì–´ ã…
Neha Partha	0:25 I feel attacked
aariayoo â„¢	SEOUL IS REALLY BEAUTIFUL AND AMAZING
â€˜ê·œì…¸	Gosh Jin really IS worldwide handsome
LY: Answer August 24th	Ù…Ø§ ÙƒÙ†Øª Ø¨Ø¹Ø±Ù Ø§Ù†Ù‡ ÙÙŠ Ù‡ÙŠÙƒ Ø§Ù…Ø§ÙƒÙ† ÙÙŠ ÙƒÙˆØ±ÙŠØ§ !! Ø­Ù„Ùˆ ÙƒØªÙŠØ± ğŸ‘€ Ø´ÙƒØ±Ø§Ù‹  BTS ğŸ’œ
ì¼ˆë‹ˆ	ì˜¤ ì´ë²ˆ ì˜ìƒ ì •ë§ ì¢‹ë„¤ìš”ã…‹ã…‹
janes blair	JIN LOOKS REFRESHING AS ALWAYS
kazi Muimmah	If only I wasn't broke af !!ğŸ˜¢ğŸ˜¢ğŸ˜¢ğŸ˜­ğŸ˜­ğŸ˜­ğŸ˜­ don't worry one day......one day...... I will surely visit there!! Thank you BTS for introducing me to a beautiful city!! ğŸ’œâ¤ğŸ’™ğŸ’œ
shiiruj bangtan	I love historical places in SeoulğŸ˜Š
annmiracleable	JIN ğŸ˜ worldwide handsome ğŸ˜ BTS â¤
Taetae wifeu BTS A.R.M.Y	ğŸ˜ğŸ˜ğŸ˜I want to learn martial arts so much..and that mud art reminded me of RUN BTS ğŸ˜‚ğŸ˜ğŸ˜˜love you WORLDWIDE HANDSOME OPPA..Seoul is really beautifulğŸ‘ŒğŸ’œğŸ˜
Afza Mukaddam	Of course Jin had to get the 'travel back in time' advertisement. Theories creeping in...
Jeon Cooky	Take a trip down memory lane and experience Seoulâ€™s colourful and majestic past and how it so magically and collides with the present-day Seoul. Go historical in Seoul with Jin ğŸ’œ
ì œì´ ì œì´	ì§„ ëª©ì†Œë¦¬ ë„˜ ì¢‹ë‹¤..ìœ¼í—£í—£í—£í—£.... ê´‘ê³ ì—ì„œ ëŒ€ì‚¬ ë§ì´ í•´ì£¼ì„¸ìš”.. ë„˜ ì¢‹ì€ê±°..íë¯¸ ì¢‹ì€ê±°
Zweet Mansa	Give me my money right now..!!!ğŸ˜ˆğŸ™
Honey Jane Acuesta	World. Wide. Handsome..
the_girl_next_door	he looks so good ğŸ˜ğŸ˜ğŸ˜ğŸ˜ğŸ˜
ARMYS always BLINK ONCE when they see me REDVELUV	Me: *where my money at?*
oriana mendoza	Seokjin logra que miles de ARMYs quieran aprender de  la historia de Corea. Es tan hermoso ver cÃ³mo todos ellos aman tanto a su paÃ­s â¤
blue butterfly	So beautiful
IRENE SALUMU	My prince, the crown prince.
BÃ¼ÅŸra k	best historic man ever Kim Seokjin
TuÄŸba Y.	I Seul You Jin
Nabam Odang	Okay, now all the visuals are getting it one by one!!
SFHBTS, ÙƒØ§Ù†Ù‚ØªØ§Ù†	Ø¬Ø§ÙŠØªÙƒÙ… Ù‚Ø±ÙŠØ¨Ø§Ù‹ ğŸ˜‹ğŸ¤©
sasuke's side chick	I always loved korean cultures
Hggfhhvf Errgcfgf	I Love you JiN ğŸ’œ
PhÆ°Æ¡ng Anh	YÃªu tháº­t
Wish lists Three words	Yes!! I want to try just like you, Jin
Lily Cosmos	Jin â¤â¤â¤â¤â¤â¤â¤â¤â¤
Kristina Reliefia official	Kim seok jin  BTS I Seoul you
amor xJin	ğŸ˜ğŸ˜ğŸ˜
hyowhani 78	ì„ì§„ì´ëŠ” ì € ë°ì€ ë¨¸ë¦¬ë³´ë‹¤ ì§€ê¸ˆ ë¨¸ë¦¬ê°€ í›¨ ë” ì´ìœ ê±° ê°™ë‹¤ ì„ì§„ì•„ ì˜í–ˆì–´ íˆ¬ì–´ê°€ìë§ˆì ê²€ì€ë¨¸ë¦¬ë¡œ ì—¼ìƒ‰í•œ ê±°ëŠ” íƒì›”í•œ ì„ íƒì´ì•¼! ê²€ì€ ë¨¸ë¦¬ë¡œ ê³„ì† ìˆì–´ì¤˜ ê·¸ ì¡´ì˜ë¯¸ëª¨ê°€ ê²€ì€ ë¨¸ë¦¬ì¼ ë•Œ í›¨ ë” ë¹›ë‚˜^^
Emily G	Worldwide handsome Jin.. historical face ğŸ’œğŸ’œğŸ’œ
Xenia P.	Historic Seoul perfect for Seok JinğŸ’œ
Aika Mikaelson	ĞĞ°Ñˆ Ğ¼Ğ¸Ñ€Ğ¾Ğ²Ğ¾Ğ¹ ĞºÑ€Ğ°ÑĞ°Ğ²Ñ‡Ğ¸Ğº ğŸ˜ğŸ‡°ğŸ‡·ğŸ˜ğŸ‡°ğŸ‡·ğŸ‡°ğŸ‡·â¤ï¸â¤ï¸â¤ï¸â¤ï¸ğŸ™ğŸ™ğŸ™
A N N	This suits really well with seokjin:))))
H JS	so cute JINâ™¥
Iphit Hyda	I just realize v's i seoul u is used for all bts ad video ğŸ˜‚
Mimay Yoongi	I Seoul U SeokjinğŸ’œ
hui li	Jin hyungâ¤(Ó¦ï½–Ó¦ï½¡)
EN Chen	JINğŸ˜
Nandaa chh	JINğŸ’œ
Prudence Mignonette	Our gorgeous JinğŸ˜â¤â¤â¤
Roro M	Jin ğŸ’œğŸ’œğŸ’œğŸ’œğŸ’œğŸ’œğŸ’œ
ì•„ì´ìŠ¤í¬ë¦¼ë³µìˆ­ì•„ë§›	ì•„ë‹ˆ ì•Œì œì´ë‘ íŒë°•ì´ë‹¤ã…œìŠ¥ì§„ì´ìµœê³ 
Aurore Kiniali	thanks jin for Everything!
eunz_ 34	MR.WORLDWIDE HANDSOME I DARE YOU TO STOP WRECKING ME!!!!ğŸ˜¤ğŸ’œ
Jungsik park	ë°©íƒ„ì†Œë…„ë‹¨ ì§„ì´ ë“¤ë ¤ì£¼ëŠ” ì„œìš¸ì´ì•¼ê¸° ì„œìš¸ì— ì‚´ë©´ì„œë„ ê·€ê¸°ìš¸ì´ê²Œ ë˜ë„¤ìš” ê¹€ì„ì§„ ëª©ì†Œë¦¬ ì •~~ë§ ì¢‹ë‹¤
jin's wonderful dad jokes	SeokjinğŸ’œ
Maricar Romero	Jinnie looked so elegant. Worldwide handsome indeed. Will visit Korea one day. :-)
Jin forever	He,s soooooooooo handsome!!
Mimi Jiji	Seoul has saved by BTS
my lovely kim seokjin	Kim SeokjinğŸ’ğŸ’•
Worldwide JIN-tleman!	This advertisement was MADE FOR JIN! ğŸµğŸ’œğŸ‘Œ
Rayan Mohammad	Really need to thank bts for introducing me to korea i probably would never have seen this if it wasnt for them
2 hyun	Jin ğŸ˜ğŸ˜ğŸ˜ğŸ˜ğŸ˜ ğŸ’›ğŸ’™ğŸ’œğŸ’šâ¤ğŸ’—ğŸ’“ğŸ’•ğŸ’–ğŸ’ğŸ’˜ğŸ’‹
Suci Suci	Hii
NINING _	ê·¼ë° ì§„ì§œ í€„ë¦¬í‹° ì¢‹ë‹¤..
Bangtan is my everything	I would enjoy going to museums, Jin wanna go with me? ğŸ˜Š
Manshi	yessss teach me history sir
Aya Kh	ğŸ’œğŸ’œğŸ’œğŸ’œğŸ’œ
Matoki Asylum	This is so calm, it matches Seokjin perfectly
Fierly Aprilla	jin and seoul mean perfection
Jose Bleu	Jin ğŸ’œğŸ˜ğŸ’œğŸ˜ğŸ’œ
lucky	jin looks gorgeous
r. white	Seokjin so cute and beautiful ğŸ’œğŸ’œ
Exo Chenbaek	Seokjinn
SINGULARITY TAEHYUNG'S DEEP VOICE	I really do wanna try jin I really love Korean traditional houses because it looks so beautifully build the paintings and the history.
ìœ¼ëˆ„ê¹…	ë„ˆë¬´ ì˜ ì–´ìš¸ë¦°ë‹¤ã… ã… ã… ğŸ’œ
Jin CEO	seokjin
alan t	JinğŸ˜ğŸ˜ğŸ˜ğŸ˜ğŸ˜ I wanna try!!!
enteraname.	*â€So show me,â€œ â€šI seoul youâ€˜* This will be stuck in my head for a bit now.
Peanad Taetae	Jin can you tell me about history of Seoul
appletree ca	Seokjin is such a cutie!!!!!!
Alondra Springer	La elegancia y belleza de Jin â¤ï¸
Tami	cute
Nidhi Masalia	Amazing workğŸ’œ
JEE H	ì°¨ì™€ ì„ì§„ì´ë¼ë‹ˆ! ë”± ì–´ìš¸ë¼ëŠ” ì¡°í•©ì´ë‹¤â™¥ ê¹Šê³  ì€ì€í•œê²Œ! ë©‹ìˆë‹¤ğŸ’œ
Hina Bts	ğŸ’œğŸ’œğŸ’œğŸ’œğŸ’œğŸ˜ğŸ˜ğŸ˜ğŸ˜ğŸ˜
Ø«ÙˆØ«Ø§ÙŠÙ‡ ØµØ§ÙƒÙ‡	Ø§ÙˆÙˆÙˆÙˆÙˆÙ‡ Ø¬ÙŠÙ† Ø´Ù†Ùˆ Ù‡Ù„ Ø¬Ù…Ø§Ù„ ØªØ±ÙˆØ­Ù„Ùƒ ÙØ¯ÙˆØ© Ø³ÙŠØ¤ÙˆÙ„ ÙˆÙƒÙ„ Ù†Ø§Ø³Ù‡Ø§ ğŸ˜ŠğŸ˜Š
Fluttering Wings	Jin i love you â¤ï¸â¤ï¸â¤ï¸
Milton Xavier Palacios	â™¡â™¡â™¡â™¡â™¡â™¡
min yoongi	Go go go ke Korea ğŸ˜ğŸ˜ğŸ˜
athrix skye	Are there any more videos like this with the other members?
August Strindberg	Sweet and gentle Jinâœ¨âœ¨
tae army	So many things to look at
rubi cruz	La historia tambiÃ©n es una parte muy esencial por conocer ğŸ’–ğŸ’–
ryehaaan	jin got the historic cos hes the oldest? jdhdhd he should be the food theme ğŸ—¿
Moonchild	King Seokjin
Deniz Åahin	JIN JIN JINğŸ’œ
AcorÃ¡n Guerra Abad	JINğŸ‘‘ğŸ’œ
Shubha Shree	Jin..ğŸ˜˜ğŸ˜˜ğŸ’•ğŸ’•ğŸ’•
Angie Jagdewsing	THIS IS soo beautiful and calming, I kind of want to study the Korean history
love jin	ì§„ ëª©ì†Œë¦¬ ë„˜ì¡°ì•™ğŸ˜ğŸ˜ğŸ˜ğŸ˜ğŸ˜ I LOVE JIN~â¤â¤â¤â¤â¤â¤â¤â¤
kim sadg	Oh my gosh the beautiful ğŸ‘‘ JinğŸ‘‘â¤â¤â¤
ê¹€ë¯¼ì •	my  jinâ™¡ my btsâ™¡
Tsering Peden	Woaaaaah. Just like the charming Worldwide handsome.
jungbebeeh	I canâ€™t wait to be in Seoul and have my Bangtan itinerary! Whoâ€™s with me?? ğŸ˜ŠğŸ˜ŠğŸ˜Š
ì˜ˆë‹ˆì†	Jin so cuteâ™¡â™¡â™¡ ê·€ì—¬ì›Œ ì„ì°Œë‹ˆ
GÃ¼lsÃ¼m YÄ±ldÄ±z	i love you seokjin you are really worldwide handsome ğŸ’•
Looney Tunes	JinnieeeğŸ˜ğŸ˜ğŸ˜
ê³ ì¹´í˜ëª¨ì¹´	love you Jin
Happy chu	Welcome to seoul in koreağŸ‡°ğŸ‡·ğŸ‘
TATA Hyung	I came here for BTS who else did? Hehehehehehehe ğŸ˜„ğŸ˜„ğŸ˜„ğŸ˜„ğŸ˜„ğŸ˜„ğŸ˜„ğŸ˜„ğŸ˜„ğŸ’œğŸ’œğŸ’œ
veautiful_twt	Baby u did a great job ğŸ˜­ğŸ’œ
jimin-ssi _	ê¹€ì„ì§„!!!!
Tiáº¿n Pháº¡m	â¤ï¸
Tráº§n Hiáº¿u	wow I am not fan of BTS but why you are so handsome, you make me can't breathhh
ëŸ¬ë¸ŒëŸ¬ë¸Œí™”ë‹ˆ	ì™€ìš° ì˜ìƒ ë„˜ ì˜ë‚˜ì™”ì–´ìš”~~^^ ë„˜   ì´ì˜ë„¤ìš” ~ ìƒ‰ê°ë„ ë„˜ ì¢‹êµ¬ìš” ìš¸ ì§„ì´ ì–¼êµ´ì€ ì—­ì‹œ ë„˜ ì˜ìƒê²¼ë„¤ìš” ëª©ì†Œë¦¬ë„ ê¹œì°í•˜ê³  ~~í•­ìƒ  ì‘ì›í•©ë‹ˆë‹¤
Mendes Army_01	PensÃ© que el mostrarÃ­a la gastronomÃ­a :'v Fui timada ğŸ˜‚ HandsomeğŸ’›ğŸ‘‘
Linh VÅ©	I love u so muchhh JIN ahhh you are so handsomeeeeeeee
Kaity Nguyá»…n	omg so handsomeee
Daydream KTS	Que lindo :"
Jin luv	My love Jinâ¤â¤â¤
HANI Is there	Youâ€™re always my worldwide handsome ğŸ˜­
Miri BTS	Jin -> Seoul, I am coming â¤
Vian Kuti	I want to visit Korea and see BTS  go to their fanmeeting and concert and then die in peaceğŸ˜­
Marix Arroyo	TT vamos ğŸ’œğŸ‘
ìœ ë¦¬ì•„	ì§„! ì—°ê¸° ê³µë¶€í•œ í‹° ë„ˆë¬´ë‚œë‹¤~ëˆˆë¹› ì¢‹êµ¬ìš”..ë°œìŒë„ ë˜ë°•ë˜ë°• ì „ë‹¬ë ¥ ìˆêµ¬..ì™¸ëª¨ëŠ”..ì´ê±° ë­... ì§„! ë„ˆë¬´ ë‹¤ê°–ì¶˜ê±° ì•„ë‹ˆì•¼? ì–´ë”” ë¹ ì§€ëŠ” êµ¬ì„ì´ ì—†ì–´.  ë°©ë¶€ì‹¬ ìƒìŠ¹í•´ì„œ ì§€êµ¬ ë˜Ÿì„ë“¯.. ğŸ‘ğŸ’œğŸ’œğŸ’œğŸ’œ
jin park	ğŸ’“
aalishaJSatan	I want to visit Korea and go to BTS concert... Someday ğŸ˜‚ Saranghae Jin ğŸ’œğŸ’œğŸ’œ
Amarachi Nosike	Jin: Do you want to try too? Me: Too broke, but I want to try yo- I'LL STOP! Whoops.
Kizzy Von Doll	I really want to visit! Jin is fantastic ğŸ’œ
Jjang Jin	í•œêµ­ì–´ë¡œ ë§í•˜ë‹ˆ ì¢‹ë‹¤!! ë‚˜ë¼ë¥¼ ì•Œë¦¬ë ¤ë©´ ì´ë ‡ê²Œ í•´ì•¼ì§€ ê´‘ê³  ì¢‹ë„¤ìš”
Sunwoo is my bias And Seventeen is my bias group	I love Him so much â¤â¤â¤. WORLD WIDE HANDSOME, I am coming to Seoul ğŸŠ ğŸ˜ğŸ˜
Diana	Am I the only one who remembered that bts run episode when BTS were making pottery
Hope world	worldwide handsome jin
Ana Andrade	I need money, i need money!!! Brasil wants to go!  ARMYğŸ’œBTSğŸ’œARMY
Suman Pal	Thanks BTS for introducing such a beautiful and historic place..love you Jin ğŸ˜ğŸ˜ğŸ˜ğŸ˜ğŸ˜ğŸ˜˜ğŸ˜˜ğŸ˜˜ğŸ˜˜ğŸ˜˜ğŸ˜˜ğŸ˜˜ğŸ˜˜ğŸ˜˜
Alexander Pascual	Jinnnn..ğŸ˜
Loan Loan	I SEOUL U ğŸ˜ğŸ˜ğŸ˜
Strawberry Min Yoongi	This video suits him so well
dolis morales	vamonos a seoul ğŸ˜¢ğŸ˜¢ğŸ˜¢
Don't mess with our Fandom	SEOKJIN WORLDWIDE HANDSOME I LOVE YOU
BTSJin noona	We visited Seoul last summer because of you Jin and BTS. We were disappointed that the Korean tourism didnâ€™t have any BTS in their Kpop corner. We only know BTS and Lee Min Ho. Haha I made sure to tell the people there that they should have BTS. Cause they are the primary reason why we were interested in visiting Seoul
Rieka Melania Ilhami	Jin is just as aesthetic as the content! LOVE U OPPA!!!
Ngo Lam	ğŸ˜€ğŸ˜€ğŸ˜€ğŸ˜€ğŸ˜€
where is BTS	ğŸ˜­ğŸ˜­ğŸ˜­ğŸ˜­ğŸ˜­Jinnie.. I Seoul you too. ğŸ’œ ğŸ’œ ğŸ’œ ğŸ’œ
Trang Äá»—	My worldwide handsomeâ¤ï¸â¤ï¸
Anh Trang	aaaaa best
yoongin aier	So much Jin
Masked Music	Korea is finally giving them the appreciation they deserve. BTS not only represents Kpop to the outside world,but the entire country too.
Anne Siojo	Now I really wanted to go Seoul...Seokjin wait for me there~
ìŠˆê°€ë¯¼íŠ¸	*I don't to listen to your seoul, i wanna listen to your epiphany ~~*
bright hope	I hope one day visit Seoul ğŸ˜£
luana loves jhopeÂ¡!	ğŸ’œğŸ’œğŸ’œ
Risma Surya	Jinnnnnnnnnnnnn
Gucci Prince	Did they actually give historical Seoul to Jin cuz he is the oldest??!!ğŸ˜‚ğŸ˜‚ğŸ˜‚ I can't!!! *I SEOUL YOU TOO JINIE!*
Bernadette Arbues Yosa	Jinnie!!! ğŸ’œğŸ’œğŸ’œğŸ’œğŸ’œğŸ’œğŸ’œ
Aya Wu	it's suits with him . . ..!!
ë§¹ì´	ì–¸ì œë‚˜ ìµœê³ ë©‹JIN ê¹€ì„ì§„ ì„œìš¸ì´ ë³´ê³ í”„ë„¤~^^â™¡
RaineJin kim	He look so handsome here he's so fresh ğŸ˜—ğŸ˜—i love you #kimseokjin
Shibrah Rafaqat	i really wanna visit Seoul one day
jjaru	ì•„ ëª©ì†Œë¦¬ ë„ˆë¬´ ì¢‹ë‹¤ã… ã…  ì´ ì¢‹ì€ ëª©ì†Œë¦¬ì— ì´ë ‡ê²Œ ê·€ì—¬ìš°ë©´ ì–´ì°Œí•˜ë¼ê³ 
ë°©íƒ„ì†Œë…„ë‹¨love.	I love Jinâ¤
dadis aleksis	O kurde*-*
Ø¬ÙŠÙ…ÙŠÙ†ÙŠ ÙˆØ¬ÙˆØ¯ÙŠ	Ø¬ÙŠÙ† ğŸ’œğŸ’œğŸ’œğŸ’œğŸ’œ
Yeahoeyea Yeahoeyea	ğŸ’˜â¤ğŸ’–
Esraa ashraf	Worlldddwiideeee handsommmmmeğŸ’›ğŸ’›ğŸ’›ğŸ’›ğŸ’›ğŸ’›ğŸ’›ğŸ’›ğŸ’›ğŸ’›ğŸ’›ğŸ’›ğŸ’›ğŸ’›ğŸ’›ğŸ’›ğŸ’›ğŸ’›ğŸ’›ğŸ’›
Sarah Alimami	WAIT TIME TRAVEL THE THEORIES
Lily	Mr. worldwide handsome : welcome to SeoulğŸ‘€ hahaha
Monie's Dimples	ë„¤ BTSë‘ í•¨ê»˜ í•´ ë³´ê³  ì‹¶ë‹¤ê³  ã…‹ã…‹
Lily Ella	Wow! SEOUL looks AMAZING!!! Booking my holiday to Korea next yr!
songhee han	ì§„ ëª©ì†Œë¦¬ ì¢‹ìŒ
Alejandra	La Ãºnica historia que quiero saber es como te hicieron tan perfecto bebe
ã‚¼ãƒ’JAEHEE	í•œì˜¥ì§„ ì¢‹ë‹¤
vivlodia	Thank you BTS for giving me an insight of Korean culture â¤
Ximena Vazquez	Mucha Historia rica,  que lindo ğŸ˜Š
Lesly Melissa	â¤â¤â¤
hafsa malik	this man himself is national history
Mariana Cruces	Jin aren't you a piece of art
Arzamand KSJ	Yes I wanna go seoulğŸ˜˜jin oppa take me their
Faith S Park	I wanna do like JIN n RJ...
Jessi C	RJ also act like jin in BT21 drink tea ^^
Binti Rosida	why you so handsome jiinnn
Gianella CD	SEOKJINNNNğŸ’•ğŸ’•ğŸ’•ğŸ’•ğŸ’•
Love Chim chim	Worldwide handsome jin ğŸ˜ğŸ˜ğŸ˜â¤ï¸â¤ï¸â¤ï¸ğŸ‘‘ğŸ‘‘ğŸ‘‘
Je Oblianda	ğŸ’œğŸ’œğŸ’œğŸ’œğŸ’œğŸ’œğŸ’œğŸ’œğŸ’œ
It's just Rachel	Definitely fitting for Prince Seokjin! I Seoul this and I Seoul you.ğŸ’œ
Ara N.	Por ti irÃ­a hasta el fin del mundo ğŸ˜â¤ï¸
Yatogami Yuki	historic sounds suit for jin.. everlanting beauty and calm ğŸ˜­ğŸ˜­ğŸ˜­ğŸ’œğŸ’œğŸ’œğŸ’œ
Tae-Nado	Jeez, why does Seoul seem straight outta 2085?
Janica Tacderas	Seokjin fits this campaign segment well. With his soft yet sophisticated features, it really blends well with the historical theme and rich culture of Seoul ğŸ˜ğŸ’™
Anon miaw	Worldwide handsome ğŸ˜
ìµœì• ëŠ”ì¼ê³±ëª…ë‹¤	ì§„ì´ ê½ƒë¯¸ëª¨ ì‹¤í™”?ã…œã…œ ë„ˆë¬´ë©‹ì§€ì–ì•„~~~ ğŸ˜ğŸ˜
Renata Romero	Bts bts! They are the best!
infires nation	Yaaah jinğŸ’œğŸ’œ
dhepict dhestory	babe, why so gorgeous?
ncw 307	Me: Yes.  ğŸ™‹ğŸ»â€â™€ï¸
Kim Seokjinâ€™s personal servant	YYYAAAAAASSSSSSSS
Kisuna	A Jin le queda perfecta esta temÃ¡tica!!
s k	ì˜¤ ë“œë””ì–´ í•œêµ­ ì†Œí”„íŠ¸íŒŒì›Œê°€ ê°•í•´ì§€ê³ ìˆë„¤
Giang Tráº§n	You looks so profession!!!
mary rose fernandez	Korea is a beautiful country..
Christina Tráº§n	CAST HIM IN HISTORIC DRAMA!!!
ë¼ë‹ˆì§€ë‹ˆ	ëª©ì†Œë¦¬ê°€ ë…¹ëŠ”ë‹¤ğŸ¤§
Pau. CC	Kim SeokJin a.k.a worldwide handsome you know?   Quiero ir a seoul :3 ğŸ’œ #MonoIsComing
Rosa Vera Quirioz	KING Seok Jin ğŸ’•
Nadya Danielle	Thats my husband. â¤ï¸â¤ï¸â¤ï¸â¤ï¸ğŸ˜ğŸ˜ğŸ˜ğŸ˜ğŸ˜
Yuly Rojas	Solo me imagino todo esto en una cita con Ã©l ğŸ˜­
Arigato Kiss	Jin, our handsome prince
Ashiq Ali	My desire jin work in Hollywood show a romantic show as a lead by lipsing bec he don't speak eng much  Plz anyone cast him its a request but in Hollywood
Tráº§n Giang	I want to watxh Jin in historical drama so much ğŸ˜¢â¤â¤â¤
TAEKOOKğŸ˜ğŸ˜ğŸ˜	Artes marciales? Ah caray! Eso si me interesa ğŸ’œ
Kxookie	Jin is indeed _worldwide handsome_ *fite me*
ì›”ì™€í•¸	ê¹€ì„ì§„ ëª©ì†Œë¦¬ ë‹¬ë‹¬í•´ì„œ ë…¹ëŠ”ë‹¤ã… ã… ã…œã…œã…œ
Deep Ocean	Shining Kim Seokjin â¤
Maria Ali	HE IS THE LOML IJDJEISISIS THE MOST BEAUTIFUL MAN
Sin Sin	So handsomeee
SUNG FLOWER	woahğŸ˜€ I can't wait to hear more Seoul's history from you Kim Seok Jin. fighting!!
BTS' music is my drug	AAAAAAAAAAAAAAAAAAAAAAAAAAAAAAAAAAAAAAAAAAAAAAAAAAAAAAAAAAAAAAAAAAAAAAAAAAAAAAAAAAAAAAAAAAAAAAAAAAAAAAAAAAAAAAAAAAAAAAAAAAAAAAAAAAAAAAAAAAAAAAAAAAAAAAAAAAAAAAAAAAAAAAAAAAAAAAAAAAAAAAAAAAAAAAAAAAAAAAAAAAAAAAAAAAAAAAAAAAAAAAAAAAAAAAAAAAAAAAAAAAAAAAAAAAAAAAAAAAAAAAAAAAAAAAAAAAAAAAAAAAAAAAAAAAAAAAAAAAAAAAAAAAAAAAAAAAAAAAAAAAAAAAAAAAAAAAAAAAAAAAAAAAAAAAAAAAAAAAAAAAAAAAAAAAAAAAAAAAAAAAAA
Rhea May Frejas	I love you jin
Minkun Hoo	ğŸ¤—â¤ï¸
Late Choco	Hanbok suits Jin very much awww I love professor Jinnnn  ğŸ˜†â¤â¤â¤
m l	ëª©ì†Œë¦¬ ì‚¬ë‘ìŠ¤ëŸ½ë‹¤
Taetae ARMY	Sang kakak ğŸ‘ğŸ˜
Andrea estefania	I love you jinâ™¡
Ligie Jinnie	Seokjin ah you look super handsome in Hanbok ğŸ˜ğŸ˜ğŸ‘ğŸ‘ğŸ‘
leslie Alice maco jimenez	I love you Jin â¤â¤
Vale Gi Jeon	Te Amo intensamente Kim Seok Jin  ğŸ’• âœ¨
ddaengsara	I Seoul you Jin! <333
Jane Cruz	Jin always associated with time travels. Omg hyyh feels ğŸ˜‚
Umokom ytzel	IncreÃ­ble lossss amoooooooiiio
LoveYourSelfisTheAnswer !	Let's run to Seoul ğŸƒâ€â™€ï¸
Candee Tran	ğŸŒ‘ğŸŒ‘ğŸŒ‘ğŸŒ‘ğŸŒ‘ğŸŒ‘ğŸŒ‘ ğŸŒ‘ğŸŒ•ğŸŒ•ğŸŒ•ğŸŒ•ğŸŒ•ğŸŒ‘ ğŸŒ‘ğŸŒ‘ğŸŒ‘ğŸŒ•ğŸŒ‘ğŸŒ‘ğŸŒ‘ ğŸŒ‘ğŸŒ‘ğŸŒ‘ğŸŒ•ğŸŒ‘ğŸŒ‘ğŸŒ‘ ğŸŒ‘ğŸŒ•ğŸŒ‘ğŸŒ•ğŸŒ‘ğŸŒ‘ğŸŒ‘ ğŸŒ‘ğŸŒ‘ğŸŒ•ğŸŒ•ğŸŒ‘ğŸŒ‘ğŸŒ‘ ğŸŒ‘ğŸŒ‘ğŸŒ‘ğŸŒ‘ğŸŒ‘ğŸŒ‘ğŸŒ‘ ğŸŒ‘ğŸŒ•ğŸŒ•ğŸŒ•ğŸŒ•ğŸŒ•ğŸŒ‘ ğŸŒ‘ğŸŒ‘ğŸŒ‘ğŸŒ•ğŸŒ‘ğŸŒ‘ğŸŒ‘ ğŸŒ‘ğŸŒ‘ğŸŒ‘ğŸŒ•ğŸŒ‘ğŸŒ‘ğŸŒ‘ ğŸŒ‘ğŸŒ‘ğŸŒ‘ğŸŒ•ğŸŒ‘ğŸŒ‘ğŸŒ‘ ğŸŒ‘ğŸŒ•ğŸŒ•ğŸŒ•ğŸŒ•ğŸŒ•ğŸŒ‘ ğŸŒ‘ğŸŒ‘ğŸŒ‘ğŸŒ‘ğŸŒ‘ğŸŒ‘ğŸŒ‘ ğŸŒ‘ğŸŒ•ğŸŒ‘ğŸŒ‘ğŸŒ‘ğŸŒ•ğŸŒ‘ ğŸŒ‘ğŸŒ•ğŸŒ•ğŸŒ‘ğŸŒ‘ğŸŒ•ğŸŒ‘ ğŸŒ‘ğŸŒ•ğŸŒ‘ğŸŒ•ğŸŒ‘ğŸŒ•ğŸŒ‘ ğŸŒ‘ğŸŒ•ğŸŒ‘ğŸŒ‘ğŸŒ•ğŸŒ•ğŸŒ‘ ğŸŒ‘ğŸŒ•ğŸŒ‘ğŸŒ‘ğŸŒ‘ğŸŒ•ğŸŒ‘ ğŸŒ‘ğŸŒ‘ğŸŒ‘ğŸŒ‘ğŸŒ‘ğŸŒ‘ğŸŒ‘
Genesis Luna	Jin!esto es muy lindo ğŸ˜!
Elham M	ğŸ’œğŸ’œğŸ’œ
TDP GamingVN	ğŸ’œğŸ’œğŸ’œğŸ’œğŸ’œ
ë§ˆë¦¬ì—˜	I majored in social studies, so I'm interested in different cultures. I wanna see and learn about the other cultures including Korean culture. This is one of the beautiful ways of promoting it. Thank you for this! ğŸ’œ
Anime lovers	Seokjin' voice is cute
MONO	JINNIE<333
Liltaelian Youtube	CUTEEEEE JINNIEğŸ’œğŸ’œ
fatimah z.	all hail professor kim seokjin
little melody	Professor Seokjin Kim ğŸ˜ğŸ˜ğŸ˜
j jang	0:01 giving me flashbacks to that one RJ animation in a tearoom lol
kiá»u giang BÃ¹i	JIN I LOVE YOU
ven pala	ëŠìœ¼ìœ¼ìœ¼ë‚˜ã…ì•„ì•„ã…ã…ã…ì„ì§„ì˜¤ë¹ !!!!!!!!!!!!!!!!!!!!!!!!!!!!!!!!!!!!!!!!ì•„ì•…@@
Jenn R.	Ow great
Lucila PÃ©rez	Jin â¤
Alrumaili Al Dossary	My husband really likes the historic Korean drama I wish to experience this one day.
Sarhy AjjaJin	Kim seok jiiinnn, love you so much.. our worldwide handsome ğŸ˜˜ğŸ˜˜ğŸ˜˜
Khesi	âœ¨ğŸ’™ğŸ’œğŸ’šâœ¨
07 JADE	Kimseokjin ğŸ¤—ğŸ¤—ğŸ¤—ğŸ¤—ğŸ¤—ğŸ¤—
Rebeca GAG	Te Amo  JIN ğŸ˜
ssunny y	very traditional and stylish~~~ !!! awesomeâ™¡
mariisa torres	vos fuiste mi inspiraciÃ³n para conocer SeÃºl y Corea del Sur en general Jinie...â¤ï¸â¤ï¸â¤ï¸â¤ï¸
Lil Namie	I would really love to visit those historical places ğŸ˜­
Bourne Ku	To some of ARMY, this is NOT an ad for Seoul featuring BTS, BUT an ad for BTS featuring Seoul.  ^O^
Christine Grace Simpas	Wow
Nina Love	WORLDWIDE HANDSOME
ë‹ˆì•„ë§ˆ	*ÙƒÙŠÙ… Ø³ÙˆÙƒØ¬ÙŠÙ†ğŸ’œ.*
Jins Bitch	Seoul such a beautiful city ğŸ‘€also I love u jin ğŸ’™
Loba Ã‰toile	Historic Seoul seems very interesting. I would like to visit historical places and learn about Korean traditions.
Shakira diaz	He looks so good
youjin yinn	BTS KIM SEOKJIN
skywalker	Thanks BTS for introducing me to KOREA!
Zeynep Gul	Cutest baby boi ğŸ˜
TheBeginning of LoveYourself	Historical places are ğŸ˜ If I can go to Korea, that might be the first place I'll visit ğŸ˜ ì‚¬ë‘í•´ ê¹€ì„ì§„
Mel Dy	I SEOUL YOU TOO JIN, BTS, BTS, BTS
JosÃ© De JesÃºs	AlgÃºn dÃ­a estaremos por allÃ¡ ğŸ¤—ğŸ‡²ğŸ‡½ğŸ‡°ğŸ‡·
rippan dhanda	ğŸ’œ
WasuWasuSu	The history looks beautiful here
Waffle Leo	jin is so handsome
Ro j1702	Insteresting and amazing culture thanks Jin we love you
Shannon Rochon	OMG...I would LOVE to try my hand at traditional ceramics!  The beauty of traditional Kirean arts goes well with our Worldwide Handsome Jin.
ìœ¤ì§€ì›	BTS JIN â™¡â™¡â™¡â™¡
TaeHyung VH	Te amo Jin â¤â¤â¤ Ã¡ngel.
young kim	Jin  ğŸ˜ğŸ˜ğŸ’œğŸ’œğŸ’œğŸ’œ
Kerone Harrison	_Worldwide Handsome_ ğŸ’–ğŸ’œ
Lim Min-Hyun	My sons (Â´à¼àº¶ ÍœÊ– à¼àº¶ `)â™¡
Carla Nieto CastaÃ±eda	Kim Seokjin, me encantasğŸ˜ğŸ’œğŸ’œ
Yuly	ğŸ’œğŸ’œğŸ’œğŸ’œğŸ’œğŸ’œğŸ’œğŸ’œğŸ’œğŸ’œğŸ’œğŸ’œğŸ’œğŸ’œğŸ’œğŸ’œğŸ’œğŸ’œğŸ’œğŸ’œğŸ’œğŸ’œğŸ’œğŸ’œğŸ’œğŸ’œğŸ’œğŸ’œğŸ’œğŸ’œğŸ’œğŸ’œğŸ’œğŸ’œğŸ’œğŸ’œğŸ’œğŸ’œğŸ’œğŸ’œğŸ’œğŸ’œğŸ’œğŸ’œğŸ’œğŸ’œğŸ’œğŸ’œğŸ’œğŸ’œğŸ’œğŸ’œğŸ’œğŸ’œğŸ’œğŸ’œğŸ’œğŸ’œğŸ’œğŸ’œğŸ’œğŸ’œğŸ’œğŸ’œğŸ’œğŸ’œğŸ’œğŸ’œğŸ’œğŸ’œğŸ’œğŸ’œğŸ’œğŸ’œğŸ’œğŸ’œğŸ’œğŸ’œğŸ’œğŸ’œğŸ’œğŸ’œğŸ’œğŸ’œğŸ’œğŸ’œğŸ’œğŸ’œğŸ’œğŸ’œğŸ’œğŸ’œğŸ’œğŸ’œğŸ’œğŸ’œğŸ’œğŸ’œğŸ’œğŸ’œğŸ’œğŸ’œğŸ’œğŸ’œğŸ’œğŸ’œğŸ’œğŸ’œğŸ’œğŸ’œğŸ’œğŸ’œğŸ’œğŸ’œğŸ’œğŸ’œğŸ’œğŸ’œğŸ’œğŸ’œğŸ’œğŸ’œğŸ’œğŸ’œğŸ’œğŸ’œğŸ’œğŸ’œğŸ’œğŸ’œğŸ’œğŸ’œğŸ’œğŸ’œğŸ’œğŸ’œğŸ’œğŸ’œğŸ’œğŸ’œğŸ’œğŸ’œğŸ’œğŸ’œğŸ’œğŸ’œğŸ’œğŸ’œğŸ’œğŸ’œğŸ’œğŸ’œğŸ’œğŸ’œğŸ’œğŸ’œğŸ’œğŸ’œğŸ’œğŸ’œğŸ’œğŸ’œğŸ’œğŸ’œğŸ’œğŸ’œğŸ’œğŸ’œğŸ’œğŸ’œğŸ’œğŸ’œğŸ’œğŸ’œğŸ’œğŸ’œğŸ’œğŸ’œğŸ’œğŸ’œğŸ’œğŸ’œğŸ’œğŸ’œğŸ’œğŸ’œğŸ’œğŸ’œğŸ’œğŸ’œğŸ’œğŸ’œğŸ’œğŸ’œğŸ’œğŸ’œğŸ’œğŸ’œğŸ’œğŸ’œğŸ’œğŸ’œğŸ’œğŸ’œğŸ’œğŸ’œğŸ’œğŸ’œğŸ’œğŸ’œğŸ’œğŸ’œğŸ’œğŸ’œğŸ’œğŸ’œğŸ’œğŸ’œğŸ’œğŸ’œğŸ’œğŸ’œğŸ’œğŸ’œğŸ’œğŸ’œğŸ’œğŸ’œğŸ’œğŸ’œğŸ’œğŸ’œğŸ’œğŸ’œğŸ’œğŸ’œğŸ’œğŸ’œğŸ’œğŸ’œğŸ’œğŸ’œğŸ’œğŸ’œğŸ’œğŸ’œğŸ’œğŸ’œğŸ’œğŸ’œğŸ’œğŸ’œğŸ’œğŸ’œğŸ’œğŸ’œğŸ’œğŸ’œğŸ’œğŸ’œğŸ’œğŸ’œğŸ’œğŸ’œğŸ’œğŸ’œğŸ’œğŸ’œğŸ’œğŸ’œğŸ’œğŸ’œğŸ’œğŸ’œğŸ’œğŸ’œğŸ’œğŸ’œğŸ’œğŸ’œğŸ’œğŸ’œğŸ’œğŸ’œğŸ’œğŸ’œğŸ’œğŸ’œğŸ’œğŸ’œğŸ’œğŸ’œğŸ’œğŸ’œğŸ’œğŸ’œğŸ’œğŸ’œğŸ’œğŸ’œğŸ’œğŸ’œğŸ’œğŸ’œğŸ’œğŸ’œğŸ’œğŸ’œğŸ’œğŸ’œğŸ’œğŸ’œğŸ’œğŸ’œğŸ’œğŸ’œğŸ’œğŸ’œğŸ’œğŸ’œğŸ’œğŸ’œğŸ’œğŸ’œğŸ’œğŸ’œğŸ’œğŸ’œğŸ’œğŸ’œğŸ’œğŸ’œğŸ’œğŸ’œğŸ’œğŸ’œğŸ’œğŸ’œğŸ’œğŸ’œğŸ’œğŸ’œğŸ’œğŸ’œğŸ’œğŸ’œğŸ’œğŸ’œğŸ’œğŸ’œğŸ’œğŸ’œğŸ’œğŸ’œğŸ’œğŸ’œğŸ’œğŸ’œğŸ’œğŸ’œğŸ’œğŸ’œğŸ’œğŸ’œğŸ’œğŸ’œğŸ’œğŸ’œğŸ’œğŸ’œğŸ’œğŸ’œğŸ’œğŸ’œğŸ’œğŸ’œğŸ’œğŸ’œğŸ’œğŸ’œğŸ’œğŸ’œğŸ’œğŸ’œğŸ’œğŸ’œğŸ’œğŸ’œğŸ’œğŸ’œğŸ’œğŸ’œğŸ’œğŸ’œğŸ’œğŸ’œğŸ’œğŸ’œğŸ’œğŸ’œğŸ’œğŸ’œğŸ’œğŸ’œğŸ’œğŸ’œğŸ’œğŸ’œğŸ’œğŸ’œğŸ’œğŸ’œğŸ’œğŸ’œğŸ’œğŸ’œğŸ’œğŸ’œğŸ’œğŸ’œğŸ’œğŸ’œğŸ’œğŸ’œğŸ’œğŸ’œğŸ’œğŸ’œğŸ’œğŸ’œğŸ’œğŸ’œğŸ’œğŸ’œğŸ’œğŸ’œğŸ’œğŸ’œğŸ’œğŸ’œğŸ’œğŸ’œğŸ’œğŸ’œğŸ’œğŸ’œğŸ’œğŸ’œğŸ’œğŸ’œğŸ’œğŸ’œğŸ’œğŸ’œğŸ’œğŸ’œğŸ’œğŸ’œğŸ’œğŸ’œğŸ’œğŸ’œğŸ’œğŸ’œğŸ’œğŸ’œğŸ’œğŸ’œğŸ’œğŸ’œğŸ’œğŸ’œğŸ’œğŸ’œğŸ’œğŸ’œğŸ’œğŸ’œğŸ’œğŸ’œğŸ’œğŸ’œğŸ’œğŸ’œğŸ’œğŸ’œğŸ’œğŸ’œğŸ’œğŸ’œğŸ’œğŸ’œğŸ’œğŸ’œğŸ’œğŸ’œğŸ’œğŸ’œğŸ’œğŸ’œğŸ’œğŸ’œğŸ’œğŸ’œğŸ’œğŸ’œğŸ’œğŸ’œğŸ’œğŸ’œğŸ’œğŸ’œğŸ’œğŸ’œğŸ’œğŸ’œğŸ’œğŸ’œğŸ’œğŸ’œğŸ’œğŸ’œğŸ’œğŸ’œğŸ’œğŸ’œğŸ’œğŸ’œğŸ’œğŸ’œğŸ’œğŸ’œğŸ’œğŸ’œğŸ’œğŸ’œğŸ’œğŸ’œğŸ’œğŸ’œğŸ’œğŸ’œğŸ’œğŸ’œğŸ’œğŸ’œğŸ’œğŸ’œğŸ’œğŸ’œğŸ’œğŸ’œğŸ’œğŸ’œğŸ’œğŸ’œğŸ’œğŸ’œğŸ’œğŸ’œğŸ’œğŸ’œğŸ’œğŸ’œğŸ’œğŸ’œğŸ’œğŸ’œğŸ’œğŸ’œğŸ’œğŸ’œğŸ’œğŸ’œğŸ’œğŸ’œğŸ’œğŸ’œğŸ’œğŸ’œğŸ’œğŸ’œğŸ’œğŸ’œğŸ’œğŸ’œğŸ’œğŸ’œğŸ’œğŸ’œğŸ’œğŸ’œğŸ’œğŸ’œğŸ’œğŸ’œğŸ’œğŸ’œğŸ’œğŸ’œğŸ’œğŸ’œğŸ’œğŸ’œğŸ’œğŸ’œğŸ’œğŸ’œğŸ’œğŸ’œğŸ’œğŸ’œğŸ’œğŸ’œğŸ’œğŸ’œğŸ’œğŸ’œğŸ’œğŸ’œğŸ’œğŸ’œğŸ’œğŸ’œğŸ’œğŸ’œğŸ’œğŸ’œğŸ’œğŸ’œğŸ’œğŸ’œğŸ’œğŸ’œğŸ’œğŸ’œğŸ’œğŸ’œğŸ’œğŸ’œğŸ’œğŸ’œğŸ’œğŸ’œğŸ’œğŸ’œğŸ’œğŸ’œğŸ’œğŸ’œğŸ’œğŸ’œğŸ’œğŸ’œğŸ’œğŸ’œğŸ’œğŸ’œğŸ’œğŸ’œğŸ’œğŸ’œğŸ’œğŸ’œğŸ’œğŸ’œğŸ’œğŸ’œğŸ’œğŸ’œğŸ’œğŸ’œğŸ’œğŸ’œğŸ’œğŸ’œğŸ’œğŸ’œğŸ’œğŸ’œğŸ’œğŸ’œğŸ’œğŸ’œğŸ’œğŸ’œğŸ’œğŸ’œğŸ’œğŸ’œğŸ’œğŸ’œğŸ’œğŸ’œğŸ’œğŸ’œğŸ’œğŸ’œğŸ’œğŸ’œğŸ’œğŸ’œğŸ’œğŸ’œğŸ’œğŸ’œğŸ’œğŸ’œğŸ’œğŸ’œğŸ’œğŸ’œğŸ’œğŸ’œğŸ’œğŸ’œğŸ’œğŸ’œğŸ’œğŸ’œ
Stefany Love Jungkook	Jin siempre atacÃ¡ndome con su BELLEZA
sopy so	Jin  ğŸ’œğŸ˜ğŸ˜š
Simone Fagundes	Interessante! Adorei a questÃ£o histÃ³rica/cultural! Me interessei!
Karen Dominguez	SEOOOOOOOOOOOOOOK JINâœ¨ğŸ˜ğŸ˜ğŸ˜ğŸ˜ğŸ˜ğŸ˜ŠğŸ˜ğŸ˜ŠğŸ˜ŠğŸ˜âœ¨ğŸ˜ğŸ˜ğŸ˜âœ¨ğŸ˜ğŸ˜ğŸ˜ğŸ˜ğŸ˜ğŸ˜ğŸ˜ğŸ˜ğŸ˜
Hadrian Dias	This concept can be a good example for other big cities in promoting tourism.
Sumi	Why is Jin so cute
tanniejoinedBT21	loving SK because of BTS
BTS ARMY	OUR *WORLD WIDE HANDSOME* OUR WEIRD *JIN* WE FOUND U LUV UğŸ’œ
Huyá»n Nguyá»…n Thá»‹ Thanh	I wan to go to Korea right now Really!  ğŸ˜ğŸ˜ğŸ˜ğŸ˜ğŸ˜ğŸ˜ğŸ˜
hyunju kang	ìš°ë¦¬ì™•ìë‹˜â™¥â™¥â™¥
MARIA SHIN	Jin worldwide handsome, you know? Te amo demasiadoğŸ’–ğŸ’–ğŸ’–ğŸ’–ğŸ’•ğŸ’–ğŸ’•ğŸ’–ğŸ’•ğŸ’œ
beth wor	Jin:Do you want to try too? Me:With you? Of course!
Saya Dearg Due	Wow la cultura, el Folklor y color de Corea carajo ğŸ’˜ğŸ‘ Jin es excelente I PURPLE U ğŸ’œ
CJ :3	Jujuju Worldwide Handsome :3
janny as	ğŸ˜˜ğŸ˜˜ğŸ˜˜
NicoL !!	HERMOSOğŸ˜ğŸ’–ğŸ˜ğŸ’–ğŸ˜ğŸ’–ğŸ¤—ğŸ¤—ğŸ’–ğŸ˜ğŸ’–ğŸ˜ğŸ’–
Marina Pessanha	O jin Ã© tÃ£o encantador, me pergunto se ele Ã© realmente realğŸ‡§ğŸ‡·ğŸ’“ğŸ˜­ğŸ’“ğŸ’“ğŸ’•ğŸ’•ğŸ’•ğŸ’•ğŸ’—ğŸ’˜ğŸ’“ğŸ’
Ã Phan	ğŸ’œ
ê¾¹ê¾¹ì•„	ë´‰5ê°œ ì €ê±° ì´ë¦„ ë­ë”ë¼ã… ã… ã… 
ODD	í•´ë³´ê³ ì‹¶ì°Œ! >_<  ã…‹ã…‹ã…‹ ì ¤í°í˜• ì ¤ê·€ì—¬ì›€.
YESISCA YN	I wish I can go to Seoul and enjoy its histories.ğŸ’œğŸ’œ
Dua'	Wow! didn't think the historical part would be the most interesting! Will be definitely among the things I'll check if I ever visit soul  in the near future
Ratih Prima R	Real Worldwide Handsome!   I Seoul You ğŸ˜˜ğŸ˜˜
Long San	Could someone tell me if Jin's back blond ? ğŸ˜±
pardon	0:17 it reminds me of that one bts episode where they made pottery for each other
Zemi T	Wow
Rikki Mei Lising	King
Nell Park	JinğŸ’œğŸ’œ handsome
Reggie K.	Besides Seokjin looking extremely cute... BRO! Look at all of this amazing art and culture! It's beautiful!
YehetYouGotNoJamskaepsong	Such a rich history ğŸ‘
Jiminliked	JIIIIIIIIIIIIIN
BTS Noona	i'll visit Seoul soonest - thank you Jin
Rima Santika	I dont know why, but Seokjin Kim looks so hotâ™¨
Cindy Martinez	Kim Seokjinâ£ï¸#LiveSeoulLikeBTSDoes #LiveSeoulLikeIDo
NicolXD	:0000
anty agustiany	Jin x Army ğŸ’œ
judit rodriguez soto	0:14 Quiero visitar ese lugar
Rosy Stha	Go go kim seokjin!!! â¤â¤â¤
oh okay	Aiyo oppa so handsome ğŸ˜ğŸ˜ğŸ˜ğŸ˜ğŸ˜ğŸ˜ğŸ˜ğŸ˜
21ë‹¤	ì„ì§„ì•„ ì˜· ë„ˆë¬´ ì˜ì–´ìš¸ë¦°ë‹¤ã… ã… ã… ã… 
Andrea Huaman	Live in Seoul like I do ğŸ’œğŸ’œğŸ’œğŸ’œ
Aline Regina De Souza	Lindo um prÃ­ncipe coreano !!!  Kim Seokjin is a Prince!!!  ğŸ’œğŸ’œğŸ’œğŸ’œğŸ’œğŸ’œğŸ’œğŸ’œğŸ’œğŸ’œğŸ’œğŸ’œ
Ingridt Huacho	Por ti jin me gustarÃ­a ir a ese hermosos lugares
JUNG KOOK	Jin ğŸ˜ğŸ’œ su cultura es fantastica ğŸ˜ŠğŸ‘ğŸ’•ğŸ’œğŸ’–ğŸ’œ
Le jindary	If jin was my history teacher will never sleep in class and never skip class
Girl Of NamJoon	JIIIIN MÃ‰XICO TE AMAğŸ’œ
Andrea Y	JIN: Do you want to try too? Me: with you? *of* *course*
Sugamyonlysenpai S2	Meu prÃ­ncipe.
CB C	I love seokjin Worldwide handsomeğŸ˜
Amor Fati Bangtan.	JinğŸ’œ. I love everything that has to do with history!
BillyHali	My baby â¤â¤
Barbara	Seoul looks like a great place to visit!! Thanks Jin
Army Best	Ooooow bebÃ© hermoso te amo , me encanta aprender cada vez mÃ¡s sobre SeÃºl ğŸ˜
Yami Ramirez	Hermosoooo!!! <3
Sunshine BTS	I seoul you tooğŸ’œğŸ’œ
Zoya Haider	Woo this is so amazingğŸ˜ğŸ’œ
Tanne Budiatma	Yess i seoul you Kim Soekjin ğŸ’•
Lisbeth UT	Jinnie ğŸ’•
nathalie_ xiv	Being the eldest means he's incharge of history lmao
BTs ARMY	Jinâ™¥
Amandi Vishwa	KING SEOKJIN!
happy k	I Seoul U. I ğŸ’œ Jin!!!
SÃ¡ Army	JINâ™¥ï¸ğŸ‘‘
Sabrina Ayunani	I Seoul u
No me Llamo	â™¥â™¥â™¥
s un	ì§„  ğŸ’œğŸ’œğŸ’œğŸ’œğŸ’œğŸ’œğŸ’œ
BTS MyLife	I really love South Korea and its culture...ğŸ‡°ğŸ‡·ğŸ‡°ğŸ‡·ğŸ‡°ğŸ‡·ğŸ‡°ğŸ‡·ğŸ˜˜
Akane Apples	The pottery reminds me of their Run BTS episode, that was so much fun!! ğŸ˜‚ğŸ’œğŸ’œğŸ’œ
moonchild0405	ì° â¤
Liliane NegrÃ£o	Seoul ğŸ’œ
Mariam Bts	ğŸ’œğŸ’œğŸ’œğŸ’œğŸ’œğŸ’œ
Montse  PeÃ±a	I love you, Jin.
caramelmacchiato96's	I love you, worldwide handsome.
BTS's One of Army Rai	JINNNNN ğŸ’œ
tata Taetaq	Kim seokjin : historical seoul
Yoongles Mochii	I seoul you too Jinnie
TaeKook's Noona	Yes Jin, I want to! ğŸ˜ğŸ˜ğŸ˜
Rubab Naz	this suits with jin's sophisticated and elegant nature
GreenTeaTM	If Jin was my History teacher I would never skip class
FlÃ¡via Francis	Kim Seokjin I love you ğŸ˜
ferchichi houdaxBTS	JinğŸ’œ
Nomi	SEOK JIN AKSIXKX
Evelyn Denise	Al toque roque
j kelly	JINğŸ’œğŸ’œğŸ’œMY HEARTâ¤
Jeon Jungkook	So much history ğŸ’œ
p p	ğŸ’œ
Not the real RJ	the love of my life inviting me to seoul, what should i say? YES SIR !!
terry jin	I love jin  i love seoul.
Stephan Denaer	EAT JIN BABYYYY I LOVE YOU SO MUCH CAN I KISS YOU
BTS ARMY L.S.	JinğŸ˜
Mango Orange	This reminds me of RJâ€™s tea ğŸµ ceremony...
strong fetus is jungkook but i am an ot7	Oh wow ğŸ™.... I want... To go ğŸ’œ
R M	Legend
King Seokjin	SEOKJINNIE
Clo Chu	Goshhhh so beautifuuuul
Sandy TaeTae	Every ARMYs dream is to go to Korea..hopefully one days guysğŸ¤ğŸ¾ğŸ¤ğŸ¾
Yuliana B	beautiful
Cynthia Laureta	Suits Jin to a T. Good thing they didn't include a clip of him doing pottery. :)
Bella Zhinin	#JIN  #WorldwideHandsome  â¤ My love ğŸ˜ My boy ğŸ’• Eres perfecto ğŸ˜š
Hye Won Park	ì„ì§„ì´ê°€ ë‹¬ë ¤ë¼ ë°©íƒ„ì—ì„œ ë§Œë“¤ì—ˆë˜ ìì•„ìˆëŠ” ë„ìê¸°ê°€ ìƒê°ë‚¨ã…‹ã…‹
ARMY Jimin	ğŸ’œğŸ’œğŸ’œ
mary armyarmy	Woow It looks so beautiful!!
Alexandra Hern	Seoul... i want to experience everything it has to offer!ğŸ’œ
Emy Kim	Jin ğŸ’œğŸ’œ so beautiful
mark tuan can't relate	I seoul U, Jin. ğŸ’¯ğŸ’—
Maryjane Noriega	Jin
ARMY & BTS	WORLD WIDE HANDSOME REPRESENTING SEOULğŸ˜ğŸ˜ğŸ’œğŸ’œâ™¥ï¸â™¥ï¸ğŸ˜˜ğŸ˜˜
Emely M	JIN!! I LOVE U ğŸ’•ğŸ’•ğŸ’•
aimfineyoongi _	Seokjin i seoul you worldwide handsome
Ariana Ramos Vergara	Cuteeeee â¤ï¸
DChile! :D	Wowww this is like a movie!!! And Jin is a Prince ğŸ¤¤ğŸ˜âœ¨ğŸ’–âœ¨
Yara Alves BTS alves	â¤â¤â¤â¤â¤ğŸ‡§ğŸ‡·ğŸ‡§ğŸ‡·ğŸ‡§ğŸ‡·ğŸ‡§ğŸ‡·ğŸ‡§ğŸ‡·
Dulce Yoongisshi	Wow, is amazing ğŸ’•
susan yhoselin	IGUAL QUE RJ :D MI WORLWIDE HANDSOME
Ashley Epps	Excellent ğŸ‘ğŸ‘ğŸ‘ğŸ‘
sugasweetv	Hi guys~~it would be great if you can check out my new mvğŸ’•ğŸ’œ â€œIâ€™m fineâ€
skyup sin	ëª©ì†Œë¦¬ ë„ˆë¬´ ì¢‹ë‹¤ ì„œìš¸êµ¬ê²½í•˜ëŸ¬ ê¼­ê°ˆë„ì•¼ ì„œìš¸ê°€ê³ ì‹¶ì–´ ì§„ì´ì²˜ëŸ¼
Agustinaxa x	Interesting
Jenny Monroe	I LOVE YOU JIN
V	This suits Jin so well! I love it so much! ğŸ‘ğŸ»â¤ğŸ’œğŸ˜Š
Griselda MartÃ­nez	Ya me convenciste Jin... ahora lo Ãºnico que me falta es dinero :v
pied piper	ğŸ’œğŸ’œğŸ’œğŸ’œğŸ’œğŸ’œ
Jennifer Rivera	It looks interesting!!
Gabriela Cristovan Lopes	Minha vontade de ir pra Seoul sÃ³ aumentou meu bebÃª â¤
yuyun ayuni	I seoul u JinğŸ’™
ì—°ì£¼	ğŸ’œğŸ’œğŸ’œğŸ’œğŸ’œğŸ’œ
Mariana RamÃ­rez	King Seokjin. ğŸ’œ
Hanna Purplelove	You Seoul me Jin....ğŸ˜‚ğŸ’œğŸ’œğŸ’œ Good luck ğŸ™ I . SEOUL .U ğŸ’œ
Nancy Soberanis	ğŸ‘ğŸ’œğŸ‘ğŸ’œğŸ‘ğŸ’œğŸ‘ğŸ’œğŸ‘ğŸ’œğŸ‘ğŸ’œğŸ‡¬ğŸ‡¹ğŸ‡¬ğŸ‡¹ğŸ‡¬ğŸ‡¹ğŸ‡¬ğŸ‡¹ğŸ‡¬ğŸ‡¹ğŸ‡¬ğŸ‡¹ğŸ‡¬ğŸ‡¹ğŸ‡¬ğŸ‡¹ğŸ‡¬ğŸ‡¹ğŸ‡¬ğŸ‡¹ğŸ‡¬ğŸ‡¹ğŸ‡¬ğŸ‡¹ me gusta la cultura koreana love
Rachel_ RosÃ©	WOOOW. A HISTORIC PRINCE.
se jeong kim	i love you jin~~â¤ï¸â¤ï¸â¤ï¸â¤ï¸
InÃ©s MartÃ­nez	I love this man so much.
anyil dominguez	Belleza
Wilyanne Monique	Quero conhecer de perto a riqueza de Seoul
Tine P	This fits you so well Seokjin-ah! Saranghae!
nochu mochi	SEOKJIN NATION WHERE YOU ALL AT!?!??!!!!!
jess JBTS	Itâ€™s interestingğŸ™ŒğŸ¼ğŸ’œ
Hilda Ortega	So beautiful ğŸ’œ
LR	I would really recommend visiting the National Museum of Korea. It's huge and really fascinating to see so much history preserved. I think I spent 3 hours there exploring it was so much fun.
magda uvu	SEOKJINNIE ğŸ’œğŸ’œğŸ’œğŸ’œ
Lovely BTSfan	I love this. Absolutely beautiful history. Ah~ I want to visit Seoul even more now.  And the worldwide handsome ambassador is completely beautiful inside and out!
L o R	Kim SeokJin with the history and culture of Seoul...perfection! ğŸ˜˜
Haislane Moreira	Que lindo, sou apaixonada por Seul #BR
Wanudya Lightwood-Bane	Everything is perfect until 0:18 reminds you of BTS doing chaotic pottery in Run BTS.
BTS HAPPY I AM HAPPY TOO BTS SONG MY HEALING PILLS	I love history culture ğŸ˜ğŸ˜ğŸ˜ğŸ˜ğŸ˜ğŸ˜ my Jin ğŸ˜ğŸ˜ğŸ˜ğŸ˜
molly dariuss	Iâ€™d loved to explore all those cool places
dumbo popo	I SEOUL SEOKJIN ğŸ˜ğŸ˜
ì‹ ì¢…ìˆœ	êº„ì•„ì•„ì•„ì•…~!!! ëª©ì†Œë¦¬ë„ ë„ˆë¬´ ì¢‹ì•„. ã…œã… ã… 
C Suh	ê¹€ì„ì§„ ì‚¬ê·¹ì— ìºìŠ¤íŒ… í•´ì£¼ì„¸ìš”. ìš°ë¦¬ ì§„ì˜¤ë¹  ì—°ê¸°ë„ ì˜í•˜ê³ , ì™„ì „ ì‚¬ê·¹ ì´ë‘ ì°°ë–¡ê¶í•©!!
Love yourself: final	RJ = JIN c:
Daniela Aguilar	Oh cuteğŸ’œ
RocÃ­o ;	TE RE AMOOOO
Ivan Veliz	AMAZINGğŸ¤¯ğŸ’—
hobihoping	Ugh yes, Jin, you look so amazing! And I definitely wanna see the sophisticated and rich history of Seoul!
Rosmery Geraldino	ğŸ’œğŸ’œğŸ’œğŸ’œğŸ’œğŸ’œğŸ’œğŸ’œğŸ’œğŸ’œğŸ’œ
Nora Oliva	TE AMOOOO JIIIINNNğŸ˜˜ğŸ˜˜ğŸ˜˜ğŸ˜˜ğŸ˜˜ğŸ’œğŸ’œğŸ’œğŸ’œğŸ’œğŸ’œğŸ’œğŸ’œ
Ayu Lestari96	Go get tickets and fly to Seoul ğŸ˜ŠğŸ˜ŠğŸ˜Š
ygstanthatstansbts	a prince.
L a r i	QUE LINDOOOOOOO SEOKJINNNNN
osuka al	Seoul is so beautifullllllll, like jin ğŸ˜ğŸ˜
riima M	Jin-ahhhh I'll come to Seoul to meet you â¤ï¸â¤ï¸â¤ï¸
hoseok's cute elf ears	he's so cute oh my GOD :(
90xm	king seokjin invented the world
Giant Kookie	I love this!
Alexassandra D L Cruz	Jin Jin Jin te amo
jianzui	I love it so much ğŸ’œ
pocaari	king
ana alba	Amazing ğŸ’ğŸ’ğŸ’
Mrs Jeon97	ğŸ˜ğŸ˜ğŸ˜
Hye Lee	ê·€ì—¬ì›Œ ì„ì§„ì´ ã… ã… ã… ã… 
Yessenia A. Bahamondes Parra	the vocal god!! yes!
Amal ARMY	Ø§Ø­Ø­Ø¨ Ø¬ÙŠÙ†ÙŠ ÙˆØ³ÙŠÙˆÙ„ Ù…Ø¹Ùƒ ÙŠØ§Ø´ÙŠØ® ğŸ˜ğŸ˜ğŸ˜ğŸ˜
Ui jeonggg	I really love these historical places and cultures! Thanks BTS for introducing me to KOREA!
Sherine Bilal	i love you jinğŸ’œğŸ’œğŸ’œğŸ’œ
Mel Ack	Worldwide handsome ğŸ˜˜
Claudia Yana	Tan bello todo
SHARna loves lilseok	This suit jin so well. Like that polite royal vibe...
Belen Salazar	Lov u
Gabriela Leyton	Lo ame ğŸ˜ğŸ˜ğŸ˜
í–„ë§ˆìŠ¤í„°	ê·€ì—¬ì›Œ ã… ã… ã… ã… ã… ã… ã… ã… ã… ã… ã…  ê¸ˆì´ì§„ ëŒì•„ì™€ìš§
AngÃ©lica Quintero	Jin is so beautiful, I can't believe someone like him exists in this worldğŸ˜© also Seoul looks like a great place to visit, I will someday!
Mariachi El	Seokjin ğŸ’™ğŸ’™ğŸ’™
Yani	Seoul ğŸ˜
Velvet Oc	Why i can see RJ there?
ã‚‰ã‚‰ë¦¬ë¦¬lala	Definitely a place to visit soon....ğŸ’œğŸ’œğŸ’œ kim seokjin thank u
Eytham	Kim Seokjin ğŸ’œğŸ’œğŸ’œ
Kaah  rocha	I want to go to KoreağŸ’œğŸ’œ
Recthel Lovendino	â¤â¤
Joss	KING
Jin0412 BTS	Seokjinnie
ì•„ë¯¸ë°©íƒ„ì†Œë…„ë‹¨	Our worldwide handsome talented manğŸ’œ
Mel LÃ³pez	Bien ğŸ‘
cyndi cavestany	Jin ğŸ˜˜
ianka alcira mendoza lucano	Hermoso mi Jin,   da emociÃ³n por conocer de la cultura coreana.
Luisa Fernanda Alvarado Medina	Â¡Muy hermoso!, aprender y conocer toda la cultura ğŸ’œ.
Lyn Joy	seoul is historically beautiful. thank you jin for showing the ancient side of a modern city seoul
Jenniffer Faria	Thank you baby ğŸ’•
Koya	Beautiful
Antonia Amin Coliqueo	ğŸ’œğŸ’•
Mia Mancilla	HERMOSOOO
Balala Tatat	Our elegant and handsome Prince â¤ deserves lead role in historical dramas
katie soo	ğŸ˜­ğŸ˜­ğŸ˜­ğŸ˜­ğŸ˜­ğŸ˜­ Kim seokjin â¤â¤â¤â¤â¤
Fitriana Rahayu	Makes me want to study history^_^
Amy _bts	Seoul is beautiful!!ğŸ’œ
BTS ft my Tears	This is so beautiful
Yeii Park	Thanks Jin ğŸ’œğŸ’œ
Nahir Escudero	Worldwide handsome â¤ï¸
niarah	KING
ê°•ìœ¤í¬	ì§„ ëª©ì†Œë¦¬ ë„˜ ì¢‹ì•„^^*
Idk :D	MY CUTIE
Rawan	JinğŸ’œğŸ˜­ğŸ˜­
Hillary Rose	Historic legend
bijj you know BTS???	That one dislikeğŸ‘ŒğŸ˜Œ
Ana Itz	Jin so cute ğŸ˜ğŸ’œ
ì¥ì• ì„ 	ì§„ğŸ’–ğŸ’–ğŸ’–
dulset yoongles	Bat sayo napunta yung historic seoul napaghahalataan ah ahahaahgaha charot i love u jinnie so much
Daniela Carrillo	My worldwide handsome I love you I love South Korea ğŸ’œ
JA NNA	QUE LINDO TODO ğŸ’œğŸ’œğŸ’œ  KISS FROM ğŸ‡¦ğŸ‡·
ê¹€ëƒì˜¹	Worldwide handsome jinğŸ˜ ì˜ ìƒê²¼ë‹¤
rena	ğŸ’œğŸ’œğŸ’œğŸ’œğŸ’œ
yoon jin	ğŸ’œ
Johana segura	Ahh jin bebe hermoso fuiste a explorar con Rj
chim chim	Es tan lindo mi jin ;"v
Yesi Hernandez	Wow! This is beautiful. I canâ€™t wait to finally visit
Jazmin Vazquez	Â¡Se ve muy interesante!
BONSAE.POMSAENG.POMSA MH	Please tell me I'm not the only one who thought of that one Run episode when the ceramics scene came up..? ğŸ˜‚ğŸ’œğŸ’œ
Selina Perez	ğŸ˜ğŸ˜ğŸ˜
Misaki tan	Holaaaaa Jin jqjdjfkjdjsmslfbal ğŸ˜„ğŸ˜„ğŸ˜˜ğŸ˜„ğŸ˜˜ğŸ˜„ğŸ˜„
goldencloset_jk	i'm in love pt. 2
Nina KatyBTS	Why I'm so early.!!!  You're so beautiful JINğŸ˜˜ Love you BTSğŸ’œ
georgina leon	wow korea's tourism promo done right ... their mind.
gayatri bali	Kim seokjin â¤ï¸ ğŸ˜
Angie Pham	"Do you want to listen to my Seoul?" HA good one
luli Moreno	Jdifbeidbdkndbfidk  seokjin ğŸ˜ğŸ’•
ì§€ë¯¼ëœë“œ	ì§„ ë„ˆë¬´ ì‚¬ë‘í•´í•´â¤â¤â¤
bla bla	Jin looks so noble.
Susana gonzalez	JinğŸ’œğŸ’œğŸ’œğŸ’œ
bluÃ« pop	SEOKJIN ğŸ’œ
Ø§Ø³ÙŠØ§ Ø§Ù„Ø³Ø§Ù„Ù…	We love jin , Bts , seoulğŸ’›ğŸ’›
ë”© ë”©	jin!!!!!!!!! i love you man
Thatyane	SEOKJIN ğŸ’œ
Marie Katrina	YES JIN I WANT TO TRY IT TO
Ø±ÙŠÙƒØ§ Ø³Ø§Ù†	Ø·ÙŠÙ† Ø£ØµØ¹Ø¨ Ø­Ø±ÙÙ‡ Ø¨Ø§Ù„Ù†Ø³Ø¨Ø© Ù„ÙŠ ğŸ˜‚ğŸ˜‚ğŸ˜‚ğŸ˜‚ğŸ˜ğŸ˜Ø¨Ø³ Ø§Ø­Ø¨Ù‡Ø§
No Thunder	ì˜ìƒë¯¸ê°€ ì¢‹ë„¤ìš”ì˜¤-! ì§„ ëª©ì†Œë¦¬ê¹Œì§€ğŸ˜â™¥ï¸â™¥ï¸â™¥ï¸â™¥ï¸
Daisy R	I want to visit Korea because of BTS!
Worldwide Shoulders	I am now convinced to go to Seoul...
í–„í† ë¦¬jin	JinğŸ˜ğŸ˜ğŸ˜
I'm manggaetteok	â™¡â™¡
YESE NIA	Wow que bello ğŸ‘ğŸ»
ì•„ë‚˜	Arte mostrando arte.
ButterflyARMY	I love you Jin ğŸ’œ
kim Nara	Worldwideactor!
Mary Lee	worldwide handsome ğŸ’œ
kyungah kim	BTS  JINâ™¥â™¥â™¥Love  youâ™¥â™¥Miss  youâ™¥â™¥
Sara J	seokjin is amazing
Hannah Faye	ğŸ’œğŸ’œğŸ’œğŸ’œğŸ’œğŸ’œğŸ’œ
Jimena EnrÃ­quez	La historia de Corea es tan atrayente... gracias por promover a tan bello paÃ­s. Jin ğŸ’™
laalways lala	Jinâ™¡â™¡â™¡â™¡â™¡
ë¦¬ìŠ¤ê¹€	Seokjinnie~~~
PhÃ¹ng Linh	I Seoul U ğŸ’œğŸ’œ I love Jin ğŸ’œğŸ’œ
Soohyun Yang	ì–´íí‘ã… ã…   ì§§ì•„ë„ ì¢‹êµ¬ë‚˜~~â™¡
Adry VMendicuti	Corea tiene mucha riqueza cultural, necesito ir :D
Samanta Gaytan	Jin!!!! I promise I'll go to Korea I'll go to your restaurant and I'll see the same beautiful places you always see  I love you so much
Indah Dwi Ariani	I want to see him more ğŸ˜­ğŸ˜­ my worldwide handsome I hope you get an acting role very soon â¤ğŸ’™
Nuna Nuna	THis is so cool.
ARMY are BTS fans	SeokJin ah I Seoul you
Nicole Alvarez	Me encantarÃ­a ir! Parece un lugar totalmente enriquecedor ğŸ˜Š
lazygirl98	Wow i want to try it !!! ğŸ‘ğŸ½ğŸ‘ğŸ½
love yourself	Jin you look so good
kdrama Krazy	I Seoul U Kim Seokjin
yngisjin x	Wow seokjin is beautiful
Liv Miller	I would like to go to their museums! So much history and culture to learn, amazing. Jin looks as handsome as ever, yup.
BTS 7	ê¹€ì„ì§„ ê·€ì—¬ì›Œ ã… ã… 
CATANAIAH MESA NUÃ‘EZ	Mi vida te amoooooooo ğŸ˜ğŸ˜ğŸ˜ğŸ˜
lara frind	JIN
Book is Life	KIM SEOKJIN!!! ğŸ’œğŸ’œğŸ’œğŸ’œğŸ’œğŸ’œğŸ’œğŸ’œğŸ’œğŸ’œğŸ’œğŸ’œğŸ’œğŸ’œğŸ’œğŸ’œğŸ’œğŸ’œğŸ’œğŸ’œğŸ’œğŸ’œğŸ’œğŸ’œ
hope and candy	por el unico Kim Seok Jin sere capaz de aprenderme toda la historia de Corea e ire a visitar lugare historicos! aunque ahora no porque no tengo plata XD
Chika Cho	Love you Kim SeokjinğŸ™†ğŸ’œ
Jackie Andrea	Jin tan bello ğŸ’œ
boy December	ì˜ìƒ ì´ë¿Œë‹¤
Kamineko13	as expected Jin representing historic Seoul â¤ I want visit the museums
Romina Fuentes	Que lindo jinn!! â¤â¤ğŸ˜ğŸ˜
ì§„í•œì†í‚¤ìŠ¤	ì‘ ì§„ì´ë‘ í•´ë³´ê³ ì‹œë½€â™¡
Mi Mi	TE AMO SEOKJIN
ARMY DO BTS	JIN MEU DEUS QUE LINDOOO ğŸ˜ğŸ˜ğŸ˜ğŸ‡§ğŸ‡·ğŸ‡§ğŸ‡·ğŸ‡§ğŸ‡·ğŸ‡§ğŸ‡·ğŸ‡§ğŸ‡·
ë² ë¡œë‹ˆì¹´	PLEASE LIST THE VIDEOS  SO WE CAN FIND THEM MORE EASILY INSTEAD OF ONLY PUTTING THEM UNLISTED THAT MEANS THAT WE CAN ONLY WATCH THEM IF WE HAVE THE LINK
softmochi	WORLDWIDE HANDSOME
kim sj	MY KING
Isa Min	MI PRINCIPE
A M	Really suit jin's personality. Fine and good looking !
ABBY RABBIT	Jin: Historic Seoul (SeÃºl histÃ³rico), muestra la historia de SeÃºl, incluyendo artes marciales tradicionales, museos y cerÃ¡micas.
Alejandra Vkookmin	SEOKJIN!!ğŸ˜­ğŸ˜»
LY_kimchi	Seoul has so much rich history! Just like rich Kim Seokjin himself. Winning!
Lauanda Barros Ribeiro	AAAAA KIN SEOKJINğŸ˜ğŸ˜ğŸ’œğŸ’œğŸ’œğŸ’œğŸ˜ğŸ’œğŸ˜ğŸ’›
Mundo De Mirella Mayer	JIN! SEU LINDO! ğŸ‡§ğŸ‡·â¤ Muito lindo! Muito top
Ivone Ro	This suits with Jin sophisticated and beautiful!!! Thank you!
magickoya	KIM SEOKJINNNNNNN YOU INSPIRE ME EVERY DAY
LINA R	Wow
Irrezel De Jesus	Armys let's go to Seoul
Jay Frost	JINğŸ’œğŸ’œ
Cristine Ibona	My love
nona nano	THE LOVE OF MY LIFE
ì•„ê¸° ì²œì‚¬	MY KING
MEL T	JIN BEBE
sopearlx	Worldwide handsome ğŸ˜
Elizabeth Yepes	ESTOY MURIENDOOO
