Mude Saiprasad Naik	Next cm
Madhavarao Bankala	Eee kojja.cinimalaku.tappa.cm.gaa.neenu.oppukonu.neenu.kaapune.
raj raj	Lubna super
Urs Surya	Video is not perfect for this lyrics.
jcharles wesley	Anthem leğŸ˜€
Darling Vaasu	Super song shiva anna
vishnu vardhan	Superb Ra Shiva.. superb work.. ne kastaniki pratiphalam 1milion + ravali e week end lopu..
Chandu Aluri	Evadraaaaaa dislike kotindhi jai pawanism
Thodupunoori Lavanya	Hey thq all the celebraties . Thq for supporting  pk guys
Vamshi Jenasena	Jai jenasena
nagaraja kvpower star	Super jai jai jai jai jai jai jai jai jai power star pavan kalyan jai jai jai janasena
v.siva4305 vemula	Aaripoey deepaniki veligu akkuva haaa
Madalaneni Srihari	à°¸à°¾à°‚à°—à± à°¸à±‚à°ªà°°à±.à°·à±‡à°°à± à°šà±†à°¯à±à°¯à°‚à°¡à°¿ à°²à°¿à°‚à°•à± à°ªà±à°°à°¤à°¿à°’à°•à±à°•à°°à±‚
Kilari Venky	Super jai janasena
Rajesh Korra	Super....
rpjairam naik	Super anna
Pawankalyan Freaks	Nti appude ayyipoyindaa ani evarikaina anipinchindaa
ABDUL RAHMAN	super Anwer Hussain
NANI DEVA	Awesome Bro Superb song lyrics mathram oo level o unnai nijanga nv real fan anipinchukunav â¤
PavanKalyan Daida	Iraga deesaaru kadayya..
ramakrisshna kudaramakrisshna	xlent jai pawan sir
Srinivas Pogiri	Great
Prabhakar Jogula	Nice Jai Janasena
Srikanth Battula	Super  song jai  janasena
Rambabu Rambabu	love pavan
SAGAR PSPK DESIGN'S	Janasena For Better Society
Sammeta Sateesh	Power of common man
shiva y	Super
sekhar reddy	Superb
jayaram ram	Super song good working all members r good acting jai pawankalyan jai janasena jai hind.....
Sai kumar PS PK	super Anna.. Jai janasena ğŸ”¯ Jai Hind ğŸ‡®ğŸ‡³
Lalitha Saraswathi	ğŸ‘ŒğŸ‘ŒğŸ‘Œ
Suribabu Dv	Superb
Virat jaii	Superb ğŸ‘ŒğŸ‘Œ Jai Janasena ğŸ’ªğŸ’ª
Sriram Pulime	Demi God #Kalyan Annaya ğŸ™ğŸ™  Good Work Team ğŸ‘ŒğŸ‘Œ
MN Creations	Superb.. #Shiva Ur Lyrics Awesome... Jai #PSPK...
Kannepogu Veerababu	Superb.....
Ashok Vinay	Demigod of Telugu people  Power of pavanism
Ram Raj	Baboyee. Chi. Chi...
Yolo Oloy	Dislikes kottinollu Jalaga and CBN moddagudavandi
vasanth kumar	ğŸ‘ğŸ‘ğŸ‘ğŸ‘ğŸ‘ğŸ‘ğŸ‘ğŸ‘ğŸ‘ğŸ‘ğŸ‘ğŸ‘
Upender Dharmarapu	Superb ğŸ˜˜
prasad Reddy	Wow super jai pawankalyan jai janasena
krishna chaitanya	Superb bro
Pagadala Mahesh	Excellent ...jai pawanisam
Pspk Niru	ğŸ‘ŒğŸ‘ŒğŸ‘ŒğŸ‘ŒğŸ™ğŸ™ğŸ™
leela creations	Janasena song.. https://www.youtube.com/watch?v=pBfQHNbrJYM
Shivakumar chary	https://youtu.be/n0205CQo3dE PSPK Top 5 BGM Rocks JAI JANASENA ğŸ³ï¸âœ¡ï¸ğŸ³ï¸
Vasanth Rao Yempally	Congratulations Shiva,
g mallesh	Superb song
Ashok Ramdeni	Superb lyrics Anna  Mana devudu e video chudali ani korukundddam Anna  E video chusi mimlani appreciate cheyali Anna  Jai Kalyan Babu
pruthvi naik	Jai Janasena
Latheef Sheke	Supper bro  jai  janasena
Darla Pavan Kumar	Super song bro's... Love you all.. Jai janasena Jai pavanisam
yadav hari	Super bros jai pawanism
raju teja	Super anna
salman janasinikudu	à°œà°¯à°¹à±‹ à°œà°¨à°¸à±ˆà°¨à°¿à°•à±à°¸à± à°œà°¯à°¹à±‹âœŠâœŠâœŠğŸ’ªğŸ’ªğŸ”¥ğŸ”¥ğŸ”¥
Ravula Sivaji	Jai janasenaâœŠâœŠ Simply superb
Vani Yarramsetti	spr chitti  master  raju  all of you  very  good  job
BVS NAYAK	à°®à°¿ à°¬à±Šà°‚à°¦à°¾ à°°à°¾ à°¹à°µà±à°²à±† à°®à±à°¸à±à°•à±Šà°°à°¿ à°µà°¿à°¨à°²à±†à°• à°ªà±Šà°¤à±à°¨à±à°¨à°¾à°‚ à°‡à°‚à°•à±Š à°¸à°¾à°°à°¿ à°‡à°²à°¾à°‚à°Ÿà°¿à°µà°¿ à°ªà±à°¨à°°à°¾à°µà±ƒà°¤à°‚ à°•à°¾à°•à±à°‚à°¡à°¾ à°šà±à°¡à°‚à°¡à°¿ à°²à±†à°•à±à°‚à°Ÿà±† à°®à°¿à°•à± à°®à°¿ à°šà°¾à°¨à°²à± à°•à± à°¦à°‚à°¡à°¾à°²à± à°‡à°Ÿà±à°²à±#BVSNAYAK ğŸ’œğŸ’™â¤ï¸ğŸ’ğŸ’–ğŸ’
Shaik Hedayathullah	Superbb song ,you did wonderful job rocked it  jai powerstar pawan kalyan
Pavan Kalyan	Super bro
Lucky pawanisam	Super
sk abdul	jai powerstar
kkr kkr	SuperbâœŠâœŠâœŠâœŠâœŠâœŠâœŠâœŠâœŠâœŠ
kuraku srinivasulu	à°ˆ à°œà°¬à°°à±à°§à°¸à±à°¥à± à°•à°¾à°®à±†à°¡à±€ à°•à°¿ à°¨à±‡à°¨à± 10 à°®à°¾à°°à±à°•à±à°²à± à°‡à°¸à±à°¤à±à°¨à±à°¨à°¾à°¨à±
vijay mohan	WHR is Darling das
amma amma	Jai Jena sena
gadi manohar	So nice
shridhar Bolluwar	lyrics good Bt video does not perfect for That lyrics
rajitha raj	Congrats shiva. Song suuupppeerrrr
satya bhaskaruni	Good job.keep it up
Sai 111	Simply superbğŸ˜˜
Kavuri Venkatesh	Goosebumps pakka  TQ for making This video  Jai Pawan Kalyan Jai Janasena
Nune Prem	super song
Duddeda dhagad's	Nice song
Naveen Kumar N	Jai janacena
upendra pallela	Nice song.... pk fans
ch.divya divya	Jai janasena
sridhar y	Anna good.. Try to stop correcption etc... faluthu CM in Ap
STEPPING STONES	Nice making.....comgracts whole team...
Durga Rao	*à°‡à°²à°¾à°‚à°Ÿà°¿ à°…à°­à°¿à°®à°¾à°¨à°‚ à°ªà°µà°¨à± à°•à°¿ à°®à°¾à°¤à±à°°à°®à±‡ à°¸à±Šà°‚à°¤à°‚*
Abdul Kalam	Janam kosam pavan Pavan kosam janam Janam kosame jana sena
tik tok	Simply superb goosebumps ğŸ‘ğŸ‘ğŸ˜ğŸ˜ğŸ˜˜
Ram Ramangi	Very nice album friends. Jai janasena.
Singer Vivekananda	Chala bagundi bro...ğŸ‘ğŸ‘ğŸ‘
tulasiarts007 Devaji	Medak meat tulasi
RAGHAV RANGUSETTI	Jai powerstar
Gopal Karneedi	Congo #Shiva_Vemulavada
Nagala Sateya	,Jai Pawanism
Sri Teja Yf	Jai Powerstar #Shiva you rocked with the Lyrics
sirisha Oduri	jai  pawan anna
venugopal reddy	Super brother fan of pspk
Charan Aennam	#PK fans like eskondi ğŸ‘ğŸ’ª
