AKiMi KeNjI	cutie
Angelica Vega	Jajaa Ahuevo xD
andri gamer YT	Havana en a chile pero a ValparaÃ­so plizzâ¤ï¸â¤ï¸â¤ï¸
Ivanna M.G.	Por que no esta el clip de "la vieja esa si va a cantar el dÃ­a de hoy"?? ğŸ˜¡ğŸ˜¡
Kensy Diaz	:"( lÃ¡stima que no venga a Honduras :"v ğŸ’” ME PARTE
Nadia Hassan	I love that she considered the fact that not everyone can aford meet and greet tickets and the whole roses thing is just soooo sweetâ¤ï¸
Stephany Cabello Jauregui de Mendes	The best girl on the world. â¤
Esmeralda Ruiz	y yo que crei que iba hablar en espaÃ±ol :/
Thaddeus Ip	How long did you hog the bathroom? hahaha
suicide at best	Yes Mexico por vida ğŸ‡²ğŸ‡½
Pavan R	BEst Singer EVer...
Raj Swarnkar	Ohhh ğŸ˜ğŸ˜ğŸ˜ğŸ˜ğŸ˜ no comments just speechless ğŸ˜ğŸ˜ğŸ˜
Jennyka H	Love you Camila!
VTB 11:11	ğŸ‡²ğŸ‡½ğŸ‡²ğŸ‡½ viva MÃ©xico
Monali Shah	I love you camila ğŸ’•ğŸ’•ğŸ’•
Angela H.GVevo	2cd   ( Í¡â—‰ ÍœÊ– Í¡â—‰)   I love you so much  So proud of you  #yourbiggestfan I love you I'm Mexican to but born in America i love you so much please come to Sacramento
Anna Mei Christensen	Camila  I am so so sooooo SOOOOO proud of you â¤ï¸â¤ï¸â¤ï¸â¤ï¸
Delfii MÃ¡rquez	El subtÃ­tulo mija
Pau S	Our mexican queen ğŸŒ¹ğŸ‡²ğŸ‡½ğŸŒ¹ğŸ‡²ğŸ‡½
Kathia Herrera	#camilaREBELAtubisexualidad
Jony Herrera	#camilaREBELAtubisexualidad
Asmita Krishna	Why don't you do a concert in India?Looking forward to it in the future.
Dusty Dusty	BEAUTIFUL , best of Mexican and cuba
Park Minnie	CreÃ­ que saldrÃ­a parte del concierto en Guadalajara, lo Ãºnico que vÃ­ fue el letrero de la carretera, jaja.
Jisandra Ferreira Barroso Barroso	C â¤ C
Alicia HernÃ¡ndez	Owww me encantaâ¤ğŸ‡²ğŸ‡½
Adhia Putra	Next asia tour save #indonesia
Light one	Hey sexy, ya you reading the comments
just just skyekimi sassycat143	te quiero mucho Camila...
David Alfredo	I will marry Camila Camellia any day
Vanessa Flores	Por Eso amo a Camila â™¥ï¸
Btt Castro	Camila pls lisen to to my comments my sister loves you she really needs help pls respond
valeria garay	QuÃ© dice al principio?
LYRIC IT UP	*India is waiting for you ;-;*
Claire P.	LOVE THISSSS
Defne Mutlu	Turkish Camilizers ğŸ˜ğŸ˜˜ğŸ‡¹ğŸ‡·ğŸ‡¹ğŸ‡·
SOFIVALE jIMENEZ	AhÃ­ esta el matt jajajaj, pero ya hablando en serio que bonito sinceramente que haya alguien que crea en nosotras en especial ya que uno Ã³sea si sabe que puede llegar a suceder pero no se lo llega a creer pero  alguien como ella que realmente crea en nosotras bueno al menos para mÃ­ es sÃºper bonito y me da esperanzas ya que uno como joven tiene sueÃ±os pero generalmente todos a tu alrededor en especial los adultos te dicen que no llegarÃ¡s a nada pero esto me da esperanzas aparte de que solo me lo dice mi mama y mis amigas de que puedo hacer algo bueno en mi vida â¤ï¸â¤ï¸â¤ï¸â¤ï¸â¤ï¸â¤ï¸â¤ï¸â¤ï¸
Luana Paixao	Mexicana mais linda de Havana, i love u Mila so much my inspiration
Charles Knight	You are my all time favorite singer and you also inspire me to chase my dreams. Whenever I feel sad I listen to your music and that lifts me up and in my opinion you where my favorite and  you where also the best in fifth harmony.
Zul Limo	You from mexico ??
zosijja 412	I love youğŸ˜
Ximena Mendoza	Bueno mi papÃ¡ me dijo que hiciera esto asÃ­ que... aquÃ­ voy supongo, bueno primero que nada yo te amo mucho Camila eras la mejor de las mejores no sabes cuanto te admiro â¤ï¸ğŸ˜ de echo estuve en tu concierto en Guadalajara y pues cuando te vi cantando con el mariachi de Guadalajara empecÃ© a llorar por quÃ© pues mi papÃ¡ trabaja en un mariachi y pues parte de ese mariachi eran amigos de mi papÃ¡ yo llorÃ© mucho se me partiÃ³ el corazÃ³n ğŸ’” yo le contÃ© todo a mi papÃ¡ y pues ya le dijo a mi papÃ¡ a sus amigos y yo seguÃ­a llorando por quÃ© pues me doliÃ³ sabes de que yo estuve a un paso de conocerte y yo me imaginaba conociÃ©ndote cantando contigo muchas cosas y pues me dolÃ­a por que me quedÃ© con las ganas de conocerte y todos los dÃ­as pensaba que mi papÃ¡ hubiera tocado contigo Ã©l toca el arpa hubiera sido uno de los mÃ¡s grandes sueÃ±os cumplidos....  la verdad si tengo Fe en que vas a leer esto y me vas a comprender pero a ver quÃ© me depara Dios... de echo empece a llorar en tu video por quÃ© me dio mucho sentimiento se que del 100% podrÃ¡s ver este comentario serÃ­a 1% pero ojalÃ¡ lo leas y lo aprecies tanto como yo te aprecio a ti â¤ï¸ y por favor no me vayan a tirar hate se que dirÃ¡n que es por llamar la atenciÃ³n pero no y no es por presumir pero se vale soÃ±ar puede que Camila vea este comentario o no pero lo hice por quÃ© tuve fe y esto no es Fake esto es 100% real â¤ï¸ğŸ˜
raxnboz	She is so happy Iâ€™m so happy
à¹’Ñ”à¸ ×Ÿà¸„à¹“à¹€à¸  à¸„à¸¢à¸„Ğºà¹€à¸ 	Omg sali en el videoooooooo *-*
ThePyrusDragoJ 2269	ğŸ¸ I I L I LO I LOV I LOVE I LOVE Y I LOVE YO I LOVE YOU I LOVE YOU S I LOVE YOU SO I LOVE YOU SO M I LOVE YOU SO MU I LOVE YOU SO MUC I LOVE YOU SO MUCH I LOVE YOU SO MUC I LOVE YOU SO MU I LOVE YOU SO M I LOVE YOU SO I LOVE YOU S I LOVE YOU I LOVE YO I LOVE Y I LOVE I LOV I LO I L I ğŸ¸
eliza foley	...matthew made me vomit
å§šç¥å¦¤	gustaaaaaaaa
Bianca Alexandre	2:01 oh, why is it the first time I'm noticing Mathew in this picture ?
Jane Mulder	Seriously you were so close to my countries border. We are right next to Mexico. We are in Central America. It is not Guatemala
Darely RamÃ­rez	La amooooğŸ’“â£ï¸ğŸ˜
fluffy scorpio	God, I can't wait for you to go to Asia! ğŸ’•
Edgar Ivan Aguilar Algarate	ğŸ˜ğŸ˜ğŸ˜ğŸ˜ğŸ˜
Jaz Vargas	SÃ³lo dirÃ© esta vez gracias por existir Camila CabelloğŸ˜Š
Raven KS	Waiting for the Brazil Tour Diary!!!!!!!!!!!!!!!!!!!!!!!!
Tigers and Burgers	You go gurl, I love your music,Camila you are such a big inspiration to me,I am a so proud of you,you work so hard and you deserve a break.â¤ï¸â¤ï¸â¤ï¸â¤ï¸â¤ï¸#Mexico
Leila Zebra	Congrats!!!!! The tour was so awesome and magical. I love you Camila!â¤ï¸â¤ï¸
anniebi	Te amo tanto â¤â¤ viva MÃ©xico cabroneeeees ğŸ‰
Alexia O. GuzmÃ¡n	Es normal que haya llorado durante todo el video? ğŸ˜­â¤ï¸
Unstoppable girl CC	YOU KNOW
Music Girl	Yeahh
Twice Blackpink	Collab of you and twice  Plz ğŸ™ğŸ»ğŸ™ğŸ»ğŸ™ğŸ»â¤ï¸ğŸ˜­ğŸ˜­ğŸ˜­
Silvi Cantik	Iam crying ğŸ˜Œi wanna make my dad proud of me tooğŸ™ƒhopeeee
Judith Rmz	Baby, you are such a good person, i love you so much.â¤
Andrea Garcia	Yo estaba ahi!! Omg! Me encanto! Te amo camila!! I was there! I loved it! I love you camila! â¤
Alicia Cuevas	Amoo a esta mujer con toda mi vida!! Y claro que si!!  *VIVA MÃ‰XICO CABRONES!!*
Pamela Nietto	Ven a Uruguay porfiii
Ivan Vasquez	Eres muy linda Camila
Jennifer Sarahi Cortez Bernal	Aayyyy te amo no sabes lo mucho mucho mucho que te admiro eres lo mejor del mundo mundial encerio porfavor ven a tijuana seria uno de mis sueÃ±os mas grandes cumplidos ğŸ˜­ğŸ˜­ğŸ˜­ğŸ˜­ğŸ™ğŸ™ğŸ™ğŸ™ğŸ™ğŸ˜ğŸ˜ğŸ˜ğŸ˜ğŸ˜ğŸ’ğŸ’ğŸ’ğŸ’–ğŸ’–ğŸ’–ğŸ˜˜ğŸ˜˜ğŸ˜˜
Dwighty Mitch	Te amamooooosssss.â¤ï¸
Jimena Morales	gracias karla camila por haber conocido mexico y espero q otra vez nos visites y pueda ir a verte ok  y quiero conocerte alguna vez  l love you
Jatziry Llamas	Te amo ğŸ˜ğŸ˜ğŸ˜ğŸ˜ğŸ˜
Iker Ruiz	VIVA MEXICO ğŸ‡²ğŸ‡½ğŸ‡²ğŸ‡½
Natalia Aloha	Lovely
Habeba Styles	hey queenğŸ‘‘ğŸ‘‘ğŸ‘‘...  l love You sooo muchğŸ˜ğŸ˜ğŸ˜â¤
Noureddine Adel	Ø§Ù„Ø¬Ø²Ø§Ø¦Ø±ÙŠÙŠÙ† Ø¹Ø´Ø§Ù‚ ÙƒØ§Ù…ÙŠÙ„Ø§ ÙƒØ§Ø¨ÙˆÙ„
ees4k 03	This has such a good message
Adriana Beatriz Mora Becerrit	DEBERÃAN SACAR UNA CANCIÃ“N COMPLETA DE: "DE MIAMI A MÃ‰XICO, ESTA COSA SE PRENDIÃ“". SERÃA UN GRAN HIT
Tania Perez Rangek	Ojala viniera a Atlixco Puebla en Diciembre para la Villa Iluminada ğŸ˜
Leticia Alonso	que triste yo queria ir vivo en MichoacÃ¡n y queda serca de guadalajara ya he hido a esa plaza y compre elotes y alas carreteras por que no fui
Jazlin Garcia	love camila te amo
David Adam	LOVE YA CAMILA AHUEVO. UWU
Ğ¦Ğ²ĞµÑ‚ĞµĞ»Ğ¸Ğ½Ğ° Ğ”Ğ¸Ğ½Ñ…	Love you ğŸ’–ğŸ’‹ğŸ˜˜ğŸ˜ğŸ˜Camila Cabello ğŸ’–ğŸ’‹ğŸ˜˜ğŸ˜Big ğŸ’–â¤ğŸ’–Fan. ğŸ’–ğŸ’‹ğŸ˜˜ğŸ˜ğŸ˜
Lloyd Tolentino	HERE WE GO!! THE NEW SAMSUNG GALAXY X IS RELEASED THIS MONTH OF OCTOBER!! THE FIRST FOLDABLE PHONE! https://youtu.be/7omHREd_DE8
Laura Pacheco	Camilla Cabello hermosa niÃ±a!!!!!
Valeria Flores	TE AMOOOOOâ¤
Vera Rosemountain	All here are mecicanğŸ˜©
JesÃºs Enrique GÃ³mez Gerardo	Like si eres mexicano y si eres un verdadero camilizer  viva MÃ©xico cabrones ğŸ‡²ğŸ‡½ğŸ‡²ğŸ‡½ğŸ‡²ğŸ‡½ğŸ‡²ğŸ‡½ğŸ¤—ğŸ˜ğŸ˜€ ahuevo
Casandra Caeliker	ESTA COSA SE PRENDIO ğŸ”¥
Mariiana Vasquez	Estoy llorando porque no fui ğŸ’”
videos edits	1:42 es annie [dosogas kids]
Stella Marie Jandongan	6:24 to 6:32 Who is the guy behind Camila? He's wearing blue long sleeve. Is that Matthew?? ANSWER ME GUUUUUYS!!
UNDEFINIDED	Te amamos demasiado, una gran persona ğŸ’–ğŸ˜
darKo BakuLaW	I'm going Kanye right now - Tu eres mi esposa in another universe.ğŸš€
Payoyis :v	AHORA PUEDO DECIR QUE CAMILA ESTUBO EN MI PAÃS :D
abdelkader aiouche	Â¡HERMOSA MUJER!ğŸ˜ TE AMAMOS MACHIN.â¤ï¸ğŸ‡²ğŸ‡½
suga gummy	Te amo Camila..â¤    Thank you google translate..
Sunny Agarwal	I Love You...
Arlett MartÃ­nez Landero	Que joyita este videoğŸ‘ŒğŸ½ğŸ˜â¤ï¸.
Chris Fer	Creo que Camila se ve 10000 mas linda cuando ve a camara T_T
mily valdez	Y pensar que yo estaba ahÃ­ y aÃºn no creo que pude ir ğŸ˜ğŸ˜
Mickaii M.	*Hope you'll get to concert here in the Philippines too Camz*  Love, FILIPINO FANS ğŸŒ¹
Nathaly fiori	yo me vi todo el video aunque solo entendi: Viva Mexico cabrones! <3
IQue Yazlen	Ahuevo!!
Nataly Montoya	Te amo camila!!!!!!ğŸ’•
Deja de mirar sapopÃ³	7:42 Masajes Relajantes -Faciales -DepilaciÃ³n LÃ¡ser -Tx Manchas -Tx Acne -Psicologia  :vv
BONG GUELOS	Happy Hallowin Mrs.Camila Cabello
Danna GonzÃ¡lez	ğŸ˜­ğŸ˜­ğŸ§¡
Aleghiotaffi	Sin duda una hermosa chica, tan sincera y bella! Orgullosa de ser tu fan
YaaÃhii d'PÇkÇÇ ELyooth FitzgÇrald	Something's Gotta Give ğŸ˜­ğŸ˜­ğŸ˜­ğŸ˜­ğŸ˜­ğŸ˜­ğŸ˜­ğŸ˜­ğŸ˜­ğŸ˜­
Harshita Nandal	Beautiful  HermosasğŸ˜ğŸ˜ğŸ˜
Elvia Alfaro Lopez	Te quiero mucho Camilla
Geraldin Reyes	ğŸ‡²ğŸ‡½ğŸ‡²ğŸ‡½â¤ï¸te amamos!
nao te interessa	linda ğŸ’ğŸ’ğŸ’ğŸ’ğŸ’ğŸ’ğŸ’ ğŸ˜»ğŸ˜»ğŸ˜»
Nayeli Syvertsen	I'm loving it. She is so charming!
Ross C.	A humble Diva.
Dante Villegas	Te verÃ© en tu siguiente gira, y en primera fila :)  Te amo â¤
Hailton Freitas	Legendas pf ğŸ’”
Frida Oliva	Yo estaba aÃºn lado de los muchachos del minuto 9:47
Beth Morales	How to skip Chile in two seconds
Natalia Galaviz	â¤ï¸â¤ï¸â¤ï¸
Leeh 5h	My Love Camila Cabello  Havana
Lauren	4:28 "He has such a beautiful beautiful voice" You take after your dad
abraham jenner	Hermosisisima mujer jejeje eres la mejlr camila
Sasha Ali	TE AMO Y ADMIRO TANTO.! SO, ESPERO ALGUNA VEZ TRAIGAS TU TOUR A MÃS PAÃSES DE LATINO AMÃ‰RICA COMO ECUADOR POR EJEMPLO! â¤ï¸
banana 7u7	Like si estuviste en alguno de los conciertos â¤ï¸â¤ï¸â¤ï¸â¤ï¸ Viva mexico cabrones ğŸ”¥ğŸ”¥ğŸ”¥
Mariana Paucar Gamarra	TE AMOO !!!ğŸ’•ğŸ’•ğŸŒ¹ğŸŒ¹
MariaElia	teared up watching you sing with your dad! what an amazing experience!!!
daniela vanegas	Que mega chingooon haber estado ahÃ­ contigo!â¤â¤â¤â¤
yafreisy hidalgo heredia	Te amo Camilaaaaa  :v
Emi Yarte Holgado	te amo mujer de mi vida
Nigar Pop Music	I just wanna say I LOVE YOUğŸ˜¢â¤â¤â¤â¤â¤It's my the biggest dreamğŸ’™ğŸ’™ğŸ’™
Yurimayra Mendoza	Linda mi niÃ±a ğŸ˜ğŸ˜ğŸ˜˜ğŸ˜˜
Boys for boys	La que siempre dice que es cubana y hoy si es mexicana jaja que pena que sÃ³lo cuando les conviene
gail fontarum	i don't know why but i always tear up when she say something about roses and meet and greets
Solange Santana	Te amo Camila ğŸ˜ğŸ˜ğŸ˜
Analiel Malue	camila, you're fabulous and i love you
delfi esposwithsuarez	you know
Yessenia Soto	Y el tucÃ¡n que hace ahÃ­??   Ay perdÃ³n..  me alterÃ© :v
Rahul Roy	Love you Camilla
Rised	Name a woman more beautiful thatn Camila Cabello...     Just Shut up!
Hi y'all	what, that's her dad ?? he must be so proud of his daughter.
Karen Thuanny	Matthew ğŸ˜ğŸ˜
ERTEL 42	Camila te amo eres muy talentosa like si piensas lo mismo.â™¥â™¥â™¥
Divya Pathak	camila you are my queen!! and you and my birthday is on the same day! i came to the tour and i loved it!
Grecia	Â¿Entonces como sabe camz que algunos fans no alcanzaron m&g? Es que ella dice que da las rosas por los que no lo alcanzaron:(  No entiendo
Smriti	Iâ€™ll be 17 in a couple of hours!!!!ğŸ˜­ğŸ˜­ğŸ˜­
KÃ©lia PEIFFER	love
Emily Louise Parker	literally tried not to cry the whole video. Camila is such a wonderful human
Nefeli Mendes	I can'tğŸ˜­ğŸ˜­
Viia Grace Sinelli	what an amazing family. what an amazing human. the love through your family is radiant, and we are so honored to be able to see you grow up and be happy more than anything. i love you so much, Camila and your family. you are truly so beautiful:)
selena selena	English pleasess
ì´ìœ¤ì§€	0:32 ì—¬ê¸° ë…¸ë˜ ì œëª©ì´ ë­”ê°€ìš”        What's song is it?
Anelsi Cabrera	Dominicana haorA
eleonora sava	2:01 uuuhm excuse me white boy?
omf13 gamer	The best
Lyric Network	I hope camila will love the philippines that way
patypatypaty	Bem que poderia estÃ¡ falando em espanhol jÃ¡ que a turnÃª Ã©  sobre o MÃ©xico.mas tudo bemâ¤
I stand legends bitches	I was smiling the whole time till i saw matthew ew
Sophia_GalaxyGamer 1089	Iâ€™m the english speaking person you were looking for.
floriana	PensÃ¨ que el video seria en espaÃ±ol ğŸ˜¢
Nitish patil	Unsubscribe maadidhya nodu
amanda sabajo	I â¤ you camila cabello
Berths T.	Viva MÃ©xico cabrones! ğŸ’š
Reputation 2017	I â¤ï¸ you show and show off your pride to be Mexican and belongs to an amazing culture full of awesome parties and known particularly for its beauty people  and its incomparable traditions. LOVE YOU CAMILA AND I REALLY HOPE MEET YOU SOMEDAY. #VivaMÃ©xicoCabrones
Javier Jimenez	9:24 Â¡QUITATE CABRON!
random _person	Wish I could  meet you  But..................
Fernanda	i love her so much omg as a xicana it fills me with infinite joy hearing her have so much love for Mexico <3 QUE VIVA MEXICO CABRONES!!!!
Barbara Onerom	Wey, se me puso la piel chinita de solo recordar. EL MEJOR DÃA DE MI PXBRE VIDA
astrid Cruz	Espero y en tu prÃ³xima gira tenerte en mas paises de latam ğŸ’• te amamos milaa !
Karla Jakgs	Aw yo soy una  esas luces,te amo mucho CamilağŸ’Ÿ
Tory Fa	AsÃ­ se lleva mÃ©xico en la piel!   LA AMO
Sirena Estrella	The very end awwww â¤â¤â¤ğŸ¤§ğŸ¤§ğŸ¤§
ssay greemy	ğŸ’–ğŸ’–ğŸ‡²ğŸ‡½
victor roma	Viva Camila y Mexico Cabrones Â¡Â¡Â¡Â¡Â¡saludos bella Â¡Â¡Â¡
adilene castro	what a beautiful video cam, gracias por demostrar tanto amor a MÃ©xico! we love youâ¤
uan X	Hope you will come to China one  day!!!â¤ï¸â¤ï¸â¤ï¸
Gretel velazquez	Â¿Como puede ser tan humilde y talentosa y perfecta? Todo al mismo tiempo ğŸ˜
Prins Ly	Your my fucking inspiration ,I Love YouğŸ˜šğŸ˜šğŸ˜šğŸ˜šğŸ˜šğŸ’–ğŸ’–ğŸ’–   Lablab from Philippines ğŸ˜¢
Daniela Michelle Tellez Bautista	la Verdad es que no hablo Nada inglÃ©s ğŸ˜‚pero Me metÃ­ a un curso de inglÃ©s para traducir tus Canciones Y lo que dises Y es difÃ­cil Y aunque ya estÃ©n en Youtube es todo mÃ¡s sencillo pero Hablar en inglÃ©s Y cantar en inglÃ©s soy PÃ©sima . Pero Vale La Penaâ™¥:3
hana banana	*OMG I LOVE YOU CAMILAğŸ˜« YOU ARE A REAL FRIEND. SEE YOU SOON CAMILA, LOVE ONLY FROM PHILIPPINES*
Yessenia Becerra	Envidio a todos esos chicos que pueden conocerte, ğŸ‡ªğŸ‡¨  sÃ³lo espero que un dÃ­a pueda conocerte y llorar porque llegue a cumplir mi sueÃ±o de estar aya. Muchos kilÃ³metros pero un solo ğŸ’œ nos une #Camiliarzers ğŸ‡ªğŸ‡¨âš˜
Lauren dillon	when she said what the highlight of her career was i really hoped she was gonna say tequila shots with alejandro ğŸ˜‚ğŸ˜‚
Nathalia Aguirre Payan	Ufff ğŸ¤—ğŸ‘ŒğŸ‘Œ
Monique Waite	I LOVE YOU CAMILAAAAâ€¼ï¸â¤ï¸ I wish I can meet you one dayğŸ˜©ğŸ˜­â¤ï¸â¤ï¸
MOB LIFE	9:45 ğŸ‘ğŸ‘…
Daniela Ortiz	En EspaÃ±ol>:v
Karina Ortiz	Viva MÃ©xico!ğŸ‡²ğŸ‡½ I Love you Camilaâ¤ï¸
Leticia Lima	â¤â¤
Cristian Farinango	Este video es lo mas cercano que estarÃ© de camila ğŸ˜Š
Sofia :	We will never be the same
diana potes	Dios mio que hermosa esta chama no puedo, we love you baby C!!!!
Theunstoppble_GAMER	THIS WAS AMAZING â¤ï¸ but ..but why did EW have to be there. he discussed me but I donâ€™t care ğŸ¤·ğŸ½â€â™€ï¸ğŸ˜‚Mattcow also blocked me from Instagram ğŸ˜‚.
Alienut	No cambies Camilitaâ¤â¤, eres hermosa por fuera y por dentro :)
Andrea carolina	Esta mujer es lo mÃ¡ximo
FerCCKpoper 5H	Like si lamentablemente no estuviste en el Never be the same tour ğŸ˜ğŸ’•ğŸ˜­
Yosoy Bogar	Â¡Teamo!
kat goglus	I love you camila cabello
Eva Rubi Flores RodrÃ­guez	Habla en espaÃ±ol juemama
AmazingRayRay	Im soo jeloesss pls come too Arubaa im bigggg FANN
Urvish Prajapati	0:30 Which song is this?
Mera A	Why is she so cringe.
Ravena Gomes	Quem tambÃ©m quer um Tour Diary do Brasil??  ğŸ‡§ğŸ‡·
PepsiCola TastesLike	Que perraaaaa mi amiga!!!!ğŸ¶ diciendo viva Mexico cabrones con mucho orgullo
verÃ³nica estefania	admiraciÃ³n total por esta mujer ğŸ’“ğŸ˜
Venz Oberg	Te amo Camila...
Ale C:	ğŸ˜ğŸ’“ğŸ˜ğŸ’“ğŸ˜ğŸ’“ğŸ˜ğŸ’“ğŸ˜ğŸ’“ğŸ˜ğŸ’“ğŸ’“ğŸ˜ğŸ’“ğŸ˜ğŸ’“ğŸ’“ğŸ˜ğŸ’“ğŸ˜ğŸ’“ğŸ˜ğŸ’“ğŸ˜ğŸ’“ğŸ˜ğŸ’“ğŸ˜ğŸ’“ğŸ˜ğŸ’“ğŸ˜ğŸ’“ğŸ˜
Diana Morales	Ow que lindo debe ser y sentirse de viajar y de regresar a tu pais y lo mejor es de viajar con  tu familia sentir muchos emociones ,sentimientos, recuerdos,etc. Camila  ow que Viva Mexico!ğŸ‘
Ximena Gonzalez	Q triste saber q yo no estuve ahÃ­ ğŸ˜­
Jasmin cvt	OMG THANK YOU
Andy Mendoza	te amo cami
Farin Lakhani	im weeping ğŸ˜­â¤ï¸
Enrrique jimenez	Te amo hermosa vuelve a MÃ©xico pronto ğŸ’šğŸ˜šğŸ˜˜ğŸ˜˜ğŸ˜ğŸ˜ğŸ˜ğŸ’“ğŸ‘‘ğŸ‘‘ğŸ‘‘ğŸ‘‘
Aldair Rodriguez Sierra	VIVA MÃ‰XICO CABRONESSSS!!!!! ğŸ‡²ğŸ‡½ğŸ‡²ğŸ‡½ğŸ‡²ğŸ‡½ğŸ‡²ğŸ‡½ğŸ‡²ğŸ‡½ğŸ‡²ğŸ‡½ğŸ‡²ğŸ‡½
Yasmin Santos	CadÃª a do Brasil? Brasil sempre desprezado, I love you Camilaâ¤
Rebeca TÃ©llez	Eres increÃ­ble â™¥ï¸
cabello97fan kjgoodley	Moi Hermosa, I love you camila you are beautiful you inspire me so much â™¡â™¡â™¡â™¡:)
Ruby â€˜	I love how true she is and how proud she is of where sheâ€™s fromâ¤ï¸
Fernando Rangel Juarez	AaaaaaaaaÃ¡aaaaaaaaaaaaaaaaaaaaaaaaaaaaaaaaaaaaaaaaaaaaaaaa
Antonio Armenta	Estuvo bien chido ğŸ‘ğŸ‘ğŸ‘ğŸ‘ğŸ‘ğŸ‘ğŸ‘ğŸ‘ğŸ‘ğŸ‘
Tandin0SaUri0 Ter	Yo te vi en guadalajara fue increÃ­ble verte al fin despuÃ©s de 3 aÃ±os de espera.
Nxnx 113	8:55 who is she talking bout??  ;)))ğŸ’•ğŸ’•
auronatic	AWEBO MÃ‰XICO
Lizzy Wizzy	Congatzz you just found a English coment ğŸ˜±ğŸ¤£ğŸ¤ªğŸ˜‚ğŸ˜‚ğŸ˜‚ğŸ˜œ
Gisela	Espero que Camila haga un tour diary de Brasil
Gulnisso Bunedbekova	It was incomparable!!! Thanks Mila! Love you from the bottom of my heart.
Julieta Merenda	Llore , mierda la amo tanto â™¥â™¥â™¥â™¥â™¥â™¥
Azucar Azuca	Â¡ACHO PUÃ‘ETA! Puerto Rico paâ€™ cuando ğŸ‡µğŸ‡· jajaja
Max Flores	NO ESTOY LLORANDO WEY, SE ME METIÃ“ UN "QUE PINCHE ORGULLO" EN LOS OJOS ğŸ˜­ğŸ’˜ğŸ‡²ğŸ‡½
Mariel B	Falto Noel y Jesse y Joy :(
Diego fonseca	Estoy feliz de que ahora son los comentarios en EspaÃ±ol los que dominan!
heartless phantom	Is the director Indian
JosefaStar	Camilita creo que Chile se merece su video especial del NBST TOUR. Los medios fan actions que hicimos wn. El cartel "You're our reason to Stay", la lluvia de globos y lo mÃ¡s importante la bandera de Cuba. DE MIAMI A CHILE LA CARRETA SE PRENDIO.
semneko :v	Q lindo canta igual en espaÃ±ol mas espaÃ±ol x fa
Jaqueline Guerra	Al chile, me diÃ³ mucho gusto ver a Camila cantando aquÃ­ en Monterrey, fue de las mejores experiencias cantar y bailar frente a ella como lo hacÃ­a en mi cuarto  â¤ï¸âœ¨
Victoria Rivera	ğŸ˜ğŸ˜ğŸ˜ğŸ˜ğŸ˜ğŸ˜ğŸ˜˜
Mirna Fuentes	ğŸ’˜I Love you ğŸ‘­So much Camila ğŸ™ˆ
nat	i love you so much :(
Sargun Sandhu	Pls do come in india pls u have a lot of fans here too pls do come in india and me and your fans here dream will come true pls its a huge requestğŸ™ğŸ™ğŸ™
Melissah Ì®	Salgo en el video lpm, TE AMO CAMILA!ğŸ’–
Kemille Monteiro	ğŸ˜ğŸ˜ğŸ˜
naty andrade	WE NEED NBTS TOUR DIARY IN CAMILIZERLANDIA ahre te amamos y extraÃ±amos mucho corazÃ³n â™¥ï¸
jean melling	Iâ€™m not Mexican Iâ€™m English. I love Camila so much I fainted when au seen her â€œliveâ€ on the tv! Sheâ€™s so loving and caring the way she giveâ€™s people roses to meet her back stage ğŸ˜©I would love one. Iâ€™m like her biggest fan. I love her so so so so so so so much! My dream would be to get those front row seats and to just get to touch her hand even for a second! I really want her to come to England again!
Maria Lazarou	I LOVE U CAMILAâ¤ï¸
Amairany Sb	camila tienes una esencia Ãºnica, me encanta tu sencillez, tu sensibilidad y amabilidad con los fans,  eres hermosa en toda la extinciÃ³n de la palabra
divirtiÃ©ndose con Tita Montero torres	Costa Rica a Camila i love you
Mayeli Murillo	Q bien Camila aunq entendi poco pero es un gran documental pero ven pa Ecuador
CLAV M music	frome MÃ©xico ğŸ”¥ğŸ”¥ğŸ”¥ğŸ”¥ğŸ”¥ğŸ”¥ğŸ•ŸğŸ•
Darianadalila Valencia Rodriguez	Sin duda la mejor artista que podemos tener en estos tiempos â¤ï¸un gran ejemplo a seguir....
Michell Fernandez	No entiendo ni madre pero aquÃ­ estoy viÃ©ndolo
Kyarita Ramos	OMG AND IM IN MEXICO AND I DIDNT KNOW U WERE HERE QUE BABOSA SOY :(
Loyreth Jimenez	Estoy llorando por dos cosas... 1) Porque pensÃ© que aquÃ­ iba a escuchar tu hermosa voz en espaÃ±ol, pero nop. 2) Saber que ni en un millÃ³n de aÃ±os luz yo voy a poder ser parte de eso:`(
Tilsia Ospino	No es chingÃ³n saber que no pude ir ğŸ˜£ğŸ˜£
DannyBy1512 _BTS	KSKFIDIFID AHI ESTOY YOOOO 27$($($+ BUENO ESTUVE :V
Maria Betscy	Honestly, she looks like a clown in that dress!
ariana brooks	This is just so beautiful!! â¤ï¸â¤ï¸â¤ï¸
Zaylee Art	Let's start a campaign to get them to rehire her dad! ğŸ˜‚
maria teresa alvarado	I love you camila
Aisya Najwa	Congratulations.....ğŸ’–have a nice rest before the concert love ..ğŸŒ¹
NOVELAS PARA SEMPRE	Pessoal fiz um Clip cover de Never Be The Same venha dar uma olhada https://youtu.be/TjVdguvYCYk obrigada ğŸ˜˜.
Holo Pusheen	I wish I could've gone. ;-;
Ğ’ĞµĞ½ĞµÑ€Ğ° Li	Thank you, Camila!)For your achievements! !u r amazing! !!â¤â¤
Youssef Gamer O	NO WORDS TO DESCRIBE HOW MUCH IT IS
Sterfanny Diniz	Why do not you speak spanish ?
Nogard Martell	saliÃ³ mi mano alvvv
Ross Spears	she's so precious, this world doesn't deserve her.
Mariana Santana Lugo	ESTOY TAN ORGULLOSA DE TI, IDOLAAAAA:)
Î¤Î¬Î¼Î¹ Î¤Î±Ï†	I want her to visit Greece or to come here for a concert  @DorkyCabello
Sangam Grg	Camelia you are so beautiful i love youğŸ˜˜ğŸ˜˜â¤ğŸ’«
Reyna Cuevas	ğŸ‡²ğŸ‡½ MÃ©xico te ama ğŸ’œğŸ‡²ğŸ‡½
Siwy Siwus	ğŸ’‹ğŸ€ğŸ’•ğŸ˜ˆ
Bollywood Goddess	Elotes are bomb dude! <3
Daniel Duffield	WE LOVE YOU CAMILA! THANK YOUğŸ’—
Alejandra GonzÃ¡lez	ahuevo! jajaja
Marcelo Eduardo	Ela Ã© tÃ£o fofinha gente ğŸ˜Œâ¤
Camren0071	Love you, Cutie!
Woop! Sh*t	Proud is understatement for this girl. ğŸ™Œ
Ximena Garcia	Come to Guatemala
Jennysee	So proud of you Camila ğŸ‘ğŸ¼ğŸ‘ğŸ¼ğŸ‘ğŸ¼ğŸ‘ğŸ¼ğŸ‘ğŸ¼ğŸ‘ğŸ¼ğŸ™ŒğŸ¼ğŸ‡²ğŸ‡½â¤ï¸
Ana Beatriz	Beatifullllllâ¤â¤â¤â¤â¤â¤â¤
Sue Prosser	I love this music bye beautiful lovely hot Camila Ya it's true love never be the same I love her god bless you beautiful lovely hot Camila she looks so great and very beautiful hubba hubba hubbağŸ’ğŸ’ğŸ’ğŸ’ğŸ’ŸğŸ’ŸğŸ’ğŸ’ğŸ˜ğŸ˜ğŸ˜ğŸ˜ğŸ˜ğŸ˜ğŸ˜ğŸ™ğŸ™ğŸ™ğŸ˜‡ğŸ˜‡ğŸ™ğŸ’ğŸ™ğŸ’ğŸ™ğŸ’ğŸ’ŸğŸ’ŸğŸ’—ğŸ’—ğŸ’—ğŸ’–ğŸ’–ğŸ’“ğŸ’“ğŸ¶ğŸ¶ğŸ¶ğŸ¶ğŸ¤
chan thea	Camila do you guy ready for Halloween ğŸƒ tomorrow
joe bob 47	I really like this girl.  plus, like, she can sing!
VerÃ³nica	10:53 *Ah huevo* !
ThatÃ¡ Santos	Quero um do Brasil tb =D
Alicia Santos	Sou muito sua fÃ£ Camilinha ğŸ˜ğŸ˜˜â¤
Alondra H	todos mirandole el qlo a camila cuando el camarÃ³grafo lo enfoca :v
doÄŸa bayraktar	love you from turkey
Damilyd Daniela Diaz Sanchez	Te amooo! A webo! ğŸ˜‚ğŸ˜‚â¤ï¸ğŸ‡µğŸ‡¦
Cinthia R	Mija haya sido en espaÃ±ol jaja
Bell Reyes	Wey no mames,te amo un chingo ğŸ˜­ğŸ’•
my music diaries	Love it...
anto lopez	Ame el final ğŸ˜‚
User User	I love u camila ur great
ZDBP Bohorquez	Beautiful ğŸ˜ğŸ˜
Ellen Beatriz	Brazil love Camila Cabello Forever â¤â¤â¤â¤ğŸŒ¹
Lna girl	EARLYYY
lps Candy tv toys	ğŸ’•ğŸ’•ğŸ’•
Koala_Bear_Camila	I love that like 85% of Camilaâ€™s fans speak Spanish, but Iâ€™m just kinda an outcastğŸ˜† BUT, I am in the process of learning Spanish rn cuz Iâ€™m just in love with Spanish culture and the language just sounds so nice and because of Camila too obviouslyğŸ˜‚â™¥ï¸âœ¨
Chihuahuas Chihuahuas	To be honest it feels good because the only closes thing that represents Mexico here in the USA is or was Veky G! So I just feel there are not too much Mexicans in the music industry in the USA only Puerto Rican artist and its just getting annoying.
Agustina Guzman	te amo tantoooo
pebe	AGUEVO
Wendy Pita	Wow me encanto â¤  Cuando vienes a Colombia?
Dana Sanz	0:13 ğŸ˜‚ğŸ˜‚ aprovechando que venÃ­a la cÃ¡mara para meternos en la fila ğŸ˜‚ ilusas que pensaban que era Camila la que habÃ­a salido y se salÃ­an de sus filas ğŸ˜ˆ AJAJAJAJA QUE CHINGON HABER SIDO PARTE DE ESTO
lil oreo	4:15 father and daughter goals â¤
Fani Urib	LLORE CON LA PARTE DE LAS ROSAS, NO PUEDO CAMI, ERES LA MEJOR
Harshita Gera	Daddy got fired ğŸ˜„
Giorgia Coppola	Iâ€™m so proud of you my baby ilysm â¤ï¸â¤ï¸â¤ï¸â¤ï¸â¤ï¸
ariana ft mendes	ti amo
Jadielis Negron	9:00 ğŸ˜‚ viva MÃ©xico cabron*
Mel Richo	I love how much she admires her cultural background
Camren Na Ãrea	Brazil loves you
Maiyesha Ekra	ğŸ’šğŸ’šğŸ’œ
Prettycasual 2015	I admire you for beign so open and proud about your immigrant roots, and I totally understand this videos was focus on your proximity to Mexico. But what about Cuba? We will really appreciate some content on your other side of the story.
7 subscribers	Thankyou alanjendro cabello  *idk if I'm writing his name right well in that case thankyou Camila's dad and sinu
simplynakie	This is the reason why she is loved around the world. Camila is an inspiration. She is beautiful, caring, unique, freaking talented and proud of her heritage. Iâ€™m sure she has her flaws but honey this girl is AMAZING!!! â™¥ï¸ğŸ‘ŒğŸ¾ğŸ‘ğŸ¾â™¥ï¸
Farzana Akter	don't know if I will meet her someday but really want to ğŸ˜­
Nawaf 15	6:25 what I thought they broke up
Xmin RobloxX	*CAMILAAAAAAAAAA CABELLOOOOOOOO*  *YOU R MY FAV SINGER, IM SO PROUD OF YOUUUUUUU*  ((Fangirls soo much))
goust 7	Hi Camila o Brasil ta chegando GOSTOSA MEIA BRASILEIRA kkkkkk
Giovanni Marconcini	yea
Sania Haq	and I FREAKING love u  QUEEN CABELLO â¤ï¸â¤ï¸ğŸ˜˜ğŸ˜˜ğŸ–¤ğŸ–¤ğŸ˜ğŸ‘‘
Ines Yahi	My good... this girl... I love you camila...ğŸ˜¥ğŸ˜ğŸ˜ğŸ˜ğŸ˜
Archana S Kumar	Please come to india
Erika Da SilvaxMendes	Just wow
Leidi Viviana Imbachi	Wow
LA MAIO	The best
respectformyenergy	VIVA MEXICO CARBRONES
dava sagarha	THAT LAUGH......
Anita Dawood	I fricken love these diaries of Camilas life! Iâ€™m so interested I wish she makes more of them
Marina Urdaneta	Hermoso
willse _	10 milion subscribers S0oon
Ann Louise De Leon	Finally a Vlog Diary ğŸ˜ğŸŒ¹
youcef franco	Ø¯ÙŠØ¯ÙŠÙƒØ§Øµ Ø§Ù„Ø§Ù†Ù‚Ø±ÙŠ ğŸ˜¡âœŒ
Tanaka Kuu	ğŸ‘ğŸ‘â—ğŸŒ
Rashid Khan	We should be proud of our country land
Reinzel Manaay	Goosshhh i wish i'll meet you in personalğŸ˜­ğŸ˜­
nurun nahar	Here before 1M....
Meenu Dogra	6:28 ..matthew hussey wth
abhi lala	Love you Camila ğŸ’•ğŸ’‹ğŸ’‹ğŸ’‹ğŸ’‹
Step It Up	camila is something that makes me happy all the time
Aline Martins	Lindaa!!!! Divaaaaa!!!â¤â¤â¤ AlguÃ©m do BR?
jiya gour	Eres un gran cantante en el mundo y te amo
Lujain Zia	I love u Camila!! I'm so proud of how far you have come
Mauricio Alejandro	8:58 "Viva MÃ©xico cabrones" ja ja ja me encantÃ³ esa parte ğŸ˜†â¤
Maki Sama	*want to be mexican*
Just For You	If you're reading this...         Have a nice day!! Stay who you ARE and never change for anyone or anything. Life is gonna get better,you just have to wait a little bit.
N3MESIS stars	Like si apareces en la fila del inicio :3
Shxninq	Love your voice so much, Camilaâ¤â¤ tbh Avril Lavigne's voice tooâ¤â¤
Ranessa Relucio	Love the diary ğŸ˜˜
kate love	Camila cabillo love u ğŸ’–
Abhishek Kumar	I love you Camila ğŸ’‹ğŸ’‹ğŸ’‹ğŸ’‹
MeDicenKass	Un dÃ­a voy a verte en vivo, esta vez no ocurriÃ³. Pero pasarÃ¡... ğŸ˜ğŸ¤ğŸŒ¹â¤
Luiyi Cortes	Â¡Viva MÃ©xico! ğŸ‡²ğŸ‡½
Israel &Darlene GarcÃ­a Bernal	ELLA ES CUBANA,QUE BIEN QUE AMES A MÃ‰XICO QUE TE DIO Y TE ACOGIÃ“ EN SUS BRAZOS
IILOVETENTAICON	DAB
ìì´ì–¸ì¸ giants	I love youuuuuâ¤ï¸â¤ï¸â¤ï¸â¤ï¸
Rocio Flores	Me da mucho gusto ğŸ˜Œ que tu camila hayas pisado nuestra tierra MÃ©xicana y muchas gracias por compartir tus vÃ­deos ğŸ“¹ ğŸ˜Š y es pero algÃºn dÃ­a pueda conocerte en persona y yo le doy gracias adiÃ³s por que te regalÃ³ una voz muy hermosa ğŸ¤ğŸ¹ğŸ¸ğŸµğŸ¶sabes Camila mi mente te imagina al ver tu rostro y tu sonrisa y mis oÃ­dosğŸ‘‚es cuchan la canciÃ³n y diciÃ©ndole a mi corazÃ³n â¤ no estÃ©s triste ğŸ˜¢ por favor ya sonrie â˜º por que Camila ya llegÃ³ y ahora ya mi corazÃ³nâ¤ palpita y brincağŸ’— de emociÃ³n ğŸ’“ğŸ’—ğŸ’“ al es cuchar esta hermosa  canciÃ³n ğŸµğŸ¶ de Miami a MÃ©xico y ahora mi sonrisa ya volviÃ³ ğŸ˜Š  muchas pero muchas felicidades Camila te de seo lo mejor te mando un fuerte abrazo  des de el estado de MÃ©xico ğŸ‘ğŸ™‹â˜º
Titan	une fille et une famille absolument gÃ©niale, wow , je vous aime les Cabello'ssssssssss
Ari Moldavia	ğŸ˜â™¥ï¸ hermoso
Jackie Fuentes	Cami, no querÃ­a ser demasiado rara o explosiva pero honestamente, ME HICE LITROS Y LITROS DE PIPÃ Y LLORÃ‰ A MARES, MARES INMENSOS... (irÃ© por agua) Ya en serio, estuve segundo a segundo checando a detalle a ver si salÃ­a en el video ğŸ˜‚ MIJA! TE LUCISTE EN CADA SHOW ğŸ¦‹ Y ESTOY MUY ORGULLOSA Y AGRADECIDA CON DIOS POR HABER SIDO PARTE DE ESTA EXPERIENCIA EN LA CDMX. âœ¨âœ¨âœ¨ TE AMOOOOOO ğŸ‡²ğŸ‡½
G C Lo	De MIAMI a MÃ‰XICO!!! ğŸ‡²ğŸ‡½ğŸ‡²ğŸ‡½ğŸ‡²ğŸ‡½  esta cosa se prendiÃ³ baby Just never let me go,  if you love me let me know, baby  I wanna love you INSIDE OUT!!!  AHUEVOOO!!! ğŸ‡²ğŸ‡½ ğŸ‡²ğŸ‡½ ğŸ‡²ğŸ‡½
Lety Mendoza	Te adoramos todos los de MÃ©xico y espero algÃºn dÃ­a conocerte con todo el  corazÃ³n I love you Camila cabello
akrmfthyalkwmy ALKWMY	Camila U got a beautiful  and kind family GOD bless all .give me a big KISS ğŸ’‹ğŸ’‹ğŸ’‹ğŸ’‹ğŸ’‹ğŸ’‹ğŸ’‹ğŸ’‹ğŸ’‹
Ashley Jade	Camilaaaa Pls visit the Philippinesss!!! You have a lot of Filipino Faaannnsss!!! <3
Mary R5	I love it ! Love u Camila ğŸ’—ğŸ’—ğŸ’—ğŸ’—ğŸ¤ğŸ¤ğŸŒˆğŸŒˆğŸ’˜ğŸ’‹ğŸ’˜ğŸ’‹
Black Rose Beatz TYPE BEATS & RAP INSTRUMENTALS	ğŸ“‚Documents   â””ğŸ“Music       â””ğŸ“Camila Cabello           â””ğŸ“ Bad Songs                â””âš ï¸ This folder is empty
Lele CastaÃ±eda	No pude ir ğŸ˜ğŸ˜ sali tarde de la prepa ğŸ˜’ğŸ˜’ğŸ˜’
Lps. Joelle	Love you Camilaâ¤
Lil Mai	MaTThew Hussy nah ğŸ™„
Kevin GÃ³mez	ğŸ˜ğŸ˜ğŸ˜
Diana lopez	WOW no puedo creer que la vi en el concierto este vÃ­deo nunca lo olvidarÃ© porque me trae muchos recuerdos de el Never Be The Same Tour 2018 en Monterrey no puedo creer que la vi y que estaba en primera fila WL MEJOR CONCIERTO DE LA VIDA ğŸ˜˜ğŸ’—ğŸ˜ğŸ˜
Lizette VÃ¡zquez	De lo mejorğŸ˜
Claudia RX	Camila â¤â¤â¤â¤ te amoâ¤
XxJustViannaxX	Awww she's adorable ğŸ˜˜
ÙŠØ§Ø³Ù…ÙŠÙ† Ø¹Ù…Ø±	ÙØ®Ø±Ùƒ Ø¨Ø£ØµÙ„Ùƒ Ø¹Ø¸ÙŠÙ… ğŸ‘ğŸ‘ğŸ‘
Morgan Style	Mi amorr estoy orgullosa d ti  ğŸ˜ğŸ˜˜ğŸ˜˜ğŸ˜˜ aunq no eh tenido el placer d conocerte, deseo un dia poder hacerlo ğŸ¤—â˜ºğŸ˜ ya me siento parte d tu familia son hermosos todos ustedes ğŸŒ·
æ˜¥à¸®à¸²à¸£à¸¸	ğŸ’“ğŸ’“ğŸ’“ğŸ’“ğŸ’“ğŸ’“
casey mart	Not body shaming but did she gain weight or is she pregnant?
Ayub Shaik	Hello mom
Yash Tanwar	Every father needs a daughter like her ..... one word for you Camila : Adorable !!
Ariana Buterah26	can't wait for the next chapterğŸ˜
Lucia Romero	CAMILA QUE DECEPCIÃ“N PORQUE CHINGADOS NO LE PUSISTE CHILE A TU ELOTE ESO ES ILEGAL MIJAğŸ˜‚ğŸ˜‚â¤ï¸â¤ï¸â¤ï¸â¤ï¸â¤ï¸â¤ï¸
Eduardo Villanueva	agueboooooooo -yo ahora, para todo
Assamese bikre	ğŸ˜ğŸ˜ğŸ˜ğŸ˜ğŸ˜ğŸ˜ğŸ˜ğŸ˜ğŸ˜ğŸ˜ğŸ˜ğŸ˜ğŸ˜ğŸ˜ğŸ˜ğŸ˜ğŸ˜ğŸ˜ğŸ˜ğŸ˜ğŸ˜ğŸ˜ğŸ˜ğŸ˜ğŸ˜ğŸ˜ğŸ˜ğŸ˜ğŸ˜ğŸ˜ğŸ˜ğŸ˜ğŸ˜ğŸ˜ğŸ˜ğŸ˜ğŸ˜ğŸ˜ğŸ˜ğŸ˜ğŸ˜ğŸ˜ğŸ˜ğŸ˜ğŸ˜ğŸ˜ğŸ˜ğŸ˜ğŸ˜ğŸ˜ğŸ˜ğŸ˜ğŸ˜ğŸ˜ğŸ˜ğŸ˜ğŸ˜ğŸ˜˜ğŸ˜‹
Monse Tapia	Me preguntÃ³ porque no hablo en espaÃ±ol jssjss
guess what	wow she is more popular than fifth harmony now such an inspiration love you camila from philippines ğŸ‡µğŸ‡­ğŸ˜˜âœ¨
Sudipta Saha	Wow.. sooo much passion .. sooo much love.. amazing.. after watching this I feel very happy and  excited 4 new chapter in my life.. thanks Camila 4 inspiring me..
Aji Priambodo	Wtff Matthew ğŸ’€ğŸ’€ğŸ’€
Alii Horan Grande de Tomlinson	Alguien lo tiene subtitulado ajjxja
MADISON ALVRD	En MÃ©xico siempre tendrÃ¡s una familia hermosa asÃ­ como taquitos, elotes y you know baby â¤ï¸ğŸ’ğŸ»â€â™€ï¸ğŸ‡²ğŸ‡½ğŸŒ¯
Tyler Garcia	Viva MÃ©xico Cabrones ğŸ™ŒğŸ¼ğŸ˜œğŸ‡²ğŸ‡½
Alondra SÃ¡nchez	No te entendÃ­ ni madres pero te amoâ™¥
Angela Torres	Ver a Camila cantando MÃ©xico en la piel con su papÃ¡ me llenÃ³ de tanto orgullo, estoy muy feliz de haber experimentado el nbts tour viva MÃ©xico ğŸ‡²ğŸ‡½ğŸ‡²ğŸ‡½
Dulce Laureano Morales	I love you <3
Top Psnsho 5	Im from MÃ©xico
Mitzi Morales Zavala	YO ESTUVE AHÃ PRRAS â¤ğŸ˜ğŸ˜ğŸ˜
Caitlin Mommers	â¤â¤ Please come to Australia â¤â¤
jamaicangirl forever	Another English comment ğŸ˜‚ğŸ˜‚ğŸ˜‚
Dya Lez	Â¡Â¡Te amoooo!! â¤â¤â¤â¤â¤â¤â¤â¤ Yo fui al concierto en Monterrey, te veÃ­as toda preciosa.ğŸ’–ğŸ’–
cyberhce	tE AMO CON TODO MI SER AAAAAAAA.
Sofia Balderas	A huevo ğŸ˜‚ğŸ˜‚ğŸ˜‚
Cutix 7	Sigo pensando como llegaste a conquistarme .
TaniaLpzrodrgz 98	imaginense que en vez de q camila se dedicarÃ¡ a la mÃºsica y fuera youtuber y que hiciera colaboraciones  con otros youtubers como x ejemplo los polinesios yuya debryanshow la divaza yellowmellow etc etcğŸ˜‚ğŸ˜‚ğŸ˜‚.
Armando Organista	I love you ğŸ˜ğŸ˜ğŸ˜ğŸ’–ğŸ’–ğŸ’–ğŸ˜ğŸ˜ğŸ’–ğŸ’–ğŸ’–ğŸ’–â¤â¤â¤â¤â¤
Layn Lapid	love youuuuuu ğŸ’–
JadenBladeM M	Viva MÃ©xico cabronesğŸ˜â¤ï¸ Camila 2018
Elsa Luna	No mameeees TE AMOOO alv, verte despuÃ©s de todo lo que estuve pasando en los Ãºltimos meses fue el mejor regalo de cumpleaÃ±os que pude darme jaja TE ADORO CAMILITA <3
Kokuten NSH	â¤u thats for sure
i haveabasketballgametmrw	OMG MY HEART JUST MELTED WHEN SAW MATTHEW AND HER FAMILY ğŸ˜¥
Martha Mora	No entendÃ­ nada de lo que dijo en ingles!ğŸ˜‚
Sandra Rosas	I love youâ¤ï¸â¤ï¸ğŸ˜˜ğŸ˜˜ğŸ˜ğŸ˜ğŸŒ¹ğŸŒ¹ğŸ‡²ğŸ‡½ğŸ‡²ğŸ‡½
Christopher Escobar	Is she coming to los angeles
Andres Perz	Alguien que me explique por que la amo tanto? ğŸ˜¢ğŸ˜
Betzabe Valencia	ARRIBA MÃ‰XICO CABRONESâ¤ï¸ TE AMOâ¤ï¸
Erasmo Rios	Hey Camila I just want to say that my dad is the same way his from Mexico and he love tacos and he loves singing and I wish that you would come to San Antonio because I will love to see you Camila and you are so funny and cut please come to San Antonio Camila  ğŸ˜˜ğŸ˜˜ğŸ˜˜ğŸ˜˜ğŸ˜˜ğŸ˜˜ğŸ˜˜ğŸ˜˜ğŸ˜˜ğŸ˜˜ğŸ˜ğŸ˜ğŸ˜ğŸ˜ğŸ˜ğŸ˜ğŸ˜ğŸ˜ğŸ˜ğŸ˜
Cecy DÃ¡vila	Me encantÃ³ el show de Guadalajara, estarÃ© ahÃ­ la prÃ³xima vez que nos visites!!! <3
Karla Lopez	Dice MÃ©xico, y entrando pensando que iba a estar en espaÃ±ol haha  Te amo Camila, gracias por ser una inspiraciÃ³n para mÃ­ y por ser mi Ã­dola, y lo que mÃ¡s me fascina es que te llamas como yoooo (Karla), me hubiese encantado poder estar en una de tus presentaciones, ya casi se acerca mi cumple y lo que mÃ¡s quiero es una prenda NBTS ğŸ’—
Salaiyah Reyes	The transitions though and cinematography ğŸ˜ğŸ˜ğŸ˜ğŸ˜
Diana Rojo	Te amo un chingo â¤ï¸ AGUEVOğŸ˜‚
Aniruddha Biswas	the directer is Indian??????????
Olivia Stylinson	Me siento tan orgullosa de ser mexicana y haber estado en ese concierto, de poderte ver cantando con tu papÃ¡ e inspirando a millones de personas, eres la persona que mas admiro en este mundo, te amo demasiado, no puedo explicar lo tanto que te amo y que tanto me inspiras, eres la persona mas humilde, hermosa, amable y comprensiva que conozco, gracias por ser tu, gracias por siempre tomarte tu tiempo para hacer cosas por nosotros, no podrÃ­a tener mejor Ã­dola, te amo, VIVA CAMILA CABRONES
Alex Navarro	YOOO I CANT WAIT FOR CC2
_Wolfvee _	English commenters?
Aline Rosales	Te amo muchÃ­simo, gracias por el mejor dÃ­a de mi vida â¤ï¸
Evelyn Barragan	ğŸ‡²ğŸ‡½ ğŸ˜
Diego Andres Sagrero Lopez	XD viva MÃ©xico kabroness
el unknow	fue maravilloso este tour nbts no puedo esperar mas para  estar en el siguiente
r. yulissa peralta perez	Ya decÃ­a yo que era muy raro que casi no hiciera nada en sus redes sociales respecto a los conciertos en MÃ©xico
ZAUTHIUS	Just love you camilaâ¤
Azucen Blancas	MÃ©xico y Camila en la piel â¤
Jimena Davila	Querida camila te amo un chigo pero Â¿porque chingados no hablas espaÃ±ol? :'c
Andy Bubble	TE AMOOOOOOOOOOO
Ratna Babaria	Directed by Rahul Bhatt !!!!! Wait....is he Indian????
Supermarket flowers	Fui al concierto en Guadalajara sin realmente ser fan, y me llevÃ© una gran impresiÃ³n. A pesar de eso, disfrutÃ© mucho la mÃºsica, baile, brinque, me divertÃ­ muchÃ­simo. Y lo mÃ¡s importante me hizo sentir querida. Muchas veces artistas internacionales menosprecian a su pÃºblico mexicano/latinoamericano, (he ido a varios como Ed Sheeran, 5 Seconds of Summer etc) y este ha sido el Ãºnico que me ha hecho sentirme agradecida de ser mexicana, y el gesto del mariachi fue Ãºnico. Camila Cabello es una gran artista y gran persona. DeberÃ­amos hacer famosa a mÃ¡s gente como ella
Susan Clarke	Sabes me acabo de dar cuenta que te amo mÃ¡s de lo que imagineâ¤ Viva MÃ©xico cabrones !!!!!!!ğŸ‡²ğŸ‡½ğŸ‡²ğŸ‡½ğŸ‡²ğŸ‡½ğŸ‡²ğŸ‡½
Rina Mensola	I love you camilağŸ˜Šso proud of youğŸ˜ğŸ˜
Sarai Alonzo Zambrano	IncreÃ­ble video ...solo me hubiera gustado q hablara en espaÃ±ol muchos no pueden entender q dice ...igual me encanta q se siente orgullosa de sus raÃ­ces ...Camila eres lo mÃ¡s !
Pamela Dextre	Literal se me borrÃ³ la sonrisa cuando aparecio el tucÃ¡n -.-
Mayra	te amooo <3
Lebni Vladimir Cuenca	Y ecuador pa cuando baby ğŸ˜‚â¤Â¡
Anahi GÃ³mez	Yo fui al de la CDMX el 24 de septiembre!Â¡ Uno de los mejores conciertos y dÃ­as de mi vida!!ğŸ’–ğŸ’–ğŸ’– MÃ©xico te ama!!ğŸ‡²ğŸ‡½ğŸ˜„  Eres genial CamilağŸ’–
Christopher MÃ©ndez :3	Viva MÃ©xico cabrones â¤â¤
Ary Beivide	Princesa, te amo como no tienes una idea. SÃ© que salÃ­ en el vÃ­deo, y me siento tan emocionada de haber formado parte de tu primer tour en MÃ©xico, tu tierra.â™¡
Sandra Vasquez	I love you Camila, Congratulations ! ğŸ˜³ğŸ˜³ğŸ’•ğŸŒŒğŸ˜Š
jenny potter sharma	Mexico
Grondin Sarah	Ho my gad ! She's beautiful! Ella es muy bonita â¤ï¸ I love you ğŸ’œ
ANA LUISA VERGARA GARCIA	Mexico Loves You â¤ï¸â¤ï¸â¤ï¸ğŸ‡²ğŸ‡½ğŸ‡²ğŸ‡½ğŸ‡²ğŸ‡½
Diana Legazpi	Espero que sea de tu gran agrado nuestro hermoso pais y la pases muy bien  Saludos Camila
Helena 06	Wow Camila you are amazing! I love you as much as you love bananas ğŸ˜â¤ if that is possible ğŸ˜‚ #Camilizer
Joshua Mascarenhas	Pls tour of India
Nicky HernÃ¡ndez	AY LA AMO SHE IS SUPER HUMAN AND FAMILIAR ANDIWODHOW THAT IS WHAT I WANT FOR ME IN A FUTURE AS A SINGER TE AMO CAMI ERES LO MEJOR DE LO MEJOR NUNCA CAMBIES QUE TUS FANS WE ARE AS CRAZY AS YOU ğŸ˜‚â¤â¤â¤â¤
Miguel Eliosa	SALI AHI EN  EL VIDEO ğŸ˜­ğŸ‡²ğŸ‡½  TE AMO MUCHO ğŸ˜ğŸ˜­
Coco	Omfg I love you so much
Diana Hernandez	Beautiful Camila Cabello Just beautiful and talentedğŸ˜â¤ğŸ˜­ğŸ¤ğŸ¶
Sr. Tec DIVULGA	ğŸ‘ğŸ»ğŸ¬â¤â¤â¤
Mayrel Soto Rangel	I'm so sad that I couldn't go to one of your concerts. Maybe next time, but I'm super happy for you, you honestly slayed in Mexico and I'm so so proud of you ğŸ’•
Christina oh na na	TE AMOOOO ğŸ˜­ğŸ˜­â¤ LLORÃ‰ VIENDOLO. VIVA MÃ‰XICO CABRONES!
Anna villanuevaâ€ 	no mames! ğŸ˜­ğŸ˜­ Te Amo Tanto!ğŸ˜ğŸ‡²ğŸ‡½
Lucas Cruz	I went to her show in Curitiba - Brazil. I made a mexican poncho personalized with her songs. Part of my family is from Mexico and I love the culture and everything! Camila, you are an inspiration for me as a dreamer.  VIVA MEXICO!
damarys CÃ¡rdenas	ğŸ˜­ğŸ˜­ğŸ˜­ğŸ˜­ğŸ˜ğŸ˜ğŸ˜â¤
ê²½ë¸”ë¦¬	ì§„ì§œ ë„ˆë¬´ ì˜ˆë»ã… ã…   ë‚´í•œí•´ì£¼ì„¸ìš”ã… ã… ã… ã… ğŸ‡°ğŸ‡·ğŸ‡°ğŸ‡·
maalik Maldonado	Te amo camila
itz.karenli	Auevo jsjsjsjs
Mone Fukuhara	PLEASE COMEBACK TO JAPAN
Val Arriaga	ESTOY LLORANDO, MÃ‰XICO TE AMA MUCHÃSIMO CAMILAAA
Jules Marrujo	I loved this video so much. This family is so beautiful. The only thing I hated was having to be subjected to Hussey's stupid face. Ughhh....Why?
Marco Huerta	Te amamos Camila â¤ï¸â¤ï¸ğŸ‡²ğŸ‡½â¤ï¸â¤ï¸
D.C.I.	Camila todo precioso, lindo, bello, tu eres un ser especial, cautivador. No se si nos estas preparando a los fans latinos algo sÃºper grande y hermoso en espaÃ±ol, sabes que en ese mismo momento nos vamos a morir todos de la emociÃ³n que nos va recorrer por todo el cuerpo. Camila por favor habla mas en espaÃ±ol, lo hablas muy bien tienes un acento hermoso y a mi me hipnotizas cada vez que lo haces. Creo que tu voz es hasta mas linda. Igualmente te AMO en cualquier idioma ğŸ˜˜
jackie kook	This touched my heart and reminded of my father and family ğŸ‡²ğŸ‡½ğŸ‡²ğŸ‡½ğŸ‡²ğŸ‡½ğŸ‡¨ğŸ‡ºğŸ‡¨ğŸ‡º
Yineida Garibaldi	I love how she gose for sirues to borky and then bake to sirues it so freaking adorubole
Jemima Padilla	Te amooo Camila!!â¤ Ecuador pa' cuando?
Ile Barajas	Ya regresa:(
Vanessa's Voice	This is so unrelated but Camila should make vlogs! Her personality, her family, life, etc seems so entertaining and she's obviously sticks to being herself and being "normal" I would love to see the behind the scenes. I know she doesn't like being on social media and on her phone a lot though, but it's still a cool idea :)
monzeren Muce	Por que eres tan hermosa!!! Le agradezco tanto al universo que hayas aparecido en mi vida eres un Ã¡ngel en todos los sentidos!!!! #MyLittlePrincess #VivaMexico #AGuevo
Brenda Silva	Te AmoğŸ˜­ğŸ˜­â¤
Melissa Grohl	Yo salgo ahÃ­, te amo muchÃ­simo. â¤â¤â¤
Giovany Luna	8:59
MmeGazelle PÃ©nÃ©mone	T es trop belle
Sidharth Kumar	Koi India sy h kya ğŸ‘like
Eduardo Alfonso	â¤ğŸ’ğŸ‘ŒğŸ™Œ Gracias Camila! MÃ©xico te ama ! Someday estarÃ© en uno de tus conciertos :'D
America Adame	Camila te amo eres la mejor
lizbeth Thin	Pobre estafa de Matt le querÃ­a dar los 5 al suegro y el suegro lo ignoro ğŸ˜‚ğŸ˜‚
Amanda Balcazar	*ğŸŒ»MÃ‰XICO TE AMA CAMIğŸŒ»NO LO OLVIDES, CUANDO QUIERAS VOLVER TE ESPERAREMOS CON LOS BRAZOS ABIERTOS*  *_ğŸ’šVIVA MÃ‰XICO CABRONESâ¤_*
Louella	Too many spanish comments here i love how they support camila and so are we.ğŸ’–ğŸ’–ğŸ’– congrats you just found another english comment.
Gilbert Tan	Love u camila ğŸ˜ğŸ˜ğŸ˜ŠğŸ˜ŠğŸ‘ğŸ‘ğŸ’–ğŸ’–â¤â¤
Nicee C.I	Oww ğŸ’š  â¤ ğŸ˜ğŸ˜ğŸ˜ğŸ˜ğŸ˜ğŸ˜ğŸ˜ğŸ˜ğŸ˜ğŸ˜ğŸ˜ por eso te amo â¤ğŸ˜â¤ me encanta tu humildad ğŸ™ babe eres unica la mejor  la mejor ğŸ¤ğŸ¶ğŸ¶ğŸ¶ğŸ¶ğŸ‘‘  hermosa ğŸ˜˜ te amo â¤â¤â¤â¤â¤  ğŸ˜ğŸ˜ğŸ˜ğŸ˜ğŸ˜ğŸ˜ğŸ˜â¤â¤â¤â¤â¤
Chromium 7	Hid one kiss in this loooove emoji  ğŸ˜ğŸ˜ğŸ˜ğŸ˜ğŸ˜ğŸ˜ğŸ˜ğŸ˜ğŸ˜ğŸ˜ğŸ˜ğŸ˜ğŸ˜ğŸ˜ğŸ˜ğŸ˜ğŸ˜ğŸ˜ğŸ˜ğŸ˜ğŸ˜ğŸ˜ğŸ˜ğŸ˜ğŸ˜ğŸ˜ğŸ˜ğŸ˜ğŸ˜ğŸ˜ğŸ˜ğŸ˜ğŸ˜ğŸ˜ğŸ˜ğŸ˜ğŸ˜ğŸ˜ğŸ˜ğŸ˜ğŸ˜ğŸ˜ğŸ˜ğŸ˜ğŸ˜ğŸ˜ğŸ˜ğŸ˜ğŸ˜ğŸ˜ğŸ˜ğŸ˜ğŸ˜ğŸ˜ğŸ˜ğŸ˜ğŸ˜ğŸ˜ğŸ˜ğŸ˜ğŸ˜ğŸ˜ğŸ˜ğŸ˜ğŸ˜ğŸ˜ğŸ˜ğŸ˜ğŸ˜ğŸ˜ğŸ˜ğŸ˜ğŸ˜ğŸ˜ğŸ˜ğŸ˜ğŸ˜ğŸ˜ğŸ˜ğŸ˜ğŸ˜ğŸ˜ğŸ˜ğŸ˜ğŸ˜ğŸ˜ğŸ˜ğŸ˜ğŸ˜ğŸ˜ğŸ˜ğŸ˜ğŸ˜ğŸ˜ğŸ˜ğŸ˜ğŸ˜ğŸ˜ğŸ˜ğŸ˜ğŸ˜ğŸ˜ğŸ˜ğŸ˜ğŸ˜ğŸ˜ğŸ˜ğŸ˜ğŸ˜ğŸ˜˜ğŸ˜ğŸ˜ğŸ˜ğŸ˜ğŸ˜ğŸ˜ğŸ˜ğŸ˜ğŸ˜ğŸ˜ğŸ˜ğŸ˜ğŸ˜ğŸ˜ğŸ˜ğŸ˜ğŸ˜ğŸ˜ğŸ˜ğŸ˜ğŸ˜ğŸ˜ğŸ˜ğŸ˜ğŸ˜ğŸ˜ğŸ˜ğŸ˜ğŸ˜ğŸ˜ğŸ˜ğŸ˜ğŸ˜ğŸ˜ğŸ˜ğŸ˜ğŸ˜ğŸ˜ğŸ˜ğŸ˜ğŸ˜ğŸ˜ğŸ˜ğŸ˜ğŸ˜ğŸ˜ğŸ˜ğŸ˜ğŸ˜ğŸ˜ğŸ˜ğŸ˜ğŸ˜ğŸ˜ğŸ˜ğŸ˜ğŸ˜ğŸ˜ğŸ˜ğŸ˜ğŸ˜ğŸ˜ğŸ˜ğŸ˜ğŸ˜ğŸ˜ğŸ˜ğŸ˜ğŸ˜ğŸ˜ğŸ˜ğŸ˜ğŸ˜ğŸ˜ğŸ˜ğŸ˜ğŸ˜ğŸ˜ğŸ˜ğŸ˜ğŸ˜ğŸ˜ğŸ˜ğŸ˜ğŸ˜ğŸ˜
Little Vale Covers	Te amooooo
Fanylina aaa	ğŸ‘ğŸ‘ğŸ‘ğŸ‘ğŸ‘âœŒğŸ‘ğŸ‘ğŸ‘ğŸ‘ğŸ’–ğŸ¶ğŸ™ŒğŸ‘ğŸ‘
Jos Santillan	VIVA MÃ‰XICO CABRONES! â¤ğŸ‡²ğŸ‡½
A A	Te amamos mucho ğŸ‡²ğŸ‡½â¤ï¸
anabel Arg!!!	Jjajaaj che que es ese choclo blanco q come?  Como que supero lo disfruto.  Se ve que la paso muy bien, se la ve feliz
kakaroto sj	Eres la mujer mÃ¡s hermosa del mundo y tienes un talento que cualquier quisiera tener y me da gusto que ames MÃ©xico y que no te de pena ser mexicana ahuevo jajaja Mori al Ãºltimo te amoooooğŸ‡²ğŸ‡½ğŸ‡²ğŸ‡½ğŸ‡²ğŸ‡½ğŸ‡²ğŸ‡½ğŸ‡²ğŸ‡½ğŸ‡²ğŸ‡½ğŸ‡²ğŸ‡½
XIMENA juarez	9:00 VIVA MEXICO CABRONES !!!!!! ... cami te amo â¤â¤
Nahum Carias	Here's one of the few english commentsâ˜º
Angel Valencia	Friendly advice, don't bother scrolling through the comment section if you don't speak spanish lol
Palomaa Yo	TE AMO CAMILA, ERES LA MEJOR PERSONA DEL MUNDO, Y NO PUDE HABER TENIDO MEJOR IDOLA QUE TU, GRACIAS POR HACER DE ESTE MUNDO UN LUGAR MEJOR, DEFINITIVAMENTE LOS SUEÃ‘OS SE CUMPLEN SI TRABAJAS EN ELLO, GRACIAS POR SER UNO DE MIS GRANDES EJEMPLOS A SEGUIR, ESPERO UN DIA CONOCERTE DE CERCA, Y NO DE LEJITOS, AUN ASI TE AMO, GRACIAS.â¤
Karen Reyes	Te amo ,espero y vuelvas a venir a Guadalajara Jalisco en un prÃ³ximo TOUR ğŸ˜ğŸ™ #Camilizer de â™¥ï¸
JUAN LAZCANO	Hermosisima! â¤ï¸ Gracias por el concierto y la experiencia! âœ¨
Linda Contreras	A HUEVOO!! âœŒğŸ¼
EDRian Variable	Mi amor platonico â¤â¤
EMILY RM	VIVA MÃ‰XICO CABRO#$@!!
Felix  Marquez	Deberias ir a La Habana la tierra que te vio nacer ğŸ‡¨ğŸ‡º
Professor Passion-Fruit	Well, I guess my suspicion is now put to a rest. I thought Matthew Hussey and Camila Cabello broke up because of the consequences video, but I guess not. I wonder what she sees in him...
Michelle Esteves	No entendÃ­ nada ğŸ˜‚ pero amo oÃ­r tu voz y verte tan feliz, eres una chingona Camila te amamos siempre! ğŸ˜â™¥ï¸ğŸ‡²ğŸ‡½ esperando por CC2 ğŸ™Šâœ¨
Diana Lozano	Quien mÃ¡s llorÃ³?
Giselle Casas	Ojala algÃºn dÃ­a vengas a Colombia
stephania sk	In momentos como estos estoy orgullosa de ser Mexicana â¤ï¸ğŸ‡²ğŸ‡½
iCreenadian	Selena! Selena!ğŸ˜ğŸ˜
Charles	I love this
Sara Bernabe	Los Mexas GANANDO COMO SIEMPREEEE
Aneth Garcia	ğŸ˜â¤ï¸â¤ï¸â¤ï¸â¤ï¸â¤ï¸ğŸ‡²ğŸ‡½
Mistah J	-)
Ñ•erendÎ¹pÎ¹Ñ‚y 97	3:38 aww that was so precious milaaa love youu ğŸ˜ğŸ˜™
Laura Pastor	ğŸ’–ğŸ’–ğŸ’–
babyatziri	We love you, Â¡VIVA MÃ‰XICO CABRONES!
Hailey Indof	I love you so much! Iâ€™m so happy I have you in my life and that I met you! Much love for you your such a sweetheart.
Trevosa trevosa mermo Trevosa	Matthew pussey ğŸ‘ğŸ’©ğŸ˜·
Roberto Aldair Peralta Rojas	Y jesse y joy
Pamela Doyle	ğŸ¤©ğŸ¤©ğŸ¶ğŸ¶
Maria Luisa Nava Reyes	ğŸ˜â¤
GABRIEL MOISES ARIAS SANCHEZ	ğŸ˜ğŸ˜ğŸ˜ğŸ‡²ğŸ‡½ğŸ‡²ğŸ‡½ğŸ‡²ğŸ‡½ğŸ‡²ğŸ‡½ğŸ‡²ğŸ‡½ğŸ‡²ğŸ‡½
Isaack Flowerss	Ven a Aguascalientes en la feria nacional de San Marcos ğŸ˜˜ğŸ˜ğŸ˜
San Isidro San Mateo Atenco	Camila Eres la mejor te amo ğŸ’¥â¤ï¸ğŸ˜
Alyssa Jethro	que chingo saber que estuve ahÃ­ ğŸ˜»â¤ï¸
Dulce Aguilar	te amamos camila pero me ubira gustado que ablaras espaÃ±ol no tendiendo ingles por que eres asi bebe camila
tram675	CC RocksğŸ”¥ğŸ”¥ğŸ”¥
Cesilia Romero	Ã‰pico el de Guadalajara ğŸ˜
Khalilah Muhammad	Camila just seems like a sweetheart who is very humbleâ¤â¤â¤â¤
TOPS PARA VOS	Ame este video!, pero te tengo una pregunta, Â¿PorquÃ© no viniste a Uruguay??? Osea era cruzar un rÃ­o. Ahora estas en la lista de los artistas que no vinieron a Uruguay, pero te amo. (gracias a dios Ed Sheeran va a salir de esa lista)
Andy Jauregui	Yo estuve ahÃ­, fui parte de esta experiencia... ğŸ˜â¤ï¸
Jaqueline Zata	Viva CAMILA cabrrrrroneees!!!â¤ï¸â¤ï¸â¤ï¸
janine Javou	She is so genuine and has such a radiance about her. Iâ€™ve always noticed how she speaks of others family and fans just wanting them to be happy. Just love her, great soul!
Rosa Isela	Es tan difÃ­cil no amarteğŸ˜â¤ï¸ gracias por ser una gran inspiraciÃ³n en mi vida like thank you so much I cant wait for the next era. Take care and have a lot of fun in Miami with your fam.  Love,  Rosa Isela
Paola H	VIVA MÃ‰XICO! â¤â¤
sofi polinesia	EN MEXICO TE AMAMOS COMO NO TIENES IDEA! ğŸ‡²ğŸ‡½ğŸ’“
Dianne Alex Tecson	i love youuu
paia bdd Dohling	Camila Cabello ğŸ˜my best of all timesğŸ‘
mateo	VIVA MÃ‰XICO CABRONEEEES
Anthony Peart	THE ENGLISH COMMENT YOURE LOOKING FOR!!!
Jenny Gualpa	â¤â¤
lovesmusic916	Eyebrows on fleeeeeek.
Kirly Rendoza	camila mi amor! DILE AL PRRO DE SHAWN QUE LO NECESITO EN MÃ‰XICO YA :'V
Katyy Ojeda	ğŸ˜ğŸ˜ğŸ˜ğŸ˜ğŸ˜ğŸ˜ğŸ˜ğŸ˜ğŸ˜ğŸ˜ğŸ˜ğŸ˜ğŸ˜ğŸ˜ğŸ˜ğŸ˜ğŸ˜ğŸ˜es una bebÃ© ğŸ˜ğŸ˜ğŸ˜ğŸ˜ğŸ˜ğŸ˜ğŸ˜ğŸ˜ğŸ˜ğŸ˜ğŸ˜ğŸ˜ğŸ˜ğŸ˜˜ğŸ˜˜ğŸ˜˜ğŸ˜˜ğŸ˜˜ğŸ˜˜ğŸ˜˜ğŸ˜˜ğŸ˜˜ğŸ˜˜ğŸ˜˜ğŸ˜˜ğŸ˜˜ğŸ˜˜ğŸ˜˜ğŸ˜˜ğŸ˜˜ğŸ˜˜ğŸ˜˜ğŸ˜˜ğŸ˜˜ğŸ˜˜ğŸ˜˜ğŸ˜˜ğŸ˜˜ğŸ˜˜ğŸ˜˜ğŸ˜˜ğŸ˜˜ğŸ˜˜ğŸ˜˜ğŸ˜˜ğŸ˜˜ğŸ˜˜ğŸ˜˜ğŸ˜˜
Francisco Gomez	<3
Luis Godoy	Latinos?
jungkook vkook	Matthew siempre de agregado que pesar jajajajaja ğŸ˜‚ğŸ˜‚ğŸ˜‚ğŸ˜‚ğŸ˜‚ğŸ˜‚
SadieD09	Iâ€™m nine years old who else is? ğŸ˜¹ I wish you did the 5 roses ğŸŒ¹ at the Vancouver concert for the most craziest fans I was screaming my head of write when it said 10,9,8,7,6,5,4,3,2,1 boom you opened your eyes .   Everyone love only Camila Cabello -Sadie
Martha Heixh Vargas	Soy la Ãºnica que ve a Camila en el min 7:50 como en su epoca fetus? Diooooss me encanta ver a eso en su cara. Que hermoso ver el vÃ­deo y mas aun tener su sangre, Viva MÃ©xico Cabrones !!! ğŸ˜ğŸ˜
Kyara Banxnas	AAAAAAA TE AMO
Jessy G.R	Cuando lo traducen para saber lo q dices???
Swati Vashistha	Great
Crysa Davca	T amoğŸ˜¿â£ï¸
galletas con azÃºcar Jk & MY	AÃºn recuerdo cuando debutaste con F5 y que desde que te vi me enamorÃ© de ti!!! Mi bella hermosa â¤ eres el orgullo latino. En verdad te deseo mucho existo Camila.  Te amamos y te seguiremos apoyando.  Toda persona buena merece cosas buenas, como tÃº â¤
Diane Denis	awww
Johana A-M	I'm literally crying about how genuine Camila is. I really wish i could be one of those lucky fansâ¤
Syed Alwaz	Please come in India also
Alex Vgs	I loved watching you live at Monterrey, waiting for the next to come ğŸ˜
Mandy Lopez	MEXICANA POR VIDA HASTA LA MUERTEâ¤ï¸ğŸ‡²ğŸ‡½â€¼ï¸
Maria Aliandra Ferreira Dias	ğŸ˜ğŸ˜ğŸ˜ğŸ˜
Melany Roa	Vuelve pronto Camila! Siempre te recibiremos con los brazos abiertos. Te amamos Gracias por no dejar a tu MÃ©xico lindo y querido fuera de el Never Be The Same Tour . Mucho Love Karla Camila Cabello Estrabao!!!! Att. Camilizers
Evelin Ferrero	I love you cami
DPPB pedrza	no entendi ni la mitad del video pero como hablo de mexico me emocione porque pues soy de mexico jajaja y a huevo
Deivid Staehr	#Bolsonaro 2018
A13 A13	Ami mucho a Camila ğŸ‡²ğŸ‡½ y siguen me en el Instagram: a_rojas__
Irene Azucena Ruiz	SÃºper fan de ellağŸ¤©ğŸ¤—
deepak Naidut	I love camila
Slay It	I love you camila. ğŸ˜˜
Javier Alvarez	y peru falto
Sanyelin 22	TE AMO CON TODA MI VIDA NENA
Pedro Arvizo	Just when I don't think I could fall more for her ğŸ¥°
Azul Caixba	Q hermosa camila pero para la prÃ³xima q subas vÃ­deo x fis aunque sea un vÃ­deo hazlo en espaÃ±ol t amo muy bella
Luis Angel Garcia	TE FALTA TIJUANA TE AMOOOOOOOOOOO
Guadalupe Valverde	QUE CHINGON QUE ESTUVE AHI :v  ğŸ˜ğŸ˜ğŸ˜—ğŸ˜—ğŸ˜™ğŸ˜™ğŸ˜˜ğŸ˜˜â¤â¤ğŸ’‹ğŸ’‹
VickyAlwaysLovely	TE AMOOOOOOO
Danny BarragÃ¡n	Y los de Guadalajara esperÃ¡ndola durante horas en un hotel donde ni siquiera llegÃ³...
Alondra Guzman Guzman	That show really touched my heart. Everything was so beautiful and emotional to me, specially since I've been going through difficult times. I really got to feel Camila's essence. I don't know, it was all so raw and real. Thank you Camila for being such an inspiration and role model to me and of course my wings. Te amo mucho. â¤ #NeverBeTheSameTourGuadalajara
pegasister br	o prÃ³ximo tem que ser no brasil
Leticia Pitol Castelan	Te amoğŸ˜â¤ï¸
DANIEL INAD	ğŸ˜ğŸ‡²ğŸ‡½ğŸ˜ğŸ‡²ğŸ‡½
Nereida Vazquez	If there is something that I absolutely love from this artist, is her love for family ğŸ’•ğŸ¤—  !!!
Lupita Juarez	Eres Hermosa Mi NiÃ±a.ğŸ’•
Mel	Almost cried when she talked about how proud she is being cuban-mexican but I got chills
Marisa Hernandez	Yass Mexico ğŸ‡®ğŸ‡¹ğŸ‡®ğŸ‡¹ğŸ‡®ğŸ‡¹ğŸ‡®ğŸ‡¹ğŸ‡®ğŸ‡¹Love U Camila ğŸ’™ğŸ’™ğŸ’™ğŸ’œğŸ’œğŸ’œğŸ‘‘ğŸ‘‘ğŸ˜ğŸ˜ğŸ˜ğŸ˜˜ğŸ˜˜ğŸ˜˜
Marialy27 FM	Wow que hermoso!!  Se siente hermoso saber que entre toda esa gente estuve â¤ï¸ğŸ‡²ğŸ‡½ VIVA MÃ‰XICO CABRONES!!!!
Ixchel bd	te amo te amo te amoooo ğŸ˜ğŸ‡²ğŸ‡½
Karol Paredes	Like si no entiendes nada pero sigues viendo solo por su carita toda hHERMOSA ğŸ˜ğŸ˜ğŸ˜ğŸ˜‚ğŸ˜‚
Paulina Jurado Medina	Nooooo no puedo !!! Wooow yo estuve ahiiiiiiiii ğŸ˜­ğŸ˜­ğŸ˜­ğŸ˜­ğŸ˜­ğŸ˜­ğŸ˜­es hermoso , todavÃ­a me duele la garganta de haber cantado a gritos y no lo voy a olvidar jamÃ¡s !! âœ¨ğŸ˜­âœ¨ğŸ˜­âœ¨
swifie-emma -13	Omg I literally canâ€™t read any of these comments coz they are all in SpanishğŸ˜‚
Santiago :v	9:00 viva MÃ©xico cabrones  10:54 Ahuevo  Jsksjjsja  No soy mexicano pero me encanto xd â¤
Jazul Amaya	AgÃ¼evo!ğŸ˜ğŸ˜
hnv valzaval	TE AMO!
Ari tube	Vuelve pronto Camila Te amamosğŸ˜
Eli Soo	Te amo â™¥ï¸ ğŸ‡²ğŸ‡½
Terresa Taylor	Camila Keep being a beautiful soul BBG you are amazing <3!! An you are inspiring many many young hearts.
Montserrat Butanda	SÃ³lo por este video hubieras hablado mÃ¡s en espaÃ±ol y menos en inglÃ©s
Ximena Littrell	TE AMO TANTO!!! Estoy tan feliz de poder decir que estuve ahÃ­
val Luna	So proud to be MexicanğŸ˜ğŸ˜
à¶½à·“ à¶½à·š à¶¸à·à¶´à·’à¶½à·	Wow
Dam Dam	CAMILA TE AMO EL MEJOR DIA DE MI VIDA
Di Mando	Desde hace un mes lo estaba esperando ğŸ˜ğŸ˜
andrea xd	TE AMO DEMASIADO, ESTAMOS TAN ORGULLOSOS DE TI, MÃ‰XICO TE AMA ğŸ‡²ğŸ‡½â¤ï¸
Master Playz1975	Mexico
Abigail MartÃ­nez	AlgÃºn dÃ­a te voy a conocer y abrazarte fuerte :'v... AlgÃºn dÃ­a
Orchid Azula	It was great seeing you sing with ur dad in Mexico ğŸ‡²ğŸ‡½ I remember when bruno mars and his dad played in puerto showing homage to their culture. Great seeing such great pride for our culture camila my heart was full of joy  when you bought out mariachis it was just a special moment n when you sang that song it was touching it made me feel this sense of pride yes i was born in another country but my roots and heritage are from Mexico ğŸ‡²ğŸ‡½ my parents were immigrants n worked really hard. Aun que mexicanos me llamen gringa o que yo no soy Mexicana  me padre quien es mexicano nos dice a mi familia â€œ nostros somos mexicanos!â¤ï¸
Î±rleth reyes	MEXICO ES CHINGON! Gracias Camila por amarnos tanto como nosotros a ti!ğŸ‡²ğŸ‡½â¤ï¸ğŸ™ğŸ¼
Natalia Contreras	A huevoooğŸ˜‚ğŸ˜‚â¤ï¸ En Mexico te amamos camilita ğŸ’—ğŸ’— Iâ€™m so proud of being your fan ğŸŒ¹
kath Martinez	ğŸ˜ğŸ˜ğŸ˜ğŸ˜˜ğŸ˜˜ğŸ¤—ğŸ¤—ğŸ¤£ğŸ¤£ğŸ‘ğŸ‘ğŸ‘ğŸ™ğŸ™ğŸ’‹
Piglets Lol	OMG JFKSKEKJFKWK  I LOVE HER SO MUCH
Martin . Fuentes	Queen, I am so proud of you, I love you and you deserve all the success that you have. TE AMO DE TODO CORAZON Y MUCHAS GRACIAS POR SER UNA PERSONA TAN MARAVILLOSA.
copo	Ya qt
Sergio Arrieta	Â¿Cuando Colombia?
Laura Vega	Im a truly proud mexican girl that loves Camila so VIVA MÃ‰XICO CABRONES!!!ğŸ‡ºğŸ‡¸ğŸ‡¨ğŸ‡ºğŸ‡²ğŸ‡½ğŸ‡²ğŸ‡½ğŸ‡²ğŸ‡½
Manasvi Sawant	She was in India!? I missed her concert!ğŸ˜£
TheFunny Dogo	Puedes a ir a Honduras?Tu eres muy buena persona -3â€¢
Fatima Cruz	TE AMOOOOO SIEMPRE BIENVENIDA EN TU PAÃS ğŸ˜
Ima KeepItReal	Ohhh!! Camila got her talent from her father?!! What?? The man can sing so well.
Karina PÃ©rez	Ay mi preciosa Â¿por quÃ© te amo tanto? El 25/09/2018 fue tu concierto en Guadalajara y si, yo estuve ahÃ­ y de un maravillosamente maravilloso. De echo fue el mejor dÃ­a de mi gran corta vida y mi primer concierto. Fue de las sensaciones mÃ¡s grandes de mi vida, llorÃ©, baile, cantÃ©, grite, salte uff, tantas cosas increÃ­bles ese dÃ­a. Te amo por la persona quÃ© eres mi preciosa.
deanggiani	I love ur laugh
Day Lomeli	*Â¡Viva Latinos!*
Gizelle Lopez	I AM LOVE ğŸ˜
Lizbeth Palacios	Man I wish I had enough money to go to her concert or a meet in greetğŸ˜­
Polar	Camila back to MÃ©xico city than evil
EDITH ARM	QUEEN ğŸ‘‘ CAMILA ğŸ˜€â¤â¤â¤â¤â¤ LA MJOR DEL POP ğŸ‘ğŸ‘ğŸ‘ğŸ‘ğŸ‘
maaruku555	â˜ºï¸ğŸ’–
? rettamtnseodti	luv ğŸ’• that you are proud to be Mexican , luv ğŸ’your music  ... #beautiful (bazzi) ğŸŒ·ğŸŒ¹ğŸ’­ viva Mexico y los mariachis
Mary Grace Chua	So much love! Viva Camila Cabello ğŸ¦‹ğŸ¦‹ğŸ¦‹ğŸ’™ğŸ’™ğŸ’™
Raisa Emily	Te amo â¤â¤â¤ Camila quero de volta no Brasil linda
Daneli BL	Gracias por tanto Cami! Te quiero.
Jimena Arias	I love you, I'm so proud of you sweetheart. â¤ï¸ğŸ‡²ğŸ‡½ Orgullosamente mexicana y camilizer. ğŸŒ¹âœ¨
wexknessari	PensÃ© que habrÃ­a subtÃ­tulos xd pd: no pude ir pero aÃºn asÃ­ me alegro que vinieras a MÃ©xico:')
Yanara Pulido	MÃ©xico takes a especial place in my heart â¤
Gaby.camren 1231	Love you sooooooo much camz wait only Lauren calls you that I mean Mila oops
CUTIEPIE SREYA	I am the fan of Havana
M Emardi	I woke up to this notification. Seeing this first in the morning makes my day. Why does Camila have to be beautiful inside out?! ğŸ’“
Mila	Ser parte de algo especial te hace especial â¤ï¸â¤ï¸â¤ï¸ğŸ’•â¤ï¸
Eric JesÃºs Ochoa	AhuevoğŸ˜ğŸ˜ğŸ˜
Eduarda GonÃ§alves	Waiting for Brazil ğŸ‡§ğŸ‡·â¤ï¸xxx
Madison	QuÃ© increÃ­ble â¤ï¸ what an inspiring video â¤ï¸â¤ï¸â¤ï¸
Angel Santiago	TÃº llevas mÃ¡s que MÃ©xico en la piel, eres una inspiraciÃ³n en todas partes del mundo y tÃº voz es algo que muchos amamos de tÃ­, Muchas gracias Por venir a MÃ©xico VIVA MÃ‰XICO CABRONES!!!ğŸ‡²ğŸ‡½ğŸ‰
Sabrina Byers	Ahhh! Camila's laugh is just the cutest, I'm literally crying and her dad sings good wow! :D
grasiela perez	â€œIâ€™m so Mexican right now, Ahuevo â€œ ğŸ˜‚â¤ï¸
Brandon x	Que falta de respeto saber EspaÃ±ol, subir un vÃ­deo que ponga MÃ©xico y hablar en Ingles, sin poner subtitulos para los fans Latinos
Carmen Diaz	1:22 te amo mujerrrr!! De verdad te tengo un gran corazÃ³n, espero y pronto vuelvas a venir porque no pude ir a tus conciertos y espero que hayas disfrutado de ğŸ‡²ğŸ‡½
Shivang Gulati	As Cool as always!!!!
Sheyly Acevedo	AwwwwğŸ˜ğŸ˜˜ su ahuevo
Gleyce Kelem	Melhor pessoa â¤
Valentina Perez M	te amo tanto chiquita
dalaina foster	I have Mexican in me my mom's side of her family is Mexican  and my dad's side of his family is white/American
Gissel Yeh	â™¥ï¸ğŸ˜ğŸ˜¹ğŸ˜
carolina yunga	alguien mas coicide que la risa de sinu y camila son igualitas hahahah
Faye Cui	Hello! Are you also looking for an English comment? ğŸ˜‚
Juli Castillo	TE AMO
Gabriela Flores	ğŸ˜
Niiko Velasquez	Cual sera tu proximo destino????
Ashley D	This comment section is all Spanish
EsCoRLy chuquizuta	AAH MUY LINDA â¤ I LOVE YOU ğŸ˜˜ Beautiful that girl ğŸ’˜ğŸ’˜ğŸ’™
Genny Vazquez	la mas ermosa cantando en espaÃ±ol y ablandağŸ˜ğŸ˜ğŸ˜â¤â¤â¤â¤â¤â¤ğŸ’“ğŸ’“ğŸ’“
albita hye	Eres una personita para amarte con todas las ganas del mundo esas ganas, sonrisa, ilusion, trabajo, constancia, entrega, amor y agradecimiento por tus "amigos" los fans etc... eres una princesa que no necesita de ningun principe!!!!! Ahora dicho esto mi amor un consejo, se como eres, aunque el amor cambia a las personas y los aÃ±os te dan tranquilidad, la niÃ±ez que tienes no lo pierdas jamas, porque es algo que pocos compartimos. Para finalizar decir y repetir que no paren de votar para el 4 de noviembre!!!! Y por todo lo que nos quede por delante. Posdata: Porfa, hasta es un bien por el mismo, ("Matti")mejor que no lo expongas, ya que no pudiste o no quisiste harcelo con el amor de tu vida, el no te da mas realidad no te da mas confianza el no te da nada mas de la que ya tienes. Querer a un artista no es el fisico, quien la acompaÃ±e, sus habitos ect, nada de eso es que sean reales y sinceros con ellos mismos y luego exponerlo a los demas.ğŸ˜˜ #camilacabello
Wardah Tynna Yusof	Congratulations love. #hugs
Kim Antra	now she is more famous than fifth harmony !!
Michelle Sugar	So sweet!ğŸ˜Just follow Taylor Swift lead for your are her best friend and you and her will one day become great songwriting partners! Can u do a song with marshmallow plz! Mi no hablo Espanol. I know a bit of Spanish :D gonna keep trying. My life will never be the same since i went to the Reputation tour my life has been kinda the opposite of many other Taylor Swift fans that went there. Instead of loving her, even more, i fell i love with this other artist and if you are reading this Camila that artist is you! I want you to know that there are people who relate to you eveyday so never feel alone. Btw what is ur tumblr username i got tumblr because of u so kinda have nothing to do with it i haave nobody to view posts of. :D do not let the post change you an any way for from some people you are already described as 98% perfect! O those 2% is nobody is perfect. Just be happier and do a song with marshmellow
DANIELA MIRELES VILLARREAL	TE AMAMOS!!!!
Natalia Ramirez	TE AMOOOOO CAMILAAA â¤ï¸
Meme Lover32	Hi camila
Kenia Serrano Torres	Te amo weeeyğŸ˜­ğŸ‡²ğŸ‡½ğŸ’–
Tamia Herring	You go girl we love you
Erika Elizabeth Reye Cuellar	Regresa pronto Te amamos camila ğŸ˜ğŸ˜ğŸ˜ğŸ’™ğŸ˜­ğŸ˜­
Libraezzy Hastings Rosas	AhueeeevoooğŸ‡²ğŸ‡½â¤ï¸ Te amo hermosa
BEL Rivera	I LOVE YOU CAMILA!!!
Nat Jaramillo	I saw Hussey oadhhdhdhdhdhhska
Yoselyn LÃ³pez	TE AMO CAMILITA HERMOSA!!!Â¡!
Rodrigo Pichardo	Carajo es tan hermosaa.!
jeÑ•Ñ•Î¹e Ä¸Î¹Ñ‚Ñ‚y	When all the comments are in Spanish so you donâ€™t understand anything ğŸ˜‚ğŸ˜
AleK 7102	Pero mira nada mas que PaÃ­s tan mÃ¡s pinche hermoso. ğŸ˜ŒğŸ˜
Adele Ange	Es tan genuina y talentosa â¤ï¸âš¡ï¸ğŸ§ğŸ™Œâ¤ï¸
Aylla Nunes	camila Ã© um anjo
Idelfina Souza	Thank you for sharing this with us, I love you ...ğŸ˜ğŸ˜˜
Pedro SuperBoss	Te Amo Mexico ğŸ‡²ğŸ‡½ğŸ‡²ğŸ‡½ğŸ‡²ğŸ‡½ Y Te Amo Camila Cabello
Glenda Rodriguez	TÃ´ esperando o do Brasil dona Camila .. ğŸ˜¼ ğŸ‡§ğŸ‡·ğŸ‡§ğŸ‡·ğŸ‡§ğŸ‡·ğŸ‡§ğŸ‡·ğŸ‡§ğŸ‡·
Alana Walker	CamrenShippers presentes??? PS: Digan presente (solo CamrenShippers)
Michel Saavedra	Ven a PerÃº plis ğŸ˜ğŸ’“
Nicole Gomes Pereira	Omg you love camilla
Giniux Pandi Corn	Amo a camila cabello
Evelyn Eve	Oh god,.you are my everything My friend My Sister My angel My life #i love you ğŸ˜­
Milena Thomaz	Camilla! Come to Brazil plz!!! We Luv uğŸ’™ğŸ’šğŸ’›ğŸ‡§ğŸ‡·
Nallely Garias	Te amoo ğŸ˜‚ğŸ™ŒğŸ’•!
Fernanda Reyes	Eres una chingona y te amo demasiado. JamÃ¡s olvidare la experiencia que vivi en el concierto fuÃ© y serÃ¡ el mejor dia de mi vida para siempre. Espero un dia conocerte y abrazarte y decirte cuando te aprecio. Te amoğŸ˜­â¤
Jacob Marquez	Faltaron los subtitulos camilita :(
Alondra Martinez	Te amoooo ğŸ˜â¤ï¸
AbrilX lm	bitchhhh i'm on sec  00:12  hloifjefhoshf literally i'm dying Nomamessss KARLA CAMILA CABELLO ESTRABAO TE AMOOOOOOO
BeccaVerzola	Esperando do Brasil Fada, se n tiver n tem brigadeiro
Luz Azul	*Para todos los que no hablan inglÃ©s o no entendieron el video, aquÃ­ les dejo una traducciÃ³n.* No traduje todo tal cual porque si lo hiciera habrÃ­a algunas cosas que quedarÃ­an sin sentido jaja, o algunas cosas quedaban muy repetitivas en la misma oraciÃ³n. Les voy a poner el minuto en que empieza cada cosa, para que mas o menos sepan quÃ© onda. Traduje casi todo el video, solo fueron poquitas cosas las que me faltaron porque o no entendÃ­ ğŸ˜… jajajaj, o como ya dije, eran repetitivas y no tenÃ­a caso. *No soy experta en inglÃ©s, por si alguien tiene intenciones de atacarme o cosa parecida, jaja, para que no lo hagan* hice mi mejor esfuerzo, pero si algo no lo traduje bien, o algo de lo que me faltÃ³ ustedes lo saben, pues solo pÃ³nganlo en los comentarios.  0:15 Esa noche fue especial, ya que ese concierto no es algo que pasara todas las noches, porque como su papÃ¡ es mexicano, su familia y amigos estuvieron en el show, asÃ­ que es una experiencia diferente y tienes que sentirlo todo. 1:04 MÃ©xico fue uno de los momentos mÃ¡s especiales en el tour, y estuvo esperando por ese momento del NBTST por mucho tiempo. Ella es cubana - mexicana (ğŸ‡¨ğŸ‡ºğŸ‡²ğŸ‡½), viviÃ³ un tiempo en MÃ©xico cuando era muy pequeÃ±a y su papÃ¡ es la persona mÃ¡s mexicana que ella haya conocido, por lo que ella estÃ¡ muy orgullosa de ser mexicana y ama la cultura mexicana. Ella se ve a sÃ­ misma en todas las caras jÃ³venes de MÃ©xico que tienen sueÃ±os y que aman la mÃºsica e ir a conciertos (como decir que se ve reflejada). En ese show se sintiÃ³ como estar en casa, especialmente en la Ciudad de MÃ©xico ğŸ¤˜ğŸ½ porque toda su familia estÃ¡ ahÃ­; su papÃ¡ tiene como 5 o 6 herman@ y el dÃ­a del concierto todos estaban ahÃ­ y que en verdad es muchÃ­sima familia, y se divirtiÃ³ mucho. 2:04 La mejor parte para ella fue ver a su papÃ¡ tan feliz como nunca habÃ­a estado, y cada vez que van a MÃ©xico Ã©l se pone muy feliz de estar en su casa, y la comida mexicana es la que Ã©l mÃ¡s ama en todo el mundo, que cada vez que van a comer a un lugar como muy fresa (no se me vino otra palabra jaja) Ã©l siempre pregunta si no se pueden comer unos tacos, y que en verdad Ã©l es SUPER mexicano, y ella y su familia sienten como ese orgullo de serlo y cada vez que estÃ¡n aquÃ­ (en MÃ©xico) estÃ¡n muy felices, por la gente y el ambiente. 2:43 Su papÃ¡ trabajaba como guardia de seguridad cuando tenÃ­a 17 aÃ±os en el lugar en donde ella iba a dar concierto y lo corrieron porque la chamarra que tenÃ­a que se suponÃ­a era la de su uniforme era como de doble vista, y por un lado estaba de color negro (que era su uniforme) y por el otro lado estaba de color naranja, y que cuando iban a dar conciertos (Guns n' Roses, Metallica, Michael Jackson) Ã©l se ponÃ­a la chamarra del lado naranja y comenzaba a gritar y lo descubrieron y lo corrieron jaja. 4:20 Su sueÃ±o en toda su carrera era cantar MÃ©xico en la piel con su papÃ¡; Ella creciÃ³ escuchando a su papÃ¡ cantar y Ã©l tiene una voz increÃ­ble. Y el hecho de que ella creciera oyÃ©ndolo cantar hizo que le diera como ese amor por la mÃºsica porque era algo contagioso y que incluso ahora tiene un karaoke en su telÃ©fono (su papÃ¡), y todo el tiempo estÃ¡ cantando, y que al cantar MÃ©xico en la piel con su papÃ¡ se sintiÃ³ como estar cantando una canciÃ³n de amor acerca de MÃ©xico, y se siente muy orgullosa. Aunque no seas mexican@, por ejemplo en su equipo que no son de MÃ©xico, pero cada vez que escuchan la canciÃ³n de MÃ©xico en la piel le dicen a Camila que se sienten orgullosos de ser mexicanos y ni siquiera lo son. 5:13 El hecho de que su papÃ¡ estuviera en el escenario y cantara con ella la canciÃ³n, representaba todo lo que ella querÃ­a ser, porque estaba haciendo lo que mÃ¡s le gustaba hacer en la vida que es la mÃºsica y hacer su propio concierto, representando la esencia de ella que en muchos sentidos es su cultura, porque es cubana mexicana y tambiÃ©n hacerlo con la gente que ama (sus fans, su familia mexicana). 5:52 Ella es muy cercana a su familia y para ella es lo mÃ¡s importante en el mundo ğŸ’ y todo el show en MÃ©xico se sintiÃ³ como un momento de familia; para ella todo lo mÃ¡s importante estaba representado en ese stage, y que en ese momento solo era ella siendo sincera consigo misma, recordando de dÃ³nde es, quiÃ©n es y su historia, y que todas esas cosas la hacen especial. 6:31 LlorÃ³ 3 veces antes del concierto y estaba muy emocional porque estaba muy nerviosa ya que realmente querÃ­a hacer un buen trabajo y querÃ­a darle a sus fans una noche inolvidable porque sentÃ­a que se veÃ­a a ella misma en la cara de cada uno de ellos teniendo sueÃ±os no solo con algo relacionado a la mÃºsica sino en general de querer ser alguien en la vida, y realmente sentÃ­a la presiÃ³n de dar un show increÃ­ble. Y cuando estaba en el concierto solo dijo, este concierto es para mi familia, para mis fans que han esperado esto por mucho tiempo, por la cultura, y por todas las chicas latinas que tienen sueÃ±os, y tambiÃ©n era por ella misma. Ese show fue la representaciÃ³n de sus sueÃ±os convirtiÃ©ndose en realidad, porque regresÃ³ al lugar donde alguna vez viviÃ³ cuando estaba pequeÃ±a, y recuerda que despuÃ©s de la escuela siempre compraba elotes en la esquina y tacos, y estar ahÃ­ aÃ±os despuÃ©s cantando en frente de un montÃ³n de gente en su paÃ­s se sintiÃ³ increÃ­ble. 8:10 Siente que nunca se cansa de decir lo orgullosa que se siente de su familia y la historia de su familia. Y lo increÃ­ble y difÃ­cil (lo mucho que tienes que trabajar) cuando eres un inmigrante y que ella realmente no hizo mucho trabajo porque solo era una niÃ±a, pero sus papÃ¡s se esforzaron muchÃ­simo, y por lo tanto se siente muy orgullosa de ser una inmigrante, y de ser cubana y mexicana y ama compartir eso con el mundo; y que en todo el mundo, cada una de las personas deberÃ­an saber lo increÃ­bles que somos los mexicanos (wuuu) ğŸ˜ 9:16 Explica que estÃ¡n dando 5 rosas en cada show porque las rosas son algo entre ella y sus fans ğŸŒ¹ y alguien de su equipo o familia entrega 5 rosas a diferentes fans que no tuvieron chance de un m&g, y estÃ¡ muy emocionada de conocer a sus fans. 9:57 Lo de las rosas lo hicieron por primera vez en MÃ©xico y se sintiÃ³ increÃ­ble porque siente que tiene muchos fans (super, ultra fans) que no tenÃ­an dinero para un m&g o ya no alcanzaron o cualquier otra razÃ³n, y entonces esa fue una buena manera de acercarse a sus fans y estaba muy emocionada de hacerlo. 10:16 Y que si recibes una rosa no es que su equipo estÃ© intentando ligarte jaja sino que se van a conocer despuÃ©s del show, que va a estar muy divertido, y que lo harÃ¡ en SuramÃ©rica ğŸŒ y en futuros shows. ğŸŒğŸŒğŸŒ
Mia Victoria	I love your music and I'm Mexican too btw I'm the smallest biggest fan ever I'm 12
Franzela Alvarez	Camila cabello is so sweet it would be a dream come true if I could meet herâ˜º
Vanessa Galaviz Soto	Me largo a llorar, te amo mucho Camila ğŸ˜­ğŸ˜­ğŸ˜­â¤â¤â¤â¤â¤ğŸ‡²ğŸ‡½ğŸ‡²ğŸ‡½ğŸ‡²ğŸ‡½
AA AA	Tour dairies makes me so happy.. canâ€™t believe the tour is over
is Sucre	La amooooooooO
Saira Majiddd	ENGLISH COMMENTERS SQUAD WHERE YOU ATğŸ™‹ğŸ½â€â™€ï¸ğŸ™‹ğŸ½â€â™€ï¸ğŸ™‹ğŸ½â€â™€ï¸    Also, under 100k Squad Where you atğŸ™‹ğŸ½â€â™€ï¸ğŸ™‹ğŸ½â€â™€ï¸ğŸ™‹ğŸ½â€â™€ï¸
Ilced Styles	TE AMO COMO NO TE IMAGINAS
colton Roberson	6:25 poor confused Matthew
Brinstar	Desafortunadamente lleguÃ© tarde a tu concierto en GDL por un inconveniente. Cuando te escuche cantar Something's Gotta Give detrÃ¡s de las puertas para entrar al auditorio, sentÃ­ una presiÃ³n enorme intentando abrir la puerta para poder entrar, ver las luces y desde muy lejos a ti en el escenario, pero disfrutÃ© cada segundo escuchando las canciones en vivo. Fue hermoso y definitivamente yo... #I'll Never Be The Same, Never. Gracias Camila â£
good girl	YO TE VÃ EN GUADALAJARA
Leticia Pinheiro	6:26 tava td perfect atÃ© a praga aparecer GRR
oo f	te amo
Heda Fan de sÃ©ries5HLM	â¤ï¸
M A R I X UwU	ME ENCANTA VERLA TAN FELIZ Y TAN LLENA DE ENERGÃA, SIGUE CUMPLIENDO TUS SUEÃ‘OS CAMILITAAAAA, ESTAMOS SÃšPER ORGULLOSOS DE TIIII â¤ï¸ VIVA MÃ‰XICO AJUAAAAAAAAAAA ğŸ‡²ğŸ‡½â¤ï¸âœ¨
Iraistenou21 Tenou	No mames que onda con tu hermosura ğŸ’•
Hellen Cristina	alegro o meu dia ğŸ˜ğŸ˜ğŸ˜ğŸ˜˜ğŸ˜ğŸ˜ğŸ˜ğŸ˜
k_vxxpe	I will never forget the concert in Guadalajara, it was such a blessing to be there ğŸ’›
Jayla Contreras	You go Camila you're my inspirationğŸ˜˜ğŸ”¥ğŸ”¥â¤ï¸ğŸ‡²ğŸ‡½ğŸ‡²ğŸ‡½ğŸ‡²ğŸ‡½ğŸ‡²ğŸ‡½ğŸ‡²ğŸ‡½ğŸ‡²ğŸ‡½ğŸ‡²ğŸ‡½ğŸ‡²ğŸ‡½ğŸ‡²ğŸ‡½ğŸ‘„ğŸ‘ğŸ¤—ğŸ˜Š
Dani Hdez	La depresiÃ³n volviÃ³ a mi, al ver que no fui. :(
Brenda Sosa	Hasta mathew cae mejor q ty la neta..
Karla Solano	K1000ATEAMOOO
Alan Perez	Te amamos â¤ï¸ğŸ‘‘
nana	I LOVE YOU SO FUCKIN MUCH
Ana Karen De La Garza	Me encanto el concierto aquÃ­ en Monterrey, Mexico fue increÃ­ble zâ¤ï¸â¤ï¸
jerry luo	å‰3ä¸‡ï¼ç»™ä½ æ‰“å¡ï¼
Touma	i love you
Cyrine Rose	Matthew
Mycancun1	I know for a fact that Camila and I could be best friends
m.fatima espinoza	MEXICOâ¤
ponciano velasquez	q alegria saber q nos visitas camila claro q estuve gritando a todo galio tus canciones
Natalia Rojas	Eres una chingona de mujer camz Te amo un ChingoğŸ˜ğŸ˜ğŸ˜ğŸ‡²ğŸ‡½â¤ VIVA MÃ‰XICO CABRONES!!!!ğŸ¤—ğŸ¤—ğŸ¤—... Pero oye chica mejor hablar UN poco mÃ¡s de espaÃ±ol heeheee ğŸ˜šğŸ˜™ğŸ’•ğŸ’•ğŸ’•ğŸ™..
Sweet Larry	Fue la mejor experiencia que tuve al ir
Ray dreamer	Apenas um comentÃ¡rio em portuguÃªs ğŸ˜‚ i just know how to speak Portuguese and  Englsih
Yesenia Garcia	i love this so much! so proud to be Mexican!! love you so much my Mexican sister! viva Mexico cabrones!!!!!
Asma Rose	beautiful baby
Azareel Vidales	MATTHEWWW RUINED THIS
G B	My Cuban born princess! Born in Havana oh na na... Belongs to the world! ğŸŒ ğŸ‡¨ğŸ‡º
arnaldo silva	Havana  una una
Regina Landeros	Espero y venga otra vez lo mÃ¡s pronto posible para ahora si estar ahÃ­.ğŸ˜­ğŸ’”
Raybeli M	Estuve arrecha prÃ¡cticamente todo el vÃ­deo porque no hablabas en espaÃ±ol, hasta que dijiste el "viva MÃ©xico cabrones" asÃ­ re sexy que me quitaste toda la arrechera ahr
Elizabeth Nnangobya	I love you and I'm more than proud of you camz!
Armando PvZ	I LOVE YOU  Camila How good I am Mexican
Valeria PeÃ±a	I Lo Lov Love y Love yo Love you Love you C Love you Ca  Love you Cam  Love you  Cami  Love you Camil  Love you Camila Love you Camil  Love you Cami Love you Cam  Love you Ca  Love you C  Love you Love yo Love y Love  Lov Lo L T Te Te a Te am Te amo Te am Te a Te T Thanks for being my role model I love you so much Keep up the good work Camz!
Kay A.A	magical show
Ester Silva	camila love u â™¥
Itsmeharper Jacksons	Matthew looks like a proud big brother ğŸ˜…ğŸ˜…ğŸ˜‚ğŸ˜‚ğŸ˜‚
Cardiii Gotttaaa Be Poppin	Mexico!!!! Mi cuidad ğŸ˜ğŸ˜­ğŸ˜­ğŸ˜­ğŸ˜
Lazy MothaFaka	9:46 That Ass Tho ğŸ¤¤ â™¥ï¸
cristy1427	Te amo Mexico  Mahal Kita MexicoğŸ˜˜ğŸ‡µğŸ‡­
Baby Girl	Aaaa sdds do meu bb no Brasil :')
Shubhangi Sinha	Indian fans here?â™¥ï¸
Paulina DÃ­az	Eres increibleee â¤â¤
Lizy ortz	MÃ©xico te ama Camila !!ğŸ˜˜
Nataly v	I wish I can come to your concert I love you so much Camila ğŸ’•ğŸ’•ğŸ’•ğŸ’•ğŸ’•ğŸ’•ğŸ’•ğŸ’•
Esther Fiorela	ğŸ’›ğŸ’›ğŸ’›
Rox Anne	Love you Camila. We'll always be here for you â¤ï¸â¤ï¸â¤ï¸â¤ï¸ğŸ‡µğŸ‡­
Saah Marcela	Camila porque vocÃª nÃ£o gravou o documentÃ¡rio em espanhol amor? NÃ£o entendi nada vida, mais amei vocÃª no MÃ©xico com a famÃ­lia toda
Astrid GÃ¡lvez	Like si eres de MÃ©xico y si amas a Camila Cabello
Tina Popp	this made me cryğŸ¤§ she is such a sunshine!ğŸ’—
Sweet 32	No supe ni madres de lo que dijiste pero sÃ© que es de MÃ©xico, love u.
Abby Shots	Voy a llorar, eso fue hermoso te amo CAMILA CABELLO
Jose Luna	ğŸ˜ğŸ˜ğŸ˜ğŸ˜ğŸ˜ğŸ˜
Anna Nohemy Charcopa	A pues as una canciÃ³n para ecuador tambien
Lucero GarcÃ­a	10:53 AHUEVO! ğŸ˜‚â¤
Wendy almeida	,, ğŸ˜˜ğŸ˜˜ğŸ˜˜ğŸ˜˜ğŸ˜˜ğŸ‰ğŸ‰ğŸ‰ğŸ’ğŸ’
Elvis Drew	Hey could you listen to my new song ? Its called "Gabrielle" hope you like it ! ğŸ–¤â¤ï¸ğŸ–¤
xx xx	I wish I have a dad like her dad ğŸ˜¢
amangogna68	You are so beautiful and love your voice. ğŸŒ¹â¤ï¸
jorge eduardo avila	Viva MÃ©xico cabrones ğŸ˜˜ğŸ˜ğŸ‡²ğŸ‡½ğŸ‡²ğŸ‡½
Dulce Ruez	YO ESTUVE AHI!!! ğŸ’•ğŸ˜­ğŸ˜­â¤ï¸â¤ï¸â¤ï¸
Nancy Ramirez	You make us proud Mila & Mexico is proud of you!!! ğŸ¤—ğŸ™ŒğŸ½
Dream CerrÃ³n	Cuando sera el dia en el que vuelvas a PerÃº!!! :(
Rebeca VictÃ³ria	Te amooooğŸ˜
Regina Ortiz	Y porque puta madre no hablas en espaÃ±ol.
nitvaou Ocampo	Que orgullo haber formado parte de este nbts tour. Â¡Viva MÃ©xico Cabrones!. Te amo camz â¤ï¸
Ms. Chubie REACT	what is the title of song ?? mexico ??
Cleonice Nogueira	Tiva
Yessenia Venegas	Wey pues no entendÃ­ casi nada pero que chingon ğŸ˜ğŸ’—
Chispa	Estoy llorando marica lo estoy â¤  muy orgullosa de ti Camila BebÃ© ğŸ˜­
Reyna Villalpando	Â¡De Miami a MÃ©xico esta cosa se prendiÃ³!
Shailey Ordonez	yo no soy de MÃ©xico, soy de Guatemala, pero casi es igual!!   I love tacos! i love my family there. when i first traveled to Guatemala i loved it there! I love my culture! keep being you Camilla!  #MexicoAndGuatemalaRules!!!!
Ø¨Ø§Ù‚ÙŠØ±Ø§ Ø¨Ù† Ø³Ø¨ÙŠØ³	Fans fromğŸ‡¸ğŸ‡¦
Evelyn RÃ­os	La parte que mÃ¡s me gusto fue "VIVA MÃ‰XICO CABRONES"ğŸ˜‚ğŸ˜‚ PD: Te Amo CamilağŸ’“âœŒ
rolling stone	Gracias camilita por estos 3 shows super increibles en Mexico eres super increible tristemente no estuve hasta enfrente pero te vi hasta atras en #NBTSTOUR CDMX
VICKY MARTINEZ 27	I love you camila  mexicanas forever â¤ï¸ğŸ‡²ğŸ‡½
Yamy Ramirez	Y pensar que yo estuve ahÃ­ :')
JosÃ© Hamit	Te amamos ğŸ˜ğŸ˜ğŸ˜awuevo
avaâ€™s edits	my heart HURTSSS
imabee2010	I am so so proud of you CAMILA !! I am an american that lives in the mid west yup I doâ¤â¤â¤ ğŸ‘ğŸ¼ğŸ‘ğŸ¼ğŸ‘ğŸ¼ğŸ‘
D Gonzalez	Viva Camila Cabello!! y Viva Mexico Cabrones!!!!!!!!!!!!! I love mariachis and you (and your dad) singing with them, WOW !! Can't    stop listening to "Mexico en la Piel".  Me llenas con mucho orgullo de ser latina (Mexican). God bless you Camila and your lovely familia.  Delia "Chikita" Gonzalez
L o s e r's C l u b	YO ESTUVE AHÃ MAMÃ
Sara  Narro RodrÃ­guez	me siento tan orgullosa de mi bebÃ© Camz :')
Juanita Aguilar Rodriguez	Pero habla en espaÃ±ol cabrona, no te entiendo ni madres
Loveu2be	My favorite part, "We're so proud of being Mexican and we're not even Mexican" ğŸ˜‚ğŸ˜‚ lol  I love you Camilaâ¤ï¸ Viva Mexico cabronağŸ˜‚ you make us Mexicans proudğŸ’•
Kenya Cruz	NO ENTENDÃ NI UNA PUTA VERGA PERO TE AMO
Noswari	Iâ€˜m Single
Jay Tern	Amazing â¤ï¸
Agar Uitzil	Mi vidaaağŸ˜ğŸ˜ğŸ˜AAAAA HERMOSA MUJER ğŸ”¥ğŸ˜
aprilll fan	im so glad I got to be part of the NBTS Tour Mexico ğŸ’˜ honestly the best day of my life ğŸŒ¹
Alejandra Zamora	Sii!!!! â¤â¤â¤ mencanto! ğŸ’™ğŸ’™ğŸ˜‚
Savannah Gilchrist	I wish I was you Camila I don't no Spanish but I'm a big fan
Felipe Havana	O BRASIL te ama CamilağŸ’šğŸ‡§ğŸ‡·ğŸ‡§ğŸ‡·ğŸ‡§ğŸ‡·ğŸ‡§ğŸ‡·Somos os melhores fans do MundoğŸ‡§ğŸ‡·ğŸ‡§ğŸ‡·ğŸ‡§ğŸ‡·ğŸ‡§ğŸ‡·ğŸ‡§ğŸ‡·ğŸ’š
aailyyn g	ESTOY MUY ORGULLOSA POR LO QUE HA LOGRADO, i love you camila donâ€™t forget that, love. VIVA MEXICO CABRONES ğŸ‡²ğŸ‡½
Cookie Monster	She's so fascinating
Jessica Paz	AlÃ´ pessoal das legendas, jÃ¡ quero
Alejandro Avila	Eres lo mÃ¡s lindoâ¤ï¸.
SabinaHazenet Lara	MEE HICISTE LLORAR CULERA  Te amo
bell Sousa	I cry, it's amazing, we love you so freaking much, I never be the sabe after your concert in sao Paulo, see you MAKE me so happy and I HAVE SO MANY FRIENDS THA'T I MAKE THAT DAY, THANK YOU for everything
lisandra torres	EU TE AMO GOXTOSA
MarÃ®e VÃ®llalobos	*Ahuevo!!* ğŸ˜œğŸ˜‚ğŸ˜‚
Karen Andrea	QUE ORGULLOSA ESTOY DE TI Y QUE EMOCIÃ“N SABER QUE YO ESTUVE EN UNO DE ESOS SHOWSğŸ‡²ğŸ‡½â¤ï¸
Gidelvan Preto	Camila good
luanna michelvisck	111 pessoas deram deslike no meu bebe, vou comprar minha arma na havan e matar todos
a swiftie & camilizer guy	please come to the philippinesğŸ‡µğŸ‡­
ElAlanOk TV	Soy Ã©l Ãºnico q se vio Ã©l vÃ­deo y no entendiÃ³ nada de lo q dijo pero lo vio igual??ğŸ˜‚ğŸ˜‚
Carlos Martinez	Alguien contÃ³ los "You know"ğŸ˜‚ğŸ˜ la amo,estÃ¡n hermosaâ¤â¤â¤â¤
Abril Perichon	TE AMOO
Ayza Santos	Te amo muito â™¥ï¸ ğŸ‡§ğŸ‡·
Itzel martinez	Hola soy mexicana me encanto este vÃ­deo
Aliah	We love you ğŸ˜˜
Rae xdxd	El 3:44 son mis gritos y los de mi novioNOMAMES
Antonio Rodriguez	Te amo Camila â¤ï¸ you are amazing ğŸ’ƒğŸ¼
Alondra love Vlogs	I am so proud to be Mexican and I am from Puebla love you so much â¤ï¸â¤ï¸â¤ï¸â¤ï¸
MOONCHILD	God bless Camilaâ€™s parents they made a legend. Her parents are so lucky. â™¥ï¸
Ava Wilde	TE AMO TE AMO TE AMO.
ãƒ„ Hoseok Miraculer	Â¡Â¡Â¡Â¡OMG!!  Y pensar que estuve ahi....
Its Sebastien	Anyway Iâ€™m so glad that she left the group before all of themâœ¨ğŸ¦‹ğŸ‡®ğŸ‡¹
Renata Fabiana	Minha queen
Santi GraiÃ±o	HERMOSAAAA
Gloria Rodriguez	Omg this is so beautiful ğŸ˜­ğŸ˜ i hate don't have money to go to your concertsğŸ˜“ but I'm saving money for the next tourğŸ˜¤  so see you next year I hopeâ£ï¸ love onlyğŸ’–
Hendryk Miranda	Definitivamente camila ama los baÃ±os JAJAJAJAJAJAJAJAJAJAKAJAJAKA
Mauricio Paez Vazquez	Gracias Camila por no negar la sangre mexicana que llevas y saber que MÃ©xico lo llevas muy dentro de ti gracias Camila... #Mexicolovecamila!!
Adriana Cruz	I'm too sad because I could not go to your concert because my mom did not have enough money but I'm sure that at some point I'll meet you greetings from Peru
Kylie Aguilar	Love you Camila ğŸ’˜ğŸ’˜ğŸ’˜
giordana QE	ğŸ˜ğŸ˜ğŸ˜para Cuando, PerÃº?ğŸ˜­ ğŸ’”
iva Gutirrez	Estoy muy orgullosa de que camz  sienta tan feliz de ser mexica
Larissa Martins	esperando do brasil
ruth diaz	espero con ansias el de Camilizerlandia ,tambien conocido como Argentina ahreğŸ’•â¤ğŸ˜ TE AMO!!!!ğŸ’œ
Maria De Jesus Dionicio	Dios mÃ­o que hermosa eres
VipapkStudiosOfficial	Congratzz! You Just found a English Comment! ğŸ˜‚
Incubus Contreras	Sexy humble classy lady
Naidelin	Viva MÃ©xico cabrones!! ğŸ‡²ğŸ‡½ğŸ‡²ğŸ‡½ Se me antojÃ³ un elotitoğŸ¤¤
L b	Vlogging with Camila
Garu MC	I love you Camila ğŸŒ¹â™¥ï¸ Orgullosamente mexicana, Yo â™¥ï¸ğŸ‡²ğŸ‡½
ISHUXD	I love you camilağŸ˜‡
Leydi Alonso	Dios que orgullo de MUJER, sin duda. OjalÃ¡ algÃºn dÃ­a tenga la posibilidad de conocerte preciosa. Sin palabras, ver hasta dÃ³nde has llegado, eriza la piel de cualquier ser viviente sobre este y cualquier otro mundo.
Hector Lizarraga	COMO QUISIERA HABER SIDO LA SEÃ‘ORA QUE LE VENDIÃ“ EL ELOTE A CAMILAAA!!
Hailey Williams	I love you, and Iâ€™m letting you know.. your songs are so good and you have such a good voice.
Tj Velazquez	Camila you are special! Please never change! We love you so much! â¤ï¸
Brenda Cruz Martinez	LIKE SI ERES DE MÃ‰XICO ALV ğŸ‡²ğŸ‡½ğŸ’“
Lupee Bautista	Este video me puso la piel chinitağŸ’–
KATIA ITZEL	Yo estuve ahiğŸ˜ğŸ‡²ğŸ‡½ğŸ™
Fabiola x	God, you have me, all of me â¤ï¸
Channel #1	No te entendÃ­ ni madres de lo que dijiste Camila pero bueno ilove Camila â€œla culo bello" ğŸ˜‚ğŸ˜‚ğŸ˜‚ğŸ˜ğŸ˜ğŸ˜ğŸ˜
Purple Taehyung	No mames yo estuve ahÃ­ no se siento real alv
Luz Alcaraz	Camila Cabello ğŸ˜
Roxy Vigil	Orgullosa de ti ğŸ˜ğŸ’¥
Valeria Beltran	JamÃ¡s me voy a cansar de decir que te amo gracias por todo tu esfuerzo y estoy muy orgullosa de ti y gracias por ser una orgullosa MEXICANA ğŸ‡²ğŸ‡½ğŸ’“ te amamos.
Mariana Caldeira	Pq n teve do Brasil?ğŸ‡§ğŸ‡·
Galilea Jacinto	te amamos demasiado Camila, estas bien hermosaaaaağŸ˜»â¤
Italy AraMtes	Amo que estÃ©s orgullosa de tus raÃ­ces ğŸ‡²ğŸ‡½ğŸ˜ŠğŸ‘€ğŸ˜ğŸ’ƒğŸ»
Dana Stylinson	diosss, te amo demasiado
Lindwurm	To see your family makes me so happy. :) I know many families I would wish to be as happy as yours.
Oscar Enrique Jr.	2:32  MIRA NOMAS ESE CULOTEEEEE
Candela Jaure	que afortunados son los mexicanos, lloremos
H i	you are the best singer in the world!!
Shadi C.C	ğŸ˜­A mi me encantaria verte en persona! Pero desde mi celular es un honor, lloro y todoğŸ˜­ğŸ˜­â¤ï¸â¤ï¸â¤ï¸i love you so much!! ğŸ’¯ğŸ˜­â¤ï¸
e co	Yo fui al de guadalajara
Sr. NicolÃ¡s	Viva los latinos!!!
SofÃ­a Verbena	Te amo Mila eres mi mayor idola y siempre te apoyare â­
Adrianak Resendiz	Ese viva MÃ©xico cabrones 7w7
Daniella Hernandez	so I have a question why click the thumbs down button??? like noppppe if u don't like it then u can leave sooo byeee if u don't like her then why are u even watching her video exactly byeee no one wants u here if u have hateee!!!! so I recommend don't click the thumbs down button even if u don't like it ok then byeeee leaveee
Nestor Garcia Corral	Arriba los de Monterrey
Cristina Castro	Te amo Camila!! â¤ï¸
Ximenaâ€™s Hernandez	ME ENCANTO ğŸ˜ğŸ˜ğŸ˜ABSOLUTELY LOVE THIS CAMILAğŸ’“ğŸ’“ğŸ’“ğŸ’“ğŸ’“love how u made this type of video
D_17 .3	Me duele que no vinieras a PerÃº ğŸ˜¢ pero me siento orgullosa de lo que has logrado bebÃ© â™¥ Te estarÃ© esperando
SofÃ­a Rojas	El mejor dÃ­a de mi vida ğŸ˜»ğŸ˜»ğŸ˜»ğŸ˜»ğŸ˜»ğŸ˜»ğŸ˜»ğŸ˜»ğŸ˜»ğŸ˜»ğŸ˜»ğŸ˜»ğŸ˜»
laura yanine cruz lopez	Siempre tan linda mi bb, jeje No me cansare de decirte lo talentosa y hermosa persona que eres. Es increible que valores tus raices, que seas tan humilde y encantadora. TE AMO!
Angie GÃ³mez	ARRIBA MÃ‰XICO CABRONES ğŸ‡²ğŸ‡½ğŸ‡²ğŸ‡½ğŸ‡²ğŸ‡½â¤â¤
Nayely AnahÃ­	No se que dices pero te amo y estamos muy orgullosos de ti bb â¤â¤
Vani S	Pa cuando el video de Suth AmÃ©rica y Centro AmÃ©rica
Jiya Jogia	Omg sheâ€™s coming to my area one day before my birthday!!!!!! My 13th
Sinthia FernÃ¡ndez	Te amo CamilağŸ˜ğŸ˜â¤
Karla Gonzalez	Me encataaaaaaaaaa â¤ï¸â¤ï¸â¤ï¸ğŸ˜ğŸ˜ğŸ˜ ojalÃ¡ y vuelvas a venir a Guadalajara â¤ï¸â¤ï¸â¤ï¸â¤ï¸â¤ï¸
martina de santis	she's so precious
Raymond Calitri	Pinche camila me antojaste el elote cabrona..
Fahed Al abd	I love you Camila....ğŸ’˜ğŸ’˜ğŸ’˜ğŸ’˜ğŸ’˜
Agathe 23	Which is the music that cami and Her dad sing???
Bruno skinnyfromthe9	I LOVE YOU CAMILA ğŸ’œ
MARIA TRAX	Que linda camila teamo viva MÃ©xico yo soy de ai
canal de tops top	Cuando venÃ­s  a argentina
Tania SÃ¡nchez	Viva MÃ©xico Cabrones
ana*B*elys bel*T*rÃ¡n ca*S*tillo	El caribe (no Puerto Rico :v) pa' cuando? En donde quedo RD? Cuba? ETC (un gran ETC)
Army forever BTS	The video is amanzing! ğŸ”¥ğŸ‘Omg
Sabrina Silva	ğŸ‡§ğŸ‡·ğŸ‡§ğŸ‡·ğŸ‡§ğŸ‡·ğŸ‡§ğŸ‡·
Ingrid Marlen	VIVA MÃ‰XICO CABRONES!!! AHUEVO â¤ğŸ”¥
Anette ponz	Estoy en cierto tengo a la mejor idola y aunque no pude asistir por problemas mi corazÃ³n estuvo ahi y siempre va a estar ahi para ti
Denisse Cano	ğŸ’—ğŸ’—ğŸ’—
ã‚‰ã‚‰ã‚‰ã‚‰	ã¾ã çš†è¦‹ã¦ã‚‹ã‚ˆã­ï¼Ÿ
Evelyn Cervantes	Mexico
Alejandra Cervantes	LPM, YO ESTUVE EN EL AUDITORIO TELMEX Y DE VERDAD FUE UNA DE LAS MEJORES EXPERIENCIAS QUE HE TENIDO â¤ï¸ :')
kiara Paico	Las amo
Luna Oscura	â¤â¤â¤
Mary Remmy L	ğŸ˜ğŸ˜ğŸ˜ğŸ˜ğŸ˜ğŸ˜
Vitoria Reis	do Brasil que Ã© bom nÃ£o tem nÃ©
yirha zapata	CAMILAAAAAAAAAA PORQUE SI DICE MÃ‰XICO ME HABLAS EN INGLÃ‰S!!!!!!! PENSÃ‰ QUE POR FIN SABRÃA QUE DECÃAS EN TU DIARIO ğŸ˜­ğŸ˜­ğŸ˜­ NO IMPORTA TE AMO
Jowalio Johny	She's perfect
pilar ,	estoy llorando, te amo demasiado sos tan perfecta
Cristina Gone	Me da una felicidad enorme que estes tan ames tanto y te enorgullezca nuestro MÃ©xico querido Â¡AWBO! VIVA CAMILA CABRONESâ¤.
mko moo 8	ÙƒØ§Ù…ÙŠÙ„Ø§ ÙƒØ§Ø¨ÙŠÙˆ ğŸ˜ğŸ˜ğŸ˜
Loving Angel	I'm so proud I'm MEXICAN go Mexico
Jiane28	â¤ğŸ’“ğŸ’˜ğŸ’•ğŸ’–ğŸ’—ğŸ’ğŸ’ğŸ’œğŸ’›ğŸ’šğŸ’™ğŸ’Ÿâ£ from Philippines ğŸ‡µğŸ‡­ğŸ‡µğŸ‡­ğŸ‡µğŸ‡­ğŸ‡µğŸ‡­
wtf is this	wow iâ€™m so in love
Rosa Rodriguez	I'm Mexican!! But I live in Canada!ğŸ˜­
Juliana Valera	I WISH I GOT TO MEET YOU ON YOUR AMSTERDAM TOUR ğŸ˜­ğŸ˜­ IM SO PROUD OF YOU THOUGH CAMILA YOU ARE SUCH AN INSPIRATION â¤ï¸â¤ï¸â¤ï¸
Cruz	You was there when no one was ğŸ’—ğŸ‡²ğŸ‡½ğŸ‡²ğŸ‡½ğŸ‡²ğŸ‡½
Evillyn Beatriz	MARAVILHOSO, LINDO,  _nÃ£o entendi nada_
Adriana Matos	ğŸ’•
Noticias GerPar	Camila no entiendo porque en tus redes No hablas espaÃ±ol!!!!!!ğŸ¤”ğŸ¤”ğŸ¤”
ChaparrithA VÃ©lez	Dios como no amar a esta mujer
Nancy Viridiana	CAMILA MEXICO SIEMPRE TE TENDRA UN AMOR INCONDICIONABLE!!! TE AMAMOSâ™¥â™¥â™¥â™¥
Yesenia M6	Wow u inspire me so much ilysm!
Andrea Vidal	Me da un chingo de orgullo pensar que tengo sangre no solo latina si no que 100% mexicana ğŸ˜ y tambiÃ©n me da orgullo pensar que yo estuve ahÃ­ ğŸ™‚
Cindy Romero	FuÃ© hermoso haber sido parte de el NBTSTourMTY. Te amoooooo ğŸ’œ
Fernanda Torres	Ese fue el mejor dÃ­a de mi vida...GRACIAS CAMILA ğŸ’ğŸ’ğŸ‘‘
Zaeth Ojeda	TE AMO UN BUEN)):
Perla ZÃ¹Ã±iga BÃ¡cenas	â¤ï¸â¤ï¸â¤ï¸ğŸ˜­ğŸ˜­ğŸ˜­â¤ï¸â¤ï¸
Danna Paola Montoya Zumaya	Lo eres todo en esta vida! Vuelve pronto, para todas esas personas que no tuvieron lo suficiente para ir  y estar contigo te esperaremos todo lo que sea necesario. Te amamos!
AmÃ©rica Moreno SantillÃ¡n	I love you so much â¤ğŸ˜­
Wilben FabiÃ¡n	I LOVE YOUğŸ˜PLEASE THE DIARY TOUR OF PUERTO RICOğŸ‡µğŸ‡·
Val Bortoni Styles	Te amooooo
dua puluh januari	Saya suka.....ğŸ’–ğŸ’–ğŸ’–
JANITA SIBOLE	I love you even moreâ™¥ï¸
alexa daniela arroyo	gracias por darme el mejor dÃ­a de mi vida! ğŸ’“ y por demostrarme que todo es real y posible. Te amo! Que hermoso es saber que estuve ahÃ­
Tumblr Girls	CAMILA LOVE YOU
Bos Bonye	Te amo Camila
Larissa	I LOVE YOUUUUU ğŸ’—ğŸ’—ğŸ’—
Celine Cerdio	Fue hermoso si vuelve pronto yo voy de nuevo ğŸ˜­ğŸ˜­ğŸ˜­
dorky crybaby	"VIVA MEXICO CABRONES!!"
Paola G	TE AMAMOS, muy orgullosas de tiâ¤ï¸â¤ï¸ğŸ‡²ğŸ‡½ğŸ‡²ğŸ‡½
ana garza	infinitamente agradecida de ser parte de esta experiencia. orgullosa de admirarte y orgullosa de ser mexicana. te amo.
reinaldo borges	a cami  uma grande cantora da atualidade
dream Big	Love you Camilla â™¥ â™¥ â™¥
Darinka PÃ©rez GarcÃ­a	Ahuevo! ğŸ˜­â¤â¤â¤ Te amioo.
Hanny Quiroz	Viva Mexico!!! I love you ğŸ˜©â¤ï¸
Andrea Baxter	Hermosa!!ğŸ˜
Cosette Hernandez	ğŸ˜ğŸ˜ğŸ˜ğŸ˜ğŸ˜ Mas vlogs porfaaaa
DIANA SALVATIERRA	Hermosa
Sol Pacheco	Te amo un chingo ğŸ˜ğŸ˜ğŸ˜ğŸ˜ğŸ˜ğŸ˜ğŸ˜ğŸ˜
ramirez juan	I LOVE U CAMILA UR MY FAVORITE SINGER
MSM torches	Is she in a bathroom?ğŸ˜‚â¤
Veroonica Valdez	8:59 10:50 10:53
Jums Rot	El "Ahuevo" me matÃ³ ğŸ˜‚ğŸ˜‚ğŸ˜‚
CamzTyJish SqueletonCamilizer	QUE HERMOSURA DE MUJER CHINGAO' TE ESPERAMOS DE VUELTA MUY PRONTO FLACA, TE AMAMOS MUCHOğŸ’–
m.a.r. i.a	Simplemente arte de esta Reina ğŸ’•
JÃ©ssica KL	Greetings from Brazil ğŸ¶ğŸ‡§ğŸ‡·ğŸ”¥ Saludos desde Brasil ğŸ¶ğŸ‡§ğŸ‡·ğŸ”¥
Karen Quevedo	Â¡QUÃ‰ VIVA MÃ‰XICO CABRONES! TE AMAMOS MUCHÃSIMOğŸ‡²ğŸ‡½âœ¨â™¥ï¸
sÃ³ mais uma fÃ£	CADE A DO BRASIL ğŸ‡§ğŸ‡· ğŸ‡§ğŸ‡·ğŸ‡§ğŸ‡·ğŸ‡§ğŸ‡·ğŸ‡§ğŸ‡·
Ari jm0z	ESTA COSA SE PRENDIÃ“ LPM!!! ğŸ˜ğŸ˜ğŸ˜ğŸ˜ğŸ˜†
Ana Sandoval	Este es el primer vÃ­deo en donde veo que Camila reemplaza el *You know* con el *Â¡Viva MÃ©xico, Cabrones!*.
Park Jimin	Mujer MÃ©xico te amoâ¤
Valentina Gtrz	Como te amo
Câƒ£ Aâƒ£ Râƒ£ Mâƒ£ Eâƒ£ Nâƒ£	Camila en Tequila llorÃ© como loca por que no obtuve una foto contigo, me dueles
Diana Vee	So proud to be Mexican !!
Lisa Rodriguez	I love her omfg
Willies	10:52 ahuevo TE AMO
_Nicolas Bqz_	That was incredible ğŸ˜ğŸ˜ You're the best for me Camila, you made me cry ğŸ˜­ It was too fast ğŸ˜­â¤ï¸  We love YOU ğŸ˜ŠğŸ¤—ğŸ˜
nicole vega	Hay pero que hermosaâ¤
Beatriz Duarte	Vai ter do Brasil ??
Onlin3i	Ansioso pelo br
MÃ¼zik zamanÄ±	Love you camilaa
J V	Awebo!
cynthia rojas	Te amooooo ğŸ¤©ğŸ‡²ğŸ‡½
Josh Teran	Te amoooo
Ivon Sandoval	Te amoooğŸ˜­ğŸ˜­
Idvy Michelle Paez Carlos	Fue un evento increÃ­ble, y estoy feliz de que te sintieras a gusto en este paÃ­s tan hermoso, lindo y querido como lo es mi MÃ©xico ğŸ‡²ğŸ‡½. Te amo Camila.
à¹€à¸•à¹‹à¸­ à¹€à¸­à¸‡	Miss you Camila Cabello
TUHATER	00:56 jajaja hay un perro acostado y se le ve el ano jajaja
CHEROOO	VIVA MÃ‰XICO CABRONES!!!ğŸ‡²ğŸ‡½ğŸ‡²ğŸ‡½ Te amamos un chingo ğŸ˜
zaida ambris	No tienes idea de cuÃ¡nta admiraciÃ³n, aprecio y amor te tengo, eres mi mÃ¡ximo Ã­dolo. Te amo â¤ï¸
Lola XD	Te amo
Violeta	DesearÃ­a volver a este dÃ­a, realmente fue hermoso... Y cuando saliÃ³ tu papÃ¡ fuÃ­ la mÃ¡s feliz. Â¡Quiero volver!
Gabriel A Rivera	ğŸ‡²ğŸ‡½â¤
joseee alfaro	MÃ©xico Ganando como siempre â™¡â™¥â™¥
Gisela Isabel Alvarez GuzmÃ¡n	Wow que lindo!!!
Carlos Alberto Rodriguez Garcia	Viva MÃ©xico take me back to that dayy extraÃ±o a camila
neeella pelotuda	DE MIAMI A CHILE, LA CARRETA SE PRENDIÃ“OOOOOOOOOO
Alejandra PatiÃ±o	MÃ©xico â¤
Marittza Melina Delgado Martinez	Â¡Â¡Me encantas preciosa!! Tu humildad es lo que mÃ¡s te hace Ãºnica mi niÃ±a raritağŸ˜â¤ Â¡Viva MÃ©xico! Tu tierrağŸ’•
Luz Talia MeJu	Ese viva MÃ©xico ğŸ‡²ğŸ‡½ cabrones es lo mejor del mundo ğŸ˜‚ğŸ˜‚ğŸ˜ğŸ˜â¤ï¸â¤ï¸ğŸ‡²ğŸ‡½ğŸ‡²ğŸ‡½
Teniola Ogunbitan	When is havana   tour??
oH Sillie.Mp4	LO MEJOR QUE VIVÃ EN MI VIDA.
mexican lauren	fue mÃ¡s que un placer haberte tenido en nuestro paÃ­s, te amamos mucho espero vuelvas prontoğŸ’•
Magaby Romero	Es normal llorar por no haber podido ir y ver esto tan hermoso. ğŸ’• :')
Gab	"So proud of my flaca" AY DIOS ESTOY LLORANDO LPM ğŸ˜­ğŸ˜­ğŸ˜­ SAME ALEJANDRO SAME
Jose Antonio	Nunca olvides que llevas sangre mexicana. Te Amo Camila. Eres la mejor.
Yago Mahue	Gracias por todo hermosa, aquÃ­ siempre te estaremos esperando , te amoâ¤ï¸â¤ï¸â¤ï¸â¤ï¸â¤ï¸â¤ï¸â¤ï¸â¤ï¸â¤ï¸â¤ï¸â¤ï¸
Denice Flores	Ir a tu concierto fue lo mejor ğŸ˜­â¤ï¸
Talent Manana	love from Africa
Cloudy nâ€™ fluffy sweetener life	Te juro que cuando me vi bailando contigo en el vÃ­deo me fui a imprimir los screenshots para ponerlos en un pÃ³ster gigante en mi cuarto! No lo puedo creer!! Te amo Camila eres un amor ğŸ˜ğŸ˜ğŸ˜ aun sigo llorando ğŸ˜­â¤ï¸
Isha Calderas	CreÃ­ que hablarias en espaÃ±ol ğŸ˜¢ğŸ˜‚
CAMILIZER 1 9 9 7	TE AMOOO MALDETA SEA!!! :"v ğŸ˜­ğŸ˜­ğŸ˜ğŸ˜ğŸ˜ Quisiera guardarte en un cofresito como la hermosa perla que eres donde nadie te pueda lastimar :'3
Ma Sakamoto	TE AMO ğŸ–¤
Dani :B	Te amoo â¤ï¸â¤ï¸
Brisa Mendes	DE MAIAMI A MEXICO ESTA COSA PRENDIOOO BABY
Mariana Salais	LlorÃ© todo el vÃ­deoğŸ˜­ eres una chingona Camila! Y toda tu familia tambiÃ©n!! Â¡VIVA MÃ‰XICO CABRONES!ğŸ‡²ğŸ‡½ğŸ–¤
Jorge Cavalcanti	Talent+love+family+friends+best team= SUCCESS in the World!
Sofia Espinosa	De por si llore por no ir ahorita mas
Isela Ayala	Amo Ã©ste vÃ­deo. Cami estÃ¡ cada vez mÃ¡s hermosa ğŸ˜â¤â¤ Viva MÃ©xico cabrones!!!
Cristina Lopez	TE AMOOOOOOO
Lorena ANT	Podrias poner subtitulos en espaÃ±ol  porfis, Te amooooooooooo CamilağŸ’–ğŸ’–ğŸ’–ğŸ’–ğŸ’–ğŸ’–
Karla V	Que hermoso
reaksmey veach	i love you my idol
una persona :v	No le entendÃ­ nada pero Ã±ee xd Es Camila :v  (solo le entendÃ­ a cuando dijo "Viva MÃ©xico cabrones" );-; Ahuevo xdxd
silk	damn its so refreshing to see a young pop start with so much influence be so open about her culture. I sometimes wish my favourite celebs like selena gomez and demi could be more like this but they kinda deny their heritage
O Desafiado	ğŸ‡§ğŸ‡·ğŸ‡§ğŸ‡·ğŸ‡§ğŸ‡·ğŸ‡§ğŸ‡·ğŸ‡§ğŸ‡·ğŸ‡§ğŸ‡·ğŸ‡§ğŸ‡·ğŸ‡§ğŸ‡·ğŸ‡§ğŸ‡·ğŸ‡§ğŸ‡·ğŸ‡§ğŸ‡·ğŸ‡§ğŸ‡·ğŸ‡§ğŸ‡·ğŸ‡§ğŸ‡·ğŸ‡§ğŸ‡·ğŸ‡§ğŸ‡·ğŸ‡§ğŸ‡·ğŸ‡§ğŸ‡·ğŸ‡¦ğŸ‡¨ğŸ‡¦ğŸ‡¨ğŸ‡¦ğŸ‡¨ğŸ‡¦ğŸ‡¨ğŸ‡¦ğŸ‡¨ğŸ‡¦ğŸ‡¨ğŸ‡¦ğŸ‡¨ğŸ‡¦ğŸ‡¨ğŸ‡¦ğŸ‡¨ğŸ‡¦ğŸ‡¨ğŸ‡¦ğŸ‡¨ğŸ‡¦ğŸ‡¨ğŸ‡¦ğŸ‡¨ğŸ‡¦ğŸ‡¨ğŸ‡¦ğŸ‡¨ğŸ‡¦ğŸ‡¨ğŸ‡¦ğŸ‡¨ğŸ‡¦ğŸ‡¨ğŸ‡¦ğŸ‡·ğŸ‡¦ğŸ‡·ğŸ‡¦ğŸ‡·ğŸ‡¦ğŸ‡·ğŸ‡¦ğŸ‡·ğŸ‡¦ğŸ‡·ğŸ‡¦ğŸ‡·ğŸ‡¦ğŸ‡·ğŸ‡¦ğŸ‡·ğŸ‡¦ğŸ‡·ğŸ‡¦ğŸ‡·ğŸ‡¦ğŸ‡·ğŸ‡¦ğŸ‡·ğŸ‡¦ğŸ‡·ğŸ‡¦ğŸ‡·ğŸ‡¦ğŸ‡·ğŸ‡¦ğŸ‡·ğŸ‡¦ğŸ‡·???
FC NA	Estoy llorando
Daniel Reyes	Camila love des de mexicoooo
Guadalupe Aguilar Ruiz	Te amo camila
r0sesdeath	Te amo mucho mi niÃ±a hermosa
Mangle001	That corn is mood
adriana luna	Estoy orgullosa de ser mexicana ğŸ’•â¤ï¸
MoisÃ©s	10:53 ğŸ¤£ğŸ¤£ğŸ¤£ğŸ‘ŒCamila is so funnyğŸ’–
nsouteras	Hace uno de Argentina y uruguay
Manuela Gasparini	Na espera do video do BRASILğŸ‡§ğŸ‡·ğŸ˜
Xime guillen	ğŸ˜»ğŸ‡²ğŸ‡½
On The Road God First	SerÃ¡ que ela farÃ¡ um do BRASIL??
Juliette Martinez	No tuve la oportunidad de conocerla a ella, pero si a sus padres mientras la esperÃ¡bamos en su hotel y puedo decir que son unas personas muy amables y cariÃ±osas con los fans ğŸ’– a la prÃ³xima espero conocer a Camila de tan cerca ğŸ‡²ğŸ‡½ğŸ¤
Diana Meza	Hermosa ğŸ’‹ ğŸ’‹ ğŸ‡²ğŸ‡½ a huevo!!!
Darth Cyrus	Tu concierto en Guadalajara fue impresionante ğŸ˜ espero vuelvas pronto Camila... i love you â¤ï¸
Kaylee Ramirez	This makes me so extremely proud. Te queremos muchÃ­simo Camila !!!
Emily Vlogs /camilizer4ever	Cutieeeee
HappyHammy Blog	Most precious person i've ever seen. You just mean so to me.
Lais Monique	Quero consequences no Brasil
Liliana Oliva	Hearing you and your dad sing made me cry, I had never realized how proud I  am to be Mexican until that moment. I got chills. Youâ€™re amazing, Camila â¤ï¸ the most humble person ever. Estoy muy orgullosa de ti.
_riixaa_	HERMOSAAAğŸ˜
ê¹€ê¸°ë²”	Camila Cabello in BrazilğŸ’šğŸ’›ğŸ’šğŸ’›ğŸ’šğŸ’›ğŸ’šğŸ’›ğŸ’šğŸ’›ğŸ’šğŸ’›ğŸ’šğŸ’›ğŸ’šğŸ’›ğŸ’šğŸ’›ğŸ’šğŸ’›ğŸ’šğŸ’›ğŸ’šğŸ’›ğŸ’šğŸ’›ğŸ’šğŸ’›ğŸ’šğŸ’›ğŸ’šğŸ’›ğŸ’šğŸ’›ğŸ’šğŸ’›ğŸ’šğŸ’›ğŸ’šğŸ’›ğŸ’šğŸ’›ğŸ’šğŸ’›ğŸ’šğŸ’›ğŸ’šğŸ’›ğŸ’šğŸ’›ğŸ’šğŸ’›ğŸ’šğŸ’›ğŸ’šğŸ’›ğŸ’šğŸ’›ğŸ’šğŸ’›ğŸ’šğŸ’›ğŸ’šğŸ’›ğŸ’šğŸ’›ğŸ’šğŸ’›ğŸ’šğŸ’›ğŸ’šğŸ’›ğŸ’šğŸ’›
Sam Z	Espero que vuelvas pronto hermosa que ya te extraÃ±amos!ğŸ˜ğŸ˜‚
Zuhaib Malik	love youğŸ˜ğŸ˜ğŸ˜ğŸ˜ğŸ˜ğŸ˜ğŸ˜˜ğŸ˜˜ğŸ˜˜ğŸ˜˜ğŸ˜˜ğŸ˜˜ğŸ˜˜ğŸ˜˜ğŸ˜˜ğŸ˜˜ğŸ˜˜
Leiby Morales	Camila te amo
I'm Mexican	Todo iba perfecto hasta que saliÃ³ el tucÃ¡n del Matthew ğŸ™„
Emily Kate	YOUR DAD IS AUCH A GOOD SINGER I LOVE HIM HES OUR DAD NOW
brick killer	TambÃ©m quero o tour diary do Brasil ğŸ’™ğŸ’œğŸ’œplease
Quinn Hensley	ğŸ¤—ğŸ¤—ğŸ¤—ğŸ¤—ğŸ¤—
Maria Doodles	She is so amazing and talented!
Amber Mopa	Camila should be a YouTubed low key
Joleen Chow	The roses thing is so amazing and reminds me of what my friend told me Taylor Swiftâ€™s team does too
Elienai Breceda	Siempre me haces llorar, MÃ©xico loves youğŸ’›
Ana Cristina	Â¡QUE CHINGON SABER QUE YO ESTUVE AHÃ!
Hailey Smith	ğŸŒ»CONGRATULATIONSğŸŒ»
Sandra zam	no entiendo ni madres el inglÃ©s :"v pero aun asi me emociono demaciado al oirte hablar :3
Esme Styles	Â¡VIVA MÃ‰XICO CABRONES!â¤ğŸ‡²ğŸ‡½
Its Iqra Iqbal	OML, I LOVED THIS!ğŸ˜
camz 78	CadÃª o Brasil camila??
Obed RodrÃ­guez	Ya ven otra vez ğŸ˜«ğŸ˜«ğŸ™ğŸ™ğŸ™ğŸ™ğŸ™ğŸ™ğŸ™ğŸ™
Fernanda Jauregui	Ahora es donde sigo arrepintiÃ©ndome de no haber ido ğŸ˜­ğŸ˜­ğŸ˜­ğŸ˜­ğŸ˜­ğŸ˜­ğŸ˜­ğŸ˜”
LJ Nicargua	ğŸ˜»â¤ï¸â¤ï¸â¤ï¸ğŸ˜­ğŸ’¯
madian zempoalteca martinez	Lamentablemente no pude ir pero te prometo que para el siguiente tour voy de a grapa
Beatriz Silva	I love you Camila #Camilizer
Abisay FA	Yo no pude ir alv :'v
Hanna kaitlin Ferrer Molfese	aww que hermoso canta me encanta sus canciones my celebrity favorite ğŸ’™ğŸ’™â¤â¤ğŸ’™ğŸ’™ğŸ’™ğŸ’™ğŸ’™ğŸ’™ğŸ’™ğŸ’™ğŸ’™ğŸ’™ğŸ’™ğŸ’™ğŸ’™
meow deow	Camila your the  best, always inspire me
Tara delaney	I'm so proud of you cami â¤ï¸â¤ï¸â¤ï¸
Johanna Escalante	:((( me deprimi quiero volverte a ver :(( pero mas cerca
Lourdes Alejandra Moreno Cardos	Te amo camila ğŸ˜ğŸ’—
Donaldo Reyes	Viva  MÃ©xico cabrones  te amo Camila. Eres muy hermosa. Y sigue asi de bella
Nafisa Yahyaeva	Camilla!! Amazing
Helena Decuyper	ğŸ‘ğŸ‘ğŸ‘â¤ï¸â¤ï¸couldnâ€™t go to a concert ğŸ˜­ are you coming to Belgium on your next tour? ğŸ™ğŸ™â¤ï¸â¤ï¸
de vuelta al basurero	Viva MÃ©xico cabrones!!! Yo no pude ir por que estaba enferma :c y trate de ir pero mi hermosa amiga que dijo que no podÃ­a :c pero aÃºn asÃ­ TE AMOOOO!
Luiza Basso Tonatto	Iâ€™m so so proud of youâ¤ï¸
Rosalinda Vazquez	Te amo wey. ğŸ’
valeria paris	Uuuuu
Yani Carmona	Me encantÃ³ Camila, eres la mejor
Adriana 04	Te amoooo Camila!! Por favor ven a PerÃº te amo ğŸ˜â™¥â™¥
Ling Ling Ng	Love her
Ximena Carrillo Rodriguez	Camila, baby I love you so so much, so much that you didn't have an idea. I love you my Little QueenğŸŒ¹ always with you bae
Karla Mtz	No lo he visto y ya dejÃ© mi like, Â¡VIVA MÃ‰XICO CABRONES! ğŸ’–ğŸ‡²ğŸ‡½
Karla Olguin Martinez	Oh my gosh I can relate so much... I teared up. Her dad reminds me of my papÃ . Quiero mucho a mi papÃ¡
Cristina Reyes	It was a beautiful dayğŸ’•ğŸ’•
Shere Khan	wE NEED aLEJADNRO AS A FEATURE ON cAMILAS  SPANISH ALBUM!!!!  WHENEVER THAT HAPPENS PUES...
raphaella prates	eu te amo, vc Ã© a pessoa mais incrÃ­vel desse mundoğŸ˜­ğŸ˜­ğŸ˜­ğŸ˜­
Ana Clara	Vei pro Brasil ğŸ’ğŸ’ğŸ’—
The fun Tribe	You should come to Kentucky without taylor
sorfts ily	eres el ser humano mÃ¡s precioso de este mundo y no sabes cuÃ¡nto te agradezco por el mejor dÃ­a de mi vida, verte en vivo ha sido lo mejor que me ha pasado, Â¡en mÃ©xico te amamos tanto! â™¡
Abii Abii	Te amo Camila â¤â¤
Camren is real	Que hermosa es Camila I LOVE SOU MUCH te amo tu gran fans
Valeria Balderas	Â¿Donde esta el chilito del que pica y del que no pica en ese elote?
Gida Ammouri	Bbbbyy
Fan Juz	SALGO YO!! LPM AAAAA QUE EMOCIÃ“N  TE AMO CAMILAAAAAAA VIVA MÃ‰XICO â¤
Gaby Ortiz	Todo muy feliz, hasta que sale matthew
Fer Del Angel	Hubieras hablado spanglish en el vÃ­deo
Michelle jewels Pinney	Adrenaline junkies United time infinity
Sad Girl alone	Brazil loves you, babe!! ğŸ’šğŸ’›
Gilda Terrazas	Awww â¤  AmÃ© ese concierto â¤ğŸ™Œ Thanks Camila ğŸ™ŠğŸ’
Valentina A	Volviendo a nuestras raÃ­cesğŸ˜ que lindo
Karolina Gonzalez	TE AMO UN CHINGO
Cami Godoy	Soy la Ãºnica que lloro en el min 9:38? JAJAJAAJ KE ESTUPIDAH AHRE
Francisco Dionicio	Omg amo a esta cantante bb eres lo maximo
itâ€™s.zineb IB	You make Latinos so PROUD baby
HappyFriends Ok	with the headset so perfect for listening ... â¤ï¸
Astry Espino	â™¥ï¸â™¥ï¸â™¥ï¸â™¥ï¸â™¥ï¸
Megan Gravel	so proud of you
Pamela	No me alcanzan las palabras para decir cuanto te amo y gracias por todo. Un dia de paso ven a PerÃº que acÃ¡ te amamos con locura â™¡
Sue Rojas	Alguien sabe donde quedo la chica de los covers cameela cabeyo.? :")  QUE ORGULLOâ¤
Rayanne Gamer	I love you Cama  my fairy
Jesus Emilio Sosa	OMG  I love you so much ğŸ’ŸğŸ’Ÿ Viva MÃ©xico !!!ğŸ˜‰
Emanuel Victor Marques	Vai ter no Brasil??
Jose Mendez	That's right beautiful " Viva Mexico Cabrones"!!!
Joce Calderon	I ğŸ’—  MÃ©xico
Kawaii Pizza Horse	Sheâ€™s so amazing! Oh my gosh!
Ana isabel Reyes Duarte	camila te quiero mucho espero algun dia pueda verte me encanto el video
saly diaz	Ayy nooo, soy un mar de lagrimas Camila !!! ğŸ˜©ğŸ˜©, neta te amooo demasiado , eres la mÃ¡s pinche hermosa persona princesa ğŸ˜­â¤ï¸â¤ï¸, gracias por todo y ser cmo eres ğŸ˜­ğŸ˜­â¤ï¸â¤ï¸â¤ï¸
Dulce HernÃ¡ndez	Mi amor te amo. Â¡Viva MÃ©xico cabrones! ğŸ’•ğŸ’•
Arleth Pineda Ruiz	Porfabor el ke noles guste los videos de camila cabello ballase y no le comente nada feo
A VERDADE E CLARA   COMO A LUZ	camila ti amo â¤ que bella dona â¤ ğŸ‘ğŸ‘ğŸ‘
Javier Robles	awebo!ğŸ˜‚ğŸ˜‚ğŸ’•10:53
M22 CJS	TE AMAMOS CAMILAAAAA â¤
Kimberly	Â¡AhÃ­ salgo!....entre la multitud del pÃºblico...bueno, sÃ³lo la luz de mi celular... ok, ni yo me alcanzo a ver, pero de que salgo no hay duda ğŸ˜‚ğŸ‘Œ #NeverBeTheSameTourGDL!!! ğŸŒ¹âœŒ
Yitzen Arroyo	El ahuevo del final no se supera we
Jenny Mascote	VIVA MEXICO CABRONES ğŸ‡²ğŸ‡½ â¤ï¸
Pussynia Virgen	Ahuevooo.
E & F F	XD yo no pude ir ğŸ˜­ğŸ˜­ğŸ˜­ğŸ˜­a tu concierto y tambiÃ©n me encantan los tacos como tu Daddy viva MÃ©xico ğŸ‡²ğŸ‡½
tefi	TE AMO, TE EXTRAÃ‘O VUELVE DE NUEVO BEBE
Joss Mier	Estoy tan orgulloso de ser de tu fandom y de haber estado en el Never Be The Same aunque no te conocÃ­ en persona mi sueÃ±o es abrazarte y decirte lo mucho que te amo porque tÃº eres mi razÃ³n de ser
sky	TE AMO, Y ESTOY MUY ORGULLOSA DE TÃ :')
Brandol Barkhley	TE AMOOOOOOO ERES LA VERGAAAA ğŸ‡²ğŸ‡½ğŸ‡²ğŸ‡½ğŸ‡²ğŸ‡½ğŸŒ®â¤ï¸â¤ï¸â¤ï¸ğŸ‘‘
winderlys blanco	AlgÃºn dÃ­a te conocerÃ© lo prometo eres una mujer maravillosa te admiro tal y como eres,tu eres una mujer luchadora como tu     madre te mereces esto y mas algÃºn dÃ­a te abrazare ese es mi mayor sueÃ±o tomarme una foto con vos y lo prometo algÃºn dÃ­a te  quiero mucho Camila eres una luchadora estoy orgullosa de vos te quiero espero conocerte
Andrea Mendoza	VEN A COSTA RICA BEBÃ‰!!!â™¥
Miguel Crespo	Hermosa, hija de dos tierras hermanas, papa mexicano y madre cubana, nacida en Cuba criada en la Florida, QuÃ© combinaciÃ³n ..... I love ğŸŒ¹â¤ğŸ‘‘
LCKittyQueen	Like if youâ€™re here before 100,000!
Molly Rose Magic	You are one of the most freaking nicest human beings let alone singers. ğŸ’–
Yami :v :3	no entendÃ­ casi nada de lo que dijo que pero Te Amo Camila â¤â¤ :v
Arely Estrada Rodriguez	Por dios quiero regraste a ese dÃ­a estuvo hermoso ğŸ’–ğŸ’– lloro
J&A J&I	Esperando el prÃ³ximo con mucho cariÃ±o y AMOR â™¡ GUADALAJARA â™¥ï¸
edna rodriguez	La mejor mujer de el mundo â¤
Cute Cupcake	Oh my god Camila! I love you, you helped me through everything I love you!! ğŸ’–ğŸ’–ğŸ’–ğŸ’–ğŸ’–ğŸ’–ğŸ’–ğŸ’–#camilaqueenforever
Dulce Santiago	Guadalajara eso es todo CamÃ­!
Juan Taboada	Hola :D
Shiba 5H	in Romania de ce nu vine oare? :))
Yareli Lpz	Lo amÃ© es perfecto ğŸ’–ğŸ’–
fede :B	CAMILAZERLANDIA ES EL MEJORğŸ‡¦ğŸ‡·
Daphne Caussade	can you show the puerto rico ğŸ‡µğŸ‡· one please camila ps i went to your concert
helbeeestklc	queenğŸ˜
ximena xicohtencatl	Ame esto.... te amo
Vale S	Amamos a la "vieja esa que va a cantar " jajaja .
Î±ÊlÎ¹Ğ¸	se hubieran hechado la bikina
azalia Lorenzo	Asi se lleva Mexico en la piel Camilaaaaaaaa â¤ï¸
Red Tulip	Halllllloooooo
Mauricio Solis	Creo que te amo.â™¡
Shion Ari	Te amo tanto Camila ğŸ˜»ğŸ˜»ğŸ˜»
Nacer Waria	You are best camila ğŸ’ğŸ’‹ğŸ’ğŸ’‹ğŸ’‹ğŸ˜ˆ
Andrea MV	POR QUÃ‰ ERES TAN PERFECTA? LA PTMğŸ’ªğŸ’“
Linete Canchola	Te amooooo bb
Esteban GarcÃ­a	You were amazing in Monterreyâ™¥ï¸ te amÃ© ğŸ˜ğŸ˜
Jonathan Barbe	JTM
Wesley Silva	MÃ‰XICO LINDO Y QUERIDO
G_ lira	que hace el colado de Matthew pusy ahÃ­?
abigail sanchez	Que linda
Azia S-H	ğŸ˜ğŸ˜ğŸ˜
Alexandra Reyes	No entendÃ­ nada de lo que dijisteğŸ˜‚, pero TE AMOâ¤â¤â¤â¤â¤â¤â¤
JesÃºs Hernandez	Por que hablas inglÃ©s, que ridÃ­cula, mejor habla el espaÃ±ol por que estÃ¡s hablando de MÃ©xico y la neta no entiendo nada
Sofiiia RodrÃ­guez	Tienes que volver esa noche fue inolvidable te adueÃ±aste del auditorio y Dr MÃ©xico! ğŸ˜˜ğŸ˜˜
Silvana Rios Behr	TE AMOOOOOOOâ¤â¤â¤
Sonya Strelnikova	Camila, I love you SO much!!!  You are one of the best singers, and one important thing, that you really love your fans. I wish I can get a ticket to your concert, but I donâ€™t think that you will be in Russia, so it is disappointing. But no matter where I am, I will always adore your songs, and respect you Love youâ¤ï¸
STARGIRL BITCH	MÃ‰XICO AMA A CAMILAAAAğŸ’•ğŸ‡²ğŸ‡½
Arvind Grande	lysm camila! we're always there for you!â™¡ btw i'm so hungry after looking at those food ğŸ˜‚
Marco Antonio	MÃ‰XICO! ğŸ‡²ğŸ‡½
Natalia Hernandez	Te amo â¤
Direnizer Dlm â€¢	Te amoooâ˜„â˜„â˜„â˜„
Valeria Oseguera Baltazar	VIVAAA MÃ‰XICO ğŸ‡²ğŸ‡½ WUUUUUUUUUUUUUUUUUU
CAT MONTES	Â¡Â¡Me encantaaaaa!!â™¡ MuchÃ­simas gracias camila por ser tan tÃº â™¡:D Puedo decir que soy parte de esto:D y valiÃ³ muchÃ­simo la pena todo el esfuerzo que hice para poder verte, escucharte, sentir las vibraciones de tu voz, de la mÃºsica, poder mover cada mÃºsculo de mi cuerpo con mucha felicidad y sentir la sensaciÃ³n de disfrutar cada segundo :D Â¡Lo amÃ©! AmÃ© el NBTSTourâ™¡ Sigue cosechando la felicidad en ti y compartiendo ese sentimiento, sigue creciendo camila, tienes derramando tu talento, eres grande, inteligente, carismÃ¡tica, empatica, geniaaaaaal!!! Te deseo todos los Ã©xitos del mundo ati y a tu familia, que tambiÃ©n estÃ¡ muy loquita, jeje, pero me encanta porque esa es la actitud mexicana, la que nunca deja entrar la tristeza, la que nunca se rinde, ser mexicano es lo mÃ¡s chingon!:D  Te esperamos cuando quieras camilita, ati, y a todo tu equipo, todos lucieron asombrosos en cada cosa que realizaronâ™¡ :D Vuelve pronto por favor, los taquitos, elotes dorados y jarritos te estarÃ¡n esperando :3â™¡   Â¡VIVA MÃ‰XICO CABRONES!!â™¡  Te amooo camilaaaâ™¡:D
FÃ©lix Carranza	Hermosa camila cabello  hermoso ser humano cuÃ¡nta luz we love you ğŸ‡²ğŸ‡½ğŸ‡²ğŸ‡½ğŸ‡²ğŸ‡½â™¥ï¸ğŸ˜
Pau G	regresa pronto TE AMO ğŸ‡²ğŸ‡½â¤ï¸
Gina Amanda Velasquez Lipa	esto es realmente triste :( cam cuando para perÃº :'(
Jime Espinosa	La amoooo tantoooo q no es normalllll xddğŸ–¤âš˜
Destiny. you had missed zr rbe Virginiai. love. u.	Omg
I say Banana / Platano tambien :v	Me parece que no quieren a Mathew...sale sobrando el siempre. ..JajajajajağŸ˜¹ğŸ˜¹ğŸ˜¹ğŸ˜¹
Kingdom Clarke	Love the video
Rosy Flores	DE MIAMI A MEXICO!!! ğŸ’šğŸ‡²ğŸ‡½â™¥
Yahaira Bibiano	Camila la mejor del mundoğŸ˜ Me encanta â¤ğŸ‘‘
Gemmis Rivera	MÃ©xico te ama mi amor, vuelve pronto ğŸ’•ğŸ’«
rakel flores	Traduzcan el videoooooo
Eduardix 23	Yo no hablar inglish xdxd:b
Amina MoulaÃ¯	I love you camila
Izzy P	â¤
Anel GuzmÃ¡n	"no nos podemos comer unos tacos" te amo tanto ğŸ˜­â¤ï¸ğŸ‡²ğŸ‡½ğŸ˜‚
rem year	Love U Camila Cabello
MissxPetrovax3	Papa Alejandro â¤ï¸â¤ï¸â¤ï¸â¤ï¸â¤ï¸
Aime Soriano Zetina	eres la mejor
Agustina GÃ³mez Adorante	te amo tanto
Victoria Marrugo	Ver a Camila cantando con su papÃ¡ hace que se me enchine la piel, que hermoso todo â¤
Ø­Ù…ÙˆØ¯ÙŠ_ 992	Ø§Ù„Ø¹Ø±Ø¨ Ù†Ø­Ù†Ø§ Ù‡ÙˆÙ†Ø§
Alicia Gomez	Me hiciste llorar mucho :(â™¡ Me la paseeeee super INCREIBLE el 24 de septiembre! Te tengo en mi corazÃ³n, te veo pronto!!!
Cecy	Camila cabello MÃ©xicana.  VAMOS MEXICANOS PARTE MEXICANOS VAMOS MEXICANO
Anya LeÃ³n	Te amo y "Viva MÃ©xico Cabrones" ğŸ‡²ğŸ‡½ğŸ˜‚
xime A	Eres increibleğŸ‘ğŸ‘ğŸ‘ğŸ’œğŸ’œğŸ’œğŸ’œ
CamEEla Banana Jauregui	TE AMO ğŸ’–
Daniela Morales	Puede sonar  raro,pero tu eres de las personas que pueden hacerme tan feliz en un momento y a pesar de estar tan lejos mi amor y apoyo por ti siempre sera incondicional.â¤
Fatima Cecilia Gutierrez Vazquez	Te amo camila viva Mexico cabrones saludos desde Mexico
Homero Salazar	Muchas gracias por estar en nuestro paÃ­s viva mexicooooo cabronesÂ¡Â¡Â¡Â¡
BLACKPINK BB SHEERAN BTS UNICORNIO LITTLE MIX CLC	My love â™¥â™¥â™¥â™¥â™¥â™¥â™¥â™¥â™¥â™¥â™¥â™¥â™¥â™¥â™¥â™¥â™¥â™¥â™¥â™¥â™¥â™¥â™¥â™¥â™¥â™¥â™¥â™¥â™¥â™¥â™¥â™¥â™¥â™¥â™¥â™¥â™¥â™¥â™¥â™¥â™¥â™¥â™¥â™¥â™¥â™¥â™¥â™¥â™¥â™¥â™¥â™¥â™¥â™¥
Adam Naguim	Camilla I love youğŸ˜ğŸ˜ğŸ˜ğŸ˜ğŸ˜ğŸ˜
Jaquelin Vega	Te amoo .. ! Eres la mejor ğŸ˜˜ğŸ’«
titita tutita	Fiquei com ciÃºmes...
Amaria Raines	Camilla is awesome and so sweetğŸ˜˜ğŸ˜˜ğŸ˜ğŸ˜ğŸ˜ğŸ˜ğŸ˜—ğŸ˜—
Judy F	You look gorgeousâ¤ï¸ Ily so much queenğŸ‘‘ Keep killin shit and may God continue to bless you and yoursğŸ™ğŸ½ And stay safe this holiday seasonğŸ’ªğŸ½ğŸ‘ğŸ½ğŸ‘ğŸ½ğŸ‘ŒğŸ½ğŸ’‹
ySra- GravadÃ¸rah_	Linda
NAZEM Sy	ğŸ˜­ğŸ˜­ğŸ˜­
Maddie Shea	The NBTS Tour literally changed me. I Will Never Be The Same
Kiki W	#HğŸ…°VğŸ…°NğŸ…°ğŸ˜»ğŸ˜»ğŸ˜»ğŸ˜»ğŸ˜»â¤â¤ğŸ’™ğŸ¼ğŸµğŸ¤ğŸ”ğŸ”
Nicole Rico	Me encanta Tequila!!! Uno de los  grandioso pueblos mÃ¡gicos con los que cuenta MÃ©xico!!!!
N Art	The MOST GENUINE artist right now in the music industry. You're beautiful inside out Camila. Such a great inspirations!
Gabriela V.	like los que son PanameÃ±os(as) quieren que valla Camila cabello a PanamÃ¡ ğŸ˜˜ğŸ‘
j e s s i ca	VIVA MEXICO AND CAMILA
Gaston RomeroÃ±	AAAAAAAAAAAAAAAH LA. AMO TANTO
The Espectre	Es MÃ©xico! :v
Sweetener Songs	TE RE AMOOO KARLA
Sarvesh Gudekar	Awesome ain't it?!!
Allison Rojas	Exijo subtitulos >:v
nataly burgos	Ven a PERÃšğŸ˜ğŸ˜ğŸ˜
Ivonne HernÃ¡ndez	WAS AMAZING!!!!!! TodavÃ­a no puedo creer que te tuve taaaaaan cerca ğŸ’œğŸ™ŒğŸ»ğŸ™ŒğŸ»ğŸ™ŒğŸ»
Vianey _cc97	MÃ©xico es de Camila totalmente, fue la mejor noche de mi vida hasta el momento â¤ğŸ‡²ğŸ‡½ Te amo demasiado âœ¨ğŸŒ¹
Charles RiVi	Mi preciosa y linda cubanita. Sigue asÃ­ triunfando que te mereces todo lo mejor del mundo. Dios te bendiga eternamente. Bendiciones
Emely Bustillo	I â¤ï¸ u  #Camilaforeva
Hameeda Mohammed	we all love you..
Lizmariely Figueroa	Love her so muchâ¤â¤â¤ I'm still keeping that promise camliağŸ¤...people who went to one of her concerts would knowğŸ˜‹ğŸ˜‹ğŸ¤—
boys over flowers	Wait , isn't she Cuban? nevermind mind she already said she is,peaceâœŒï¸
Lana ChrisBerry	KeÅŸke TÃ¼rkiye'ye de gelsen Camz. TÃ¼rk Camilizerlar olarak seni Ã§ok Ã§ok seviyoruz â¤ï¸â¤ï¸â¤ï¸
Kendra Mora	Eres una encanto ğŸ’™
zoe the killer	Awwwwww ğŸ˜®ğŸ˜®ğŸ˜®ğŸ˜®ğŸ˜® ya te quiero ver â™¥ï¸â™¥ï¸
Y O	Crei que por ser de MÃ©xico iba a estar en espaÃ±ol tooodoooo. Estoy hasta la puta madre Camila, no confirmas camren y no hablas en espaÃ±ol en un vÃ­deo de MÃ©xico ğŸ˜¤ğŸ˜¤ğŸ˜¤  Pero te amo no lo olvides â¤ğŸ˜¤
Mohit Sharma	beautiful you are love from india ğŸ’‹
Lex PowerYT	Por que solo hablas inglÃ©s? Y no espaÃ±ol?
ddlovogue	voy a llorar, ya regresa, weeeeey.
Itati Segovia	Oh Dios Mio Que Hermoso Video
sandra carbone	i freaking love this girl
TheVictor Gameplays	GoooD Camila
Niki Brito	Quiero que sepas que te amo con todo mi corazÃ³n que te amo con toda mi alma â¤ amo tu musica y nunca dudes que mÃ©xico te ama igual mi bb siempre mÃ©xico te abrira las puertas de su corazÃ³n y me siento honrrada y orgullosa de que tengas sangre mÃ©xicana sangre de nuestro pais pero tambien cubana  igual bb nuestra gente de mÃ©xico humildes pero con un corazÃ³n grande para dar amor â¤â¤â¤â¤â¤â¤â¤â¤ğŸ’•ğŸ’•ğŸ’•ğŸ’•ğŸ’– TE AMAMOS NUNCA LO DUDES â¤
Itzel LF	La Reyna Mexicana ğŸ˜ Mexico te amağŸ’•
Karla Calderon Najera	AhuevoooooğŸ‡²ğŸ‡½ğŸ’•
soila berga	TE AMOOOOOOO TANTOOOOOOâ¤ï¸â¤ï¸â¤ï¸â¤ï¸â¤ï¸â¤ï¸â¤ï¸
nidia	Te amo un putero Camila enserio
Hope Wayland	this is beautiful
Ariel Cesar	Esta morocha me enamora! Saludos desde ArgentinağŸ‡¦ğŸ‡·ğŸ˜˜ğŸ¤—
Alonso Castro	MÃ‰XICO ğŸ˜
Anthony Delavega	this was the most cutest video ever you are literally one of the best singer in the world ğŸ˜ğŸ˜ğŸ’•ğŸ’˜ğŸ’˜â¤ï¸ğŸ˜love u camila
shelsi mejia	I love you camila ğŸ˜˜ğŸ˜˜ğŸ˜ğŸ˜â¤â¤
Kerem Sophia	Me encantÃ³ este video me hizo sentir mariposas ğŸ˜‚ğŸ”¥ VEN A GUATEMALA PLISğŸ’–
Fifth Harmony	ESPERO QUE EN EL PRÃ“XIMO TOUR INCLUYAS A CENTROAMÃ‰RICA!! Te amo ğŸ’•ğŸ˜­ğŸ’•
MoD Bo2 SNIPER	My love Camila ğŸ˜
Shaoran Jauregui	Imaginen que haga un tour pero solo para MÃ©xico :'0 Hermoso :v
alemandealemania	Viva Camila! Saludos desde Catalunya!
Viveka Kubendran	SHAWN MENDESğŸ˜â™¥ï¸â™¥ï¸â™¥ï¸â™¥ï¸â™¥ï¸
Iris De Valua	No entendÃ­ nada XD   Pero estÃ¡s toda HERMOSA :3 â¤ï¸ğŸ’•ğŸ˜ğŸ’•ğŸ’•ğŸ‘€
Flamingi Game	Wow camila
Sebastian Salazar	The best ever
Anita Java ZARATE	Camila Cabello en PERÃš!!  TE AMAMOS MUCHO !! ğŸ˜ğŸ˜ğŸ˜ğŸ˜ğŸ˜˜ğŸ˜˜ğŸ˜˜ğŸ˜˜ğŸ˜˜â¤â¤â¤â¤â¤ğŸ‘ğŸ‘ğŸ‘ğŸ‘ğŸ‘ğŸ‘ğŸ‘ğŸ‘ğŸ‘ğŸ‘ğŸ‘ğŸ‘‘ğŸ‘‘ğŸ‘‘ğŸ‘‘ğŸ‘‘ğŸ‘‘
Lucie Å˜Ã­hovÃ¡	11.tÃ­sÃ­cÃ¡tÃ¡
Luceroãƒ„	La mejor parte del video: 0:00 - 11:00 â¤
Leslie Moreno	Haha....diciendo de Mexico y hablando inglÃ©s!!ğŸ˜¶ğŸ˜‚
Avakin evieee â€¢	Got here at 43k views, I'm gonna see how much this video grows I'm guessing around 100m views in the future =]
Pratik Paramanik	Plz come in India...
Katie May	Might have shed a tear when she was on stage with her dad ğŸ˜­ğŸ˜
Guada Lupe	Here at 42k
ingrid zavala	Te amo ğŸ˜˜
Andy CC	MÃ©xico te ama un chingo mija. â™¥ï¸â™¥ï¸â™¥ï¸
D'iana M'artÃ­nez	â¤ï¸TE AMOOO CAMILA ERES UN SER HERMOSO :Â´3 ğŸ’™ SIGUE TRIUNFANDO CAMIğŸ˜
mica spadaboba	TE AMAMOS BELLAğŸ‡¦ğŸ‡·ğŸ’™
Sannez Camz	Oh por Dios!!!  Estoy llorando en este momento ese es el discurso mÃ¡s lindo y emotivo que he escuchado!!! ğŸ˜«ğŸ˜­ğŸ˜­ğŸ˜­ AMO la manera en que aceptas tus raices latinas ( *MÃ©xico* ) No puedo expresar lo *ORGULLOSA* Que estoy de ti.  *TE AMO* #Camila ğŸ‘ğŸ‘ğŸ˜­ğŸ˜­ğŸ˜­ğŸŒ¹ğŸŒ¹ğŸŒ¹â¤â¤â¤â¤âœ¨âœ¨âœ¨ğŸ‡²ğŸ‡½ğŸ‡²ğŸ‡½ğŸ‡²ğŸ‡½
Malukos TV	Te amooooo Gostosaa â¤â¤ğŸ‡§ğŸ‡·
IvÃ¡n TÃ©llez	:') Esto es hermoso, adoro a Camila.
Dina'h Sanz	I Love You!!ğŸ’•ğŸ’•
Karen SimÃµes	Te amo Camila ğŸ’•ğŸ’•
createinmeapureheart	I love you sooooooo sooooooo much @camila_cabello
Rhillery Andrade	TÃ´ esperando do Brasil ğŸ‡§ğŸ‡·ğŸ‡§ğŸ‡·
PRINCE INDRAJIT LAW.	Hey, Happy HALLOWEEN ğŸƒğŸ‰ğŸŠğŸ’ğŸ‘ğŸ˜˜ğŸ™ğŸ‘‘ . .
Feel_The_ lyrics _&_Beat	I love you so much
Mari Mar	TE AMOO
Mari Reyes	Te amamos cabrona â¤ï¸ eres una persona que hace bien y llegarÃ¡s muy lejos, no solo por tu talento, si no por tu increÃ­ble humildad, transparencia y gran corazÃ³n.
bÃ¡lint miklÃ³s	Camila the best vloggersğŸ˜â¤
Yesica Ruiz A.	Te amo .  Viva MÃ©xico cabrones ! ğŸ’œğŸ’œğŸ’œ
lupita cat	VIVA MÃ‰XICOOO!!! espero regreses pronto Camz <3
Pop Legendas BR	Eu tÃ´ assistindo aqui sem entender nada, mas que lindooo , concordo com tudo
saray Torres	Viva Mexico â¤â¤â¤!!!!!
Ruth Regan	This video was the most down to earth and loving Iâ€™ve ever seen you thank you for sharing this with us
Andy Rodriguez	Esperaba que fuera todo en espaÃ±olğŸ’”ğŸ˜‚
Jazmin Ferreira	Te amo de a madres, ahuevo mexicanas!!ğŸ‡²ğŸ‡½ğŸ™ğŸ»
Janeth Garcia	Omg, Camila es la persona mÃ¡s linda y tierna que uno puede conocer, cada uno de tus camilizer  de MÃ©xico estamos muy orgullosos de ti. ğŸ˜â¤ I love u, babe ğŸ’•ğŸ‡²ğŸ‡½ğŸŒ
E G	Viva mexico cabrones!!! La Ãºnica artista que ha mostrado que no le da vergÃ¼enza ser mexicana en el extranjero!!! ERES INCREÃBLE!!
Anahi Villalba	Camila la mejor te amoğŸ˜­ğŸ˜­ğŸ˜ğŸ˜â¤
Anaeli  Alvarez	Da tu viaje a MÃ©rida, quiero conocerte jiji): Te amo, soy muy tu fan):
julieta campos	CamilağŸ˜˜ğŸ˜˜ğŸ˜
Jax Axel	Who loves Camila Cabello??
Gustavo Rodrigues	Wooooow
Queen faty	you were more beautiful with your team fifth hormones I hope that you still with them â¤
Deyanira Mena	Yo siempre quiero tacos y no soy de Mexico...ğŸ˜‚ğŸ˜‚ğŸŒ®
okaygio s	TÃ£o linda ğŸ’•ğŸ‡§ğŸ‡·
YayoRey	Mi sueÃ±o mÃ¡s grande es poder conocerte eres la mejor
Salt Estephanie	Ayyyy DIOOOOOSSSS !!!! YA ME MORO DE FELICIDAD !
Mohammed Lami	MY Baby Mila ğŸ¦‹
Jacelyn Tran	This is so heartwarming. I love the way she loves her family
Sarah Marie	My whole heart bro
ana rodri	ğŸ˜­ğŸ˜­ğŸ˜
Jade LetÃ­cia	Quero do BRASIL
adnarim_catalina	ğŸ’•ğŸ’•ğŸ’•ğŸ’•ğŸ’•ğŸ’•ğŸ’•ğŸ’•ğŸ’•ğŸ’•ğŸ’•ğŸ’•ğŸ’•ğŸ’•ğŸ’•ğŸ’•ğŸ’•ğŸ’•ğŸ’•ğŸ’•ğŸ’•ğŸ’•ğŸ’•
Caticornios team	Argentina te amaâ¤
Fany & Dara	CreÃ­ que hablarÃ­a en espaÃ±ol xd
Alejandra Gutierrez	Fui la Ãºnica esperando algo de Jessie & Joy y Noel Schajris? ğŸ¤”
Santiago Santamaria	que vozarrÃ³n el de tu padre, y que bonito lo que hiciste en Mexico!!! so cute!!! <3
Karla BÃ¡ez	Te amooooo
Perla C	MÃ©xico te pinches ama.ğŸ‡²ğŸ‡½ğŸ’“
Dj11 111	I really wish u have more shows in Europe on your upcoming toursâ¤
Sandra Fdz.	Que hace el mateo aqui?ğŸ˜ ğŸ˜ ğŸ˜‚
Nallely Sanchez	Hermosa te amo tanto ğŸ˜ Y que viva MÃ©xico Cabrones!! ğŸ‡²ğŸ‡½â™¥ï¸
Princess S2004	â¤ï¸â¤ï¸
fatima	Gracias por tomarnos en cuenta en todos tus proyectos, por fortuna pude ir al show en Guadalajara. Tienes un carisma sÃºper bonito, gracias por ser tu misma. MÃ©xico te ama y te esperamos para lo prÃ³ximo que venga. TE AMOOOO. ğŸ’•ğŸ’•
INNa	Camila I love you so much.#Camilizerforever ğŸ˜‰ğŸ˜ğŸ˜˜ğŸŒğŸ”ğŸ™ˆğŸ™Šâ¤
Juliana Silva	ğŸ˜ğŸ˜ğŸ‡§ğŸ‡·ğŸ’™ğŸ’šğŸ’›ğŸ€ğŸŒ»ğŸ‡§ğŸ‡·ğŸ˜ğŸ˜ğŸ˜˜
Alex R	ğŸ’•ğŸ’•ğŸ’•
UnUsuario Misterioso200	Don tucan en todos lados:v
mariposa cub	She had Mexican but I see more Cuban on her ...but good for her ..Mexico is a good country to make a business so she smart enough to know will be good for her and her father is from there so good Camila!!
Art For Kids Art By Kids	Wish u did a tour in England because that would be awesome
Jose eduardo Nataren alvarez	Minuto 9:00 lo ame,Â¡Â¡Â¡viva MÃ©xico cabrones!!!!ğŸ˜‚ğŸ˜‚ğŸ‡²ğŸ‡½â¤ espero y fijes esto Camila Cabello yo fui al never be the same Tour en la ciudad de MÃ©xico te amoooooooooooooooğŸ˜ğŸ˜ğŸ˜ğŸ˜ğŸ‡²ğŸ‡½â¤â¤
Yesenia Morales	Camila te amo
Daniela2703	Te amo demasiado ğŸ˜­ğŸ™Šâ¤
Dadaneitor Dadense	Viva MÃ©xico cabrones camila tiene que estar el eestado de cuernavaca en algÃºn tour que hagas yo soy de ahÃ­ y te quiero verte en concierto te amo mucho ğŸ’—
Morena Villarreal	Camila por favor dile a shawn que venga a argentina!!!!!
Kartik Sen	Love u Camilla
Itzel Palacios	TE AMO BEBÃ‰ AMÃ‰ CONOCERTE EN MONTERREY ERES UN AMORğŸ˜­ğŸ˜­ğŸ˜­ğŸ’–ğŸ’–ğŸ’–ğŸ’–ğŸ’–ğŸ’–ğŸ’–ğŸ’–ğŸ’–ğŸ’–âœ¨
Bellis B	Viva MÃ©xico ahuevo ğŸ‡²ğŸ‡½ğŸ‡²ğŸ‡½â¤â¤ğŸ‘‘
Caesar Peralta	Beautiful woman
Claudia Ruiz Cuenca	Pero porque eres tan guapa???Dime tu trucoâ¤ï¸â¤ï¸â¤ï¸â¤ï¸ğŸ˜ğŸ˜ğŸ˜ğŸ˜
shaila Barron	WEY YO ESTUVE AHI
Marylin Armijos	estÃ¡s muy hermosa
Fernandez Bleidy	Viva MÃ©xico ğŸ‡²ğŸ‡½ğŸ‡²ğŸ‡½ğŸ‘‘
Rose Markez	10:52
Ieva MajauskytÄ—	*I love you Camila â¤ï¸*
Nayeli Adunas	Es ver esto y sentir zozobra porque de aquÃ­ a que venga otra vez a MÃ©xico ğŸ˜­ğŸ’”. Pero aun asÃ­, quÃ© bonito todo lo mostrado, quÃ© orgullo ella y nuestro paÃ­s ğŸ‡²ğŸ‡½â¤
Hugo Xiim	Ahora espero el ft con Noel y Jesse y Joy con buen audio :)
Aylin GonzÃ¡lez	27-09-18 ğŸ™ğŸ»ğŸ’ƒğŸ»â˜ºï¸ MÃ©xico loves u baby...
Kitty	*I was carving a pumpkin so I missed the notification.*
LP MUSIC	Im high by watching this
MysticGal91	Camila is the fiercest woman with talent. She is a amazing singer.
Steffi BÃ¤umer	I Love you Baby so proud of youâ¤ï¸â¤ï¸â¤ï¸
Elena Merlo	Me encata como dice *VIVA MEXICO CABRONES* Like si a ti tambien
ã‚ã ã¾ã‚„ã	â¤ï¸
Lizbeth J	VIVA MÃ‰XICO CABRONES ğŸ‡²ğŸ‡½â¤ğŸ‡²ğŸ‡½â¤
Mon GarcÃ­a	Eres Ãºnica Camila, aun con todo el cansancio, enferma y todo lo pasado detrÃ¡s, siempre diste lo mejor de ti en cada show, para que cada una de las personas presentes en cada noche se la pasaran de lo mejor y les hicieras olvidar por unos momentos sus problemas. Vas a ser grande Camila, no como otros artistas, como tu Como Camila Cabello orgullosamente latina, aunque de repente se te sale lo SpanglishğŸ˜†, el idioma no te define, te define la cultura de tus padres, tu familia, los valores que solo los latinos entendemos y valoramos mÃ¡s que nada en el mando.  #EnLasBuenas #EnLasMalas siempre a tu lado â¤ğŸ‘£ğŸ’
AddyGabby Gamez	I love you SO SO SO SO SO MUCHHHH!! Thank you for being an phenomenal role model and inspiring me and others! I'm so happy and proud of/for you! Continue to shine your light on the world!
Hoseok Jauregui	Mientras vivÃ­a este momento en el #NBTStourGDL no puede evitar recodar la estrevista que tuviste hace 3 aÃ±os, que tu mÃ¡s grande sueÃ±o era cantar con tu papÃ¡ en MÃ©xico una canciÃ³n Mexicana fui ahÃ­ donde mÃ¡s se me salieron las lagrimas pero fueron lÃ¡grimas de felicidad al ver que por fin lo habÃ­as logrado y yo estaba ahÃ­ para verlo. @camila_cabello estoy muy orgullosa de ti, de lo que has logrado. NUNCA me voy a arrepentir de tenerte como idola â¤ï¸ y te seguire en tus prÃ³ximas aventuras. Te amo Camila eres mi Cubana-Mexicana Favorita VIVA MÃ‰XICO CABRONES!!! ğŸ‡²ğŸ‡½âœ¨
libra scar	AwwwwwwğŸ˜ğŸ˜ğŸ˜ğŸ˜ğŸ˜ğŸ˜ tan tierna siempree ğŸ’‹ğŸ’‹
maria claudia Vargas	Te amo Camila â¤ï¸â¤ï¸â¤ï¸
Claudia Valeria GutiÃ©rrez	Camii te faltÃ³ venir a Puebla MÃ©xicoğŸ˜¢ğŸ˜¢ğŸ˜¢no te pude conocer. OjalÃ¡ un dÃ­a puedas venir a Puebla
Diego RodrÃ­guez	EstÃ¡ en inglÃ©s ğŸ˜‘
Paulina Diaz	Is no one talking about 10:49 ? ğŸ˜‚
Amnesia	Holi
enigma ruiiz	Regresa pronto a MÃ©xicoğŸ˜ğŸ˜ŠğŸ’•
karla Glez	Por quÃ© me haces esto? Ya no querÃ­a llorar ğŸ˜­*ahora se pone a mirar de nuevo los vÃ­deos que grabÃ³ del concierto*
infinitestar infiniteyblackops	ğŸ˜­ğŸ˜­ğŸ˜­ğŸ˜¢ğŸ˜¢ğŸ˜¢ am so happy for youğŸ˜ğŸ˜ğŸ˜ğŸ˜
aneiby d	Mexico ğŸ‡²ğŸ‡½
Dulce Maria Victoria Becerril	Eres la mejor Camila, me uviera gustado conocerte en persona pero no pude ir, aunque no fui se que a sido una  increÃ­ble experiencia para los q si fueron.ğŸ˜
Misty FT	Viva MÃ©xico cabrones!!! >:D
Wendy Marisol Hernandez Garcia	Amor cantaste hermoso en Monterrey ğŸ˜â¤ï¸ Ya te extraÃ±amos mucho ğŸ˜°ğŸ’” vuelve por favor:( â¤ï¸ Te amo Camila ğŸ’• Mi bananita ğŸ˜â¤ï¸
alejandra guerra	Lo mÃ¡s hermoso es verme ahÃ­ ğŸ˜ tan enfrente, tan cerca de ella ğŸ˜ğŸ˜­â¤ï¸â¤ï¸
Rbd Lomas	arÃ¡s de los otros paises tambiÃ©n, me muero si sales bailando tango ğŸ’–ğŸ˜ğŸ”¥â­âœ¨ğŸŒŸ
mahreen asad	Ahhhh I luv you sooo damn much.. ğŸ’–ğŸ’–ğŸ’–ğŸ’–ğŸ’–ğŸ’–ğŸ’–ğŸ’–ğŸ’–ğŸ’–ğŸ’–ğŸ’–
Carmen Garcia	Yo no pude ir ğŸ’”ğŸ˜­ğŸ˜­ğŸ˜­
Camila and Dami can chocke me	The love I have for this tiny brunette ugh
Emilia Naranjo	te amo tanto â¤ï¸
Melody	Camila da seÃ±ales que viste que en el hotel de Monterrey te llevamos mariachi â™¡
Oreo Lover	Go Mexico Cabrones! ğŸ˜ğŸ‡²ğŸ‡½ğŸ‡²ğŸ‡½ğŸ‡²ğŸ‡½ my dad grew up in Mexico too but I didnâ€™t but I can b so Mexican sometimes lol.
Romelie Sareno	I can't wait for the next tour with the 2nd album..  I'm praying for the "CAMILA IN GRAMMY" ğŸ™ğŸ™ğŸ™
Laurencio CÃ³rdova Martinez	Flaca de dÃ³nde don Alejandro  jajajaj
Angeles Carrasco	te amooooooo
Vero V	No puedo creer que soy una de esas manchitas, tus canciones en vivo son arte, la vibra, lo disfrutÃ© a morir
Hxran	Yo estuve ahÃ­ ğŸ˜­â¤ Fue el mejor dÃ­a de mi vida, y estuvo hermoso!!! Te amo mucho Camila â¤
Kimberly Areysi	:') â¤ï¸ğŸ‡²ğŸ‡½
clara live	Me encata camila cabello. Viva MÃ©xico cabrones.  DE Miami a MÃ©xico estÃ¡ cosa se prendiÃ³ baby. I love youğŸ–¤ğŸŒ·
Melanie Medina	Te amo boluda ğŸ’—
Pari Tripathi	My heart melted, like awww! â¤ï¸
JoMaSa	3:32 Thatâ€™s beyond BEAUTIFUL To share that stage with your DAD â¤ï¸  Tan Linda Camila ğŸ’¯ #ImTearingUP
Valentina Hemmings	AYYY AMO TANTO A MI BEBÃ‰EEEğŸ’
Tania Puc	Mi suegro siempre rifandosela. â¤
Emily Motse	ğŸ˜ğŸ˜ğŸ˜ğŸ˜ğŸ˜
WM	OjalÃ¡ puedas venir a centroamerica
Alana Berejanski	AQUI Ã‰ BRASIIIIIIIIIIIIIL
Ximena Jauregui	Voy a darle me gusta, pero me ofende muchÃ­simo que hayas cambiado la letra de "Inside Out" para cada paÃ­s
Novia de Shawn Mendes	En el momento que comenzÃ³ somenthing gotta give fue imposible que no me salieran algunas lÃ¡grimas jajaj:(â¤ï¸
Consuelo Tapia	ğŸ˜­ğŸ˜­
Nancy Flores	HERMOSAAAA â£ï¸ TE AMOOOOOO!
Karen	NO PUEDES VERME PERO ESTOY LLORANDO
Abigail Moreno	MÃ¨xico te ama mucho flaca, we miss u
vermelhinho lindo	Brasil love you ğŸ’•ğŸ’•ğŸ’•ğŸ’•ğŸ˜
Maria pon	I Love You ğŸ˜â¤â¤ ğŸ‡¦ğŸ‡·
COPS- KUZEY	Lol you legend
Dhiego Rocha	Gostosa queremos Brasil meu amor
Sarai De Paz	I love you so much mija I'm half of Mexican ğŸ‡®ğŸ‡¹ and half of Salvadorian ğŸ‡¸ğŸ‡» I'm so proud of u girl ğŸ˜ğŸ˜ğŸ˜
Mais Uma Perdida No Mundo	Tio Ale Ã© mÃ³ cantor, ele e a Camz deveriam fazer uma dupla sertaneja ğŸ˜‚ğŸ˜‚ğŸ’™
HOMER H.-SMITH	I LOVE YOUR MUSIC SOO MUCH XOXO
Thilida Matos	I loveeeeeeee youuu
Fernando Navarro	EL MÃS CHINGÃ“N ğŸ‡²ğŸ‡½
PrevisÃ£o De Tudo	First
Gaston Romero	AAAAAAAAH LA AMO TANTO
MrCalifornia1234	Stay grounded with your family.
Jaziel lumbreras	Regresa pronto, te extraÃ±amos
Diamond 487	Te amooo Camila ğŸ˜™ğŸ˜™ğŸ’›ğŸ’›
Mabel Amroliwala	Te amo Camila ğŸ’™
Sarah Mybe	jente alguem aqui fala portugues ?
CHANEL PATIÃ‘O	Â¡VIVA MÃ‰XICO CABRONES! ğŸ‡²ğŸ‡½
denisse benitez	No entendÃ­ ni verga pero me gustÃ³ el video
Karol Oviedo	Â¡Viva MÃ©xico Cabrones! ğŸ‡²ğŸ‡½ğŸŒ¯
Jenn â€¢ â€¢	Y Cuando vienes a perÃº  camilita ğŸ˜»
ElÃ©onore B	The idea of the meet and greet with roses is AMAZING ! Thanks so much for being who you are Camila, you're so caring for your fans and you're incredibly talented - you're a role model and your positivity is all I needed thanks so much ğŸ’›ğŸ’›ğŸ’›ğŸ’›ğŸ’›
Bety Reyes Macin	como hacerme llorar de nuevo, EL MEJOR DIA DE MI VIDA FUE ESE 24 DE SEPTIEMBRE, VIVA MEXICO CABRONEEEEEEES
C. M	MÃ©xico! MÃ©xico! MÃ©xico! ğŸ‡²ğŸ‡½ğŸ‡²ğŸ‡½ğŸ‡²ğŸ‡½ğŸ‡²ğŸ‡½
à¹à¸£à¹‰à¸§à¹à¸•à¹ˆà¹€à¸£à¸¢ à¹„à¸¡à¹ˆà¸•à¹‰à¸­à¸‡à¸šà¸­à¸	LOVE â¤ï¸
Ally #Camilizer.	Camz,Camz, Camz, camz,camz, camz!!!milaaaaaa!!! ğŸ˜ğŸ˜ğŸ˜ para cuando Colombia?  :,c ğŸ˜¢ğŸ˜¢ğŸ˜ğŸ’”
Abul Hasnat	Awwwww ğŸ˜ğŸ˜˜ğŸ¤ª  I loved this ALOT! ğŸ˜˜ğŸ˜˜ğŸ˜ğŸ’—ğŸ’–
soleejfifkj	Te amooo!â¤ğŸ˜ğŸ‡¨ğŸ‡±
Jos Pals	TE AMO MI MEXICANA FAVORITA ERES LA VERGA MIJAAAA, YA REGRESA PRONTO A MEXICO PARA QUE DISFRUTES DE ESTE HERMOSO PAÃS Y TAMBIÃ‰N DESPUÃ‰S CON MÃšSICA NUEVA  MÃ‰XICO TE AMA UN CHINGO ğŸ‡²ğŸ‡½ ğŸ‡²ğŸ‡½ğŸ‡²ğŸ‡½ğŸ‡²ğŸ‡½ğŸ‡²ğŸ‡½â¤ï¸â¤ï¸â¤ï¸â¤ï¸â¤ï¸â¤ï¸ğŸ‡²ğŸ‡½ğŸ‡²ğŸ‡½ğŸ‡²ğŸ‡½ğŸ‡²ğŸ‡½ğŸ‡²ğŸ‡½
Pablo Lpz	Te amo ğŸ˜ ğŸ˜â¤â¤
Yuliana SuÃ¡rez	Muy bello tan lindo lo mejor!ğŸ˜
Cristian LÃ³pez	Como siempre ğŸ™„ MÃ©xico ğŸ‡²ğŸ‡½ sobresaliendo de todo latinoamerica
America Garcia	Si MÃ©xico  ğŸ˜ğŸ˜ğŸ˜
luvthatbutera	i got chills im so proud of her
MarÃ­a Isabel HolguÃ­n GutiÃ©rrez	todo iba hermoso y perfecto hasta que saliÃ³ Mateo :)
RN86FJ	full circle for u and ur dad ğŸ˜­ğŸ˜­ğŸ˜ğŸ˜ so proud of u!!!
Dulce Ilescas	Hermosa
Sara Ruiz Cuenca	Pero...Camila?,por que?...eres tan guapa?ğŸ¤¤ğŸ˜â¤ğŸ˜˜ğŸ³ï¸â€ğŸŒˆğŸ‘‘
Margarita Dreamer	i adore and love this girl so much.. she is truly out of this worldğŸŒ¹
Jaidan Loran	Camila is so humble!! Thats on eof ny favorite qualities in her...because most celebs are just full of themselves and its hard to watch, but camila isnt like that! Thank GodğŸŒŒ
Rafaela Lima	â™¥â™¡â™¥â™¡â™¥
The_gymnast 11	I love you camilaaaaaaağŸ˜˜ğŸ˜˜ğŸ‘‘
mariana martinez fuentes	9:41 que suerte tienen algunos ğŸ˜¢
foxy 335	Segundo comentario #EspaÃ±a te queremos
Fernanda Santana	"Orgulloso de mi flaca". ğŸ˜¢â¤
ã€‹Tanyaã€Š	CamelaaaaaaaaağŸ˜»
Karla Ailen	Sos un sollll
Karla Murillo	Te amo Camila â¤
Violet Edits	This is so cute omg
Areli Drews	Jajajajajaja el final "AGUEVO"
Leslie Arana	LPM
jf ln	Veo este video despuÃ©s de comer tacos jaja
Sara y Atenas	Â¡HERMOSA MUJER!ğŸ˜ TE AMAMOS MACHIN.â¤ï¸ğŸ‡²ğŸ‡½
Neilson Soares	CadÃª a Tour Diary no Brasil dona Camila?
Antonia is gay af and ships Camren	We stan
Ranzu Mayangcha	I love you
lara Pereira	Good
more feminist	sos la mejor te amo espero el de Argentina ğŸ’™
hanna carolina	Esta siempre sera tu Casa!â¤â¤â¤â¤â¤â¤
Anto- Boom	We love you! âš¡âš¡âš¡
Marie Lozano	I love you Queenâ¤ğŸ‘‘
Luisa Wagner Reboredo Rodrigues	I'm your fan number 1 Te amo muito meia brasileira ğŸ‡§ğŸ‡·ğŸ’šğŸ‡§ğŸ‡·ğŸ’™ğŸ‡§ğŸ‡·ğŸ’›ğŸ‡§ğŸ‡·ğŸ’šğŸ‡§ğŸ‡·ğŸ’™ğŸ‡§ğŸ‡·ğŸ’›
Ryry & Chim	My wifeee!!!
Highway U	TE AMO
Loser_McGee	Must be nice to be close to your father like that
Maybelline RodrÃ­guez	OMG I'M CRIYING!!! TE AMO TANTO CAMILA, ERES MI TODO Y LA ÃšNICA QUE LE DA SENTIDO A MI VIDA. :')
Karla uwu	VIVA MÃ‰XICO CABRONEESSS
Camille Martins	2:01 olha o anjinho ali no canto de azul ğŸ˜â¤ğŸ˜â¤ğŸ˜â¤ğŸ˜â¤ğŸ˜â¤
Roomy M.	I canâ€™t believe I never stanned her in 5H ughhhh what a queen ğŸ˜­    also Iâ€™m a v small youtuber so if youâ€™d like pls check out my â€˜Consequencesâ€™ cover hehe cheeky plug.
Esme Ramos	TE AMO ğŸ’•
Louca por BTS	ğŸ˜ğŸ˜ğŸ˜ğŸ˜
Anel Perezmay Aparicio	Esta mujer hace que  estÃ© aun mÃ¡s orgullosa de ser Latina y Mexicanaâ™¡
Beck Deane	Iâ€™m Serious I Hate Being Irish But This Video Made Me Love My Own Culture Camila You Are So Amazing Iâ€™m Serious YOU ARE SO FREAKING WONDERFUL I CANT EVEN EXPLAIN IT
Andrea Raamirez	â¤
galaxy music	ka
Jose Delmar Toledo MontaÃ±o	ğŸ˜ğŸ˜ğŸ˜ğŸ˜CAMILA IS THE BEST!! â™¥
Dallasita :v	MÃ‰XICO TE AMA!! AHUEVO! â¤ï¸â¤ï¸â¤ï¸ğŸ‡²ğŸ‡½ğŸ‡²ğŸ‡½
Taiane Sousa	Camilaaaa faz um negÃ³cio desse do Brasil please ğŸ˜â¤â¤ğŸ‡§ğŸ‡·ğŸ‡§ğŸ‡·ğŸ‡§ğŸ‡·
Sousa Lima	Quero o do Brasiiiiiil!!! ğŸ’šğŸ’›
Anshee Devi	Wow
Maria_crosss	I don't know why Camila is so AMAZING. I really want she to have the BEST future... Like if you â¤ï¸ she!
Seesea Sy	Yas MijağŸ’–
KRipto Malik	Te amo CAMILA!!ğŸ˜ğŸ’
AlexaValenzu canela	Mexico te ama baby !!!â¤ï¸
erick martinez	Viva MÃ©xico cabrones.!!! â¤
Alberto Portilla	No soy muy fan de Mexico y su cultura, pero tengo que reconocer que esto se ve emocionante!
Shadday Zamarripa	Aguevooo!
Skyler Alchin	Someone tell Camila to turn her necklace around lol
Carolina Trinidad Mauro	Te amo muchÃ­simo!!! Agradezco poder coincidir contigo en esta vida ğŸ’•
jose gt	Pelease DVD o documental
DiAgron Latino	Best your diary, best concert eveeeeer!!! Mexico is the fucking best, viva MÃ©xico cabrones!!!
ISAÃ Olmos	ğŸ‡²ğŸ‡½ğŸ‡²ğŸ‡½ğŸ–¤
Sunshine Cortez	Rahul this is beautiful â¤ï¸
PPteamJesus Polinesio	No pude ir Camz :'(  Te amoooo, pero se acabaron los boletos! <3 Tâ¤ Teâ¤ Te aâ¤ Te amâ¤ Te amoâ¤ Te amo Câ¤ Te amo Caâ¤ Te amo Camâ¤ Te amo Camiâ¤ Te amo Camilâ¤ Te amo Camilaâ¤ Te amo Camilâ¤ Te amo Camiâ¤ Te amo Camiâ¤ Te amo Camâ¤ Te amo Caâ¤ Te amo Câ¤ Te amo â¤ Te amâ¤ Te aâ¤ Teâ¤ Tâ¤ Teâ¤ Te aâ¤ Te amâ¤ Te amoâ¤ Te amo Câ¤ Te amo Caâ¤ Te amo Camâ¤ Te amo Camiâ¤ Te amo Camilâ¤ Te amo Camilaâ¤ Te amo Camilâ¤ Te amo Camiâ¤ Te amo Camiâ¤ Te amo Camâ¤ Te amo Caâ¤ Te amo Câ¤ Te amo â¤ Te amâ¤ Te aâ¤ Teâ¤ Tâ¤ Teâ¤ Te aâ¤ Te amâ¤ Te amoâ¤ Te amo Câ¤ Te amo Caâ¤ Te amo Camâ¤ Te amo Camiâ¤ Te amo Camilâ¤ Te amo Camilaâ¤ Te amo Camilâ¤ Te amo Camiâ¤ Te amo Camiâ¤ Te amo Camâ¤ Te amo Caâ¤ Te amo Câ¤ Te amo â¤ Te amâ¤ Te aâ¤ Teâ¤ Tâ¤
Kim Grazyh 0015	I love you Camila â™¡..... you are beautiful â™¡
amo pugs	Eu amo demais esse serğŸ˜
artsysoull	SHE IS SOOOO CUTE
Sofi Ojeda	Camila la  youtuber jaja
Nay RF	Te amo! Gracias por permitirme vivir estÃ¡ inolvidable y magica experiencia â¤ MÃ©xico te ama y te esperamos pronto ğŸ‡²ğŸ‡½
KSI HAS A FUCKEN GAY ASS 101	Camila Brasil loves u and Iâ€™m American and but Brasil loves u
Angel Torres Padilla	Es lo mejor
Ana Luiza Santos	Brasil?!
Ğ²Î±cĞº Ñ‚Ïƒ Ñ•Ğ½Î±Ï‰Ğ¼Î¹Î¹Î±	so proud... te amo!
Ø§Ù†Ø§ Ø§Ù„Ø´ÙØª	I love you!!!
Emcrazy _	Why do I wanna meet Camila more than ever right now?
Ison Moh'ed	"CAMILA CAMILA CAMILA" THAT PROVES THERE WHERE SOME ONE FOR U ON SOME WHERE
Isaiah Perez	I'm not able to go to any of her shows or meet and greets cause my parents don't have the money for it or can't make it but I love Camilla so much that she helps me get through a lot and recently my grandpa passed away and her music and just her in general help get through it all and I love her so so much for that
Valentina Galindo	PERO MRK PRODUCE Y VEN A COLOMBIA
Fatima Meza	te amo
Henry Maita	Vente a peru
PORK_NÃƒO/PARÃ“DIA	I love camilla
Cabeyo Beanz	Quero o do Brasil logo
Anastasia Vasquez	Camila es cubana y mexicana perfectaağŸ˜ Vive MÃ©xico!! ğŸ‡²ğŸ‡½
Ariana Grande	Camila Cabello ğŸ˜˜ğŸ˜
Maria Fernanda BaÃ±uelos Chavez	Te amo tanto y viva MÃ©xico cabrones ğŸ‡²ğŸ‡½
Brenda Guzman	TE AMOOO AHUEVOOOğŸ˜ğŸ˜­â¤
Jeremy Carrero	1123 comentarios
A N A Bangtan.	*Te amo!â¤*  *_#MÃ©xico_*
Ashley Rosero	DeberÃ­an venir a Ecuador ğŸ’”
zoe	te amoooo
Angelly Mosquera	ğŸ˜ğŸ˜ğŸ˜ğŸ˜ğŸ˜ğŸ˜ğŸ˜Camila hermosa, diosa adorada ven por favor, por favor a ColombiağŸ‡¨ğŸ‡´ğŸ‡¨ğŸ‡´ğŸ‡¨ğŸ‡´ğŸ‡¨ğŸ‡´ğŸ‡¨ğŸ‡´ğŸ‡¨ğŸ‡´ğŸ‡¨ğŸ‡´ğŸ‡¨ğŸ‡´ğŸ‡¨ğŸ‡´ğŸ‡¨ğŸ‡´
Chesther Phoenix	Te amoâ¤ asi como a mi MÃ©xico queridoğŸ˜
No seas amargado	YAAASS QUEEN!!! TE AMOOOO
Fernanda Amaro	Estoy enamorada ğŸ˜ğŸ˜ğŸ˜ğŸ˜ğŸ˜ğŸ’•ğŸ’•
Andrea S	â¤â¤â¤â¤â¤â¤â¤â¤
The Unnamed Band	7:16 omg I cried â¤ï¸â¤ï¸â¤ï¸ğŸ˜­ğŸ˜­ğŸ˜­
luchi fontana	ARGENTINA PA CUANDO?
Mercedes Rhino	Sooo cuteâ¤ï¸â¤ï¸ğŸ˜‚â¤ï¸â¤ï¸â¤ï¸ğŸ˜‚ğŸ˜ğŸ˜ğŸ˜
Estefany Fernanda Mayer	Te quiero muchoğŸ’œğŸ‡²ğŸ‡½
Angela JimÃ©nez	Fue una gran alegria estar en un concierto tuyo! Fue increible, llore de la emocion, el mejor dia de mi vida.â™¡ VIVA MEXICO CABRONEEEES!
Vanessa Hernandez	Love it! Que viva Mexico!ğŸ’™ğŸ‡®ğŸ‡¹
dxnygtz25	Thank you for the most incredible night of my life! I will never forget that day! I love you with all my heart and i thank you for coming! You are always welcome to come! Thank you thank you. TE AMO MIJAAAAA ğŸ˜
Jessie Urgell	Viva MÃ©xico Cabrones!!!ğŸ‡²ğŸ‡½
Debora Salguero	Camila CabelloğŸ˜ğŸ˜¢ğŸ˜¢â¤
isabel perez v.	TE AMO ğŸ˜ğŸ˜ pero amo mÃ¡s que hables spanish ğŸ˜‚ğŸ˜
sebas sanches	chile te ama camila muestranos cuando estuviste aqui <3
Wefa	I AM SO PROUD OF YOU ğŸ˜­ğŸ˜­
Leon Pont	Consequences in sao paolo was just... magical
Andrea Domingo	La mejor maldita noche de mi vida
Inah Ayu	Love you Camilaâ¤ï¸
Mafer Soberanis C.	I LOVE YOU ğŸ‡¬ğŸ‡¹
unicornbecerra	TE AMO
Chisi Amanda Xiong	Come to Seattle WASHINGTON please xoxo
Beatriz Oliveira	you are amazing!!Love you!!
lisa	I'm prying
Melka Maria	Viva la fada cubana mexicana secretamente brasileira te amamos Camilita â¤â¤ğŸ‡§ğŸ‡·
RocÃ­o ColÃ¡n	Camila cuando PerÃº? ?
sofia Carla Barionuevo	ARGENTINA NEXT
ØªÙ‚Ù†ÙŠØ© Ø¹Ø±Ø¨ÙŠØ© 4 YOU	Ù‡Ù„ Ù‡Ù†Ø§ Ù…Ù† Ø¹Ø±Ø¨ÙŠ
Lia Rodriguez	Hermosa!
patricia solorio diaz	Gracias por regalarnos tu amor y tÃº pasiÃ³n, me alegra haber vivido uno de tus mejores shows
Paulina Saavedra	TE AMOOOâ¤ï¸â¤ï¸
Macy	Yaaaaassss
Alishba Ali	So beautiful to see you and your daddy so happyâ¤ I love you CamilağŸ˜—ğŸ˜—
Danna Sierra	No entendÃ­ nada pero igualmente me encanto cabrones!
Mellow Peace	Te amo, aÃºn sigo con la depresiÃ³n post concierto ğŸ˜­ğŸ˜­
Sandra Elesbao	Camila cabello  linda maravilhosa espetacular fabulosa
lus ;	babeeeğŸ’ğŸŒ¹
Dani Loves	ğŸ‘‘ğŸ‘‘ğŸ‘‘âœ¨â¤ï¸
Elizabeth PenaMaslow	This is a gorgeous video!!!! Camilla is so cute and such an amazing and inspirational artist! If ya'll have been sleepin' on Camilla, then wake the F up because she's so FREAKING talented with the way she sings and the way she writes her music! She really has grown as a solo artist since 5H and even when she was in 5H, it really showed to me that Camilla is different than other artists....She's an artist that is not afraid of letting go and doing things that she loves doing which is performing. I've been a Camilla fan since 5H Reflection and I've never looked back since!!!!! WE LOVE YOU CAMILLA!!!! Also, (don't tell her) but she and I may be the same age as each other which is incredible to hear! I love it! OH and the same shoe size & height too....I'm FANGIRLING SO HARD! :D-Elizabeth <3    Camilla, Follow me please? Twitter & Instagram @LizzyMaslow_  My other instagrams: @ElizabethMaslowoods & @TeamMaslow_
Ø§Ø±ÙŠØ§Ù… 305	ÙÙŠ Ø¹Ø±Ø¨ ğŸ‘ğŸ¼ğŸ‘ğŸ¼
Omar Os	Eres mi espiraciÃ³n.  Camila cabello te quiero mucho   OjalÃ¡ un dÃ­a te pueda conocerte te quiero desde mexico
Lizeth Torres Silva	Lptm te amooo
Krish Mistry	Who loves Camilla Cabello? Me!
Trinity Brierley	I love her so much Iâ€™m British and I feel Mexican rn ğŸ˜‚ğŸ˜‚
Anali Cascada	Camila vine directamente de instagram @soy_ana_valdez ven a santo Domingo en la futura girağŸ™ğŸ¼ğŸ‡©ğŸ‡´ğŸ¶ğŸ¶ğŸ¶ğŸ¶ğŸ¶ğŸ’‹
zaira 888888i8i	Te Amo!
Tano GÃ³mez	CÃ³mo me encanta que aceptes tu raÃ­ces mexicanas y te sientas orgullosa de dÃ³nde eres gracias por todo Camila te amamos en MÃ©xico demasiado â¤ğŸ˜ğŸ‡²ğŸ‡½
Pietra Lavigne	ğŸ˜ğŸ˜ğŸ˜â¤â™¥â™¡
catalina aguayo	What about chile, arg and brasil?? :))
Dominiq Mercado	Colombia colombia!!!
bhoomi Ramgoolam	Ouuh
Ana Drumond	te amo meu amoooor
Ana Paula Pereira Lopes	Camila, volta pro Brasil aqui tem brigadeiro ğŸ˜„ğŸ˜
Cristiano bonifacio	I Love You Camila...
BruBru 007	te amo minha fada <3
MoisÃ©s Loaiza	TE AMO ğŸ˜ğŸ˜ğŸ‡²ğŸ‡½
Karen Soto	TE ADOROOOO. VIVA MÃ‰XICO CABRONES!!!!!
Nelly Esperanza Yong Bonilla	Camila te amo, eres una gran inspiraciÃ³n para mi admiro todo lo que haces como Artista y como representas a los Mexicanos y cubanos y a la comunidad latina en general con tanto orgullo!! Espero algÃºn DÃ­a llegar a ser como tu gracias por inspirarme cada dÃ­a !! I love u so much
MCPE Guy	#CamilizersğŸ’ƒ
sweetie heart	te amo, estoy demasiado orgullosa de ti
Taehyung With A Bandana â€¢	*TE AMOO* ğŸ’
Andzel PeÃ±a	TE AMO TANTO
FAN DE DUA LIPA ARIANA GARCIA	Te amo bb
Arbey Castillo	Gracias por esto mi vidaâ¤ğŸ˜­ esto es demasiado hermoso, te amo tantoâ¤â¤ğŸ˜­ğŸ˜­
Guadalupe Galvez	No entendÃ­ pero te amo ğŸ˜¢ğŸ˜
Pau Stylinson	Â¡Te amo! ğŸ’•
Yo Soy Wiss	Regresaaaaaaaaaaaaaaaaaaaaa
Indira Reyes	Te Amo Milaâ™¥â™¥â™¥ğŸŒ¹ - Ojala algun dia vengas a EcuadorğŸ’›âœ¨
Its Stich3s MSP	2018 ? ğŸ˜‚ğŸ˜‚
RJM_94	I love you Camila
Roblox zamani	Camila love you :3
Cyra `	_We_ ```are``` /really/ *proud* of *YOU* ğŸ˜
bruna luiza	i love an angel in person
Ana Morales	Te Amo mi camillaâ¤
Yulz Banana	Estoy llorando:(
Cristina Reis	Wow amazing âœ¨ğŸ˜ğŸ˜this video make me emotional ğŸ¤—Camila is beautiful she have a good heart â¤ï¸ she sweetie and cutie ğŸ˜âœ¨âœ¨I wish one day I get rose ğŸŒ¹ Camila pick me ğŸ™ğŸ™â˜ºï¸ğŸ˜˜ğŸ˜˜ğŸ˜˜ te amo te amo muito âœ¨âœ¨âœ¨
J Bel	SOY TAN FELIZ DEE HABERTE IDO A VER CUANDO VENISTE CAMILITA. TE AMOOOOO â¤ï¸ğŸ‡²ğŸ‡½
cosas de risa y musica	Si lo ases a MÃ©xico habla en espaÃ±ol , te amoooo
raven9 .lovesCC	Gracias por darme una de las mejores noches de mi vida, Camila. MÃ©xico espera tu regreso con ansias, te amo un chingo cabrona!!! ğŸ‡²ğŸ‡½â¤
MarÃ­a Daniela AvendaÃ±o Rosales	Cuando estas enamorada de camila y del video, la caga el tal Matt
BELGA SANCHEZ	Music is love and magic .viva mexico.God
Laura Moreno	Todo bien hasta que vi a Matthew ğŸ™„ ahre JAJA
Alina Letras	eu adoro voce camila
jared santos da Silva	Amor, eres perfecta ğŸ˜‰ quiÃ©n piensa lo mismo ğŸ™‹
KakiLyrics	Estoy mÃ¡s que segura que tu famila tienen sus corazones llenos de orgullo por todo lo que has logrado... Te amo Camila â¤ï¸
JosuÃ© Azarel Sotelo Cepeda	Ahuevo ğŸ’•
rulenumber1	Havana oh na na na
Santino Salvato	Me tenes loco de amor camilaaa ğŸ˜­ğŸ˜
Abi Good tastes	Eres la mÃ¡s chingona, contigo hasta el fin del mundo. âœ¨ğŸ‡²ğŸ‡½
Aylen Tazzo	DE MIAMI A MÃ‰XICO, ESTA COSA SE PRENDIÃ“ ğŸ”¥
Jamile Victoria	Te amoo â¤
Maria Serrano	Your team recorded me saying something for you. I was the girl with the flowers crown. Mila, te amamoooos en MÃ©xico!
Anet Noriega	Diiooos ğŸ˜­ğŸ˜­ğŸ˜­ğŸ˜­
Nini Burger	Wow
Karolline Carreiro	Iâ€™m crying! I love you so much! â¤ï¸ Have been 16 days since I hugged you and I already miss you so muchhh
Ruchi Barfal	Camila.â¤ï¸â¤ï¸â¤ï¸â¤ï¸â¤ï¸
Edriane Santos	WoahğŸ˜ğŸ˜˜
11O1	te amo demasiado, vuelve pronto
Naohmi GÃ³mez	Te amo â¤ no olvidarÃ© ese dÃ­a nuncağŸ˜­ğŸ’•ğŸ’•
Magda Knaack	Adoro a camila cabello
Isabel Aranda	Camila you are my queen and I just wanna say is hi and please come to New Jersey please and my dad works on a great restaurant and someday you can come and visit and preform one of your songs and my dads restaurant name is Aji Limon itâ€™s a great restaurant and it has a lot of food and I have been a fan of you for one year and my mom loves you so much and your band too and donâ€™t forget to be strong and always be and again I love you so much Camila â¤ï¸â¤ï¸â¤ï¸â¤ï¸â¤ï¸â¤ï¸â¤ï¸â¤ï¸â¤ï¸â¤ï¸ - Isabel
TOTTERYPI 98	My amorğŸ˜™ğŸ˜™
Ana Sofia RevÃ©s	I need you to come to Portugal!!!! Love you and I am really proud of you <3 <3
The One R	AHHH TE AMOOOO
Jim RamÃ­rez. RamÃ­rez	Veni a Costa Rica plis
tyt	AAAAAA camila te amo
MIA'S TOY SHOW!	Oh funny I'm American half Mexican.I'm only 8 years old.
Rebeca arias	Hola me encantan tus canciones
Brenda Reyes	â¤ï¸â¤ï¸â¤ï¸ğŸ‘¸ğŸ»
Gerson LÃ³pez	Havana ho nana  I loveğŸ’šğŸ’šğŸ’š
MyLilLol World	YASS CAMILA
Livia Pinheiro	Eu te amo muito !!!
Angelica Medina	_TE AMO_MexicoğŸ˜ğŸ˜˜
d d	Esperando o diÃ¡rio do Brasil!ğŸ¤—
Nicole Xavier	Esperando o do Brasil, bjs
wiliany freitas pego	Topppp
Jackeline S	I love your voice and your personality!!! xoxo ğŸ˜€ğŸ™ƒâ¤ï¸â¤ï¸
Laura S.	You're my new fav singerğŸ˜ğŸ’œ luv uu camiğŸ’œğŸ’œğŸ’œ
KARAR KARAR	I love you so much â™¡â™¡â™¡â™¡
Kim Taehyung	No pude ir pero aÃºn asÃ­ me encanta cada show quÃ© haces le pones mucho esfuerzo siempre lo haces con el corazÃ³n ğŸ’–ğŸ‡²ğŸ‡½
Estrella GarcÃ­a	LlorÃ© jajaja me da mucho sentimiento que no haya podido conocerte pero a la vez estoy muy feliz porque te vi y estuve viÃ©ndote cumplir tu sueÃ±o de cantar con tu papÃ¡ mientras yo cumplÃ­a el mÃ­o viÃ©ndote cantar, te amo muchÃ­simo y me inspiras demasiado a seguir luchando mis sueÃ±os, por favor regresa pronto a MÃ©xico, ya te extraÃ±amos y tÃº tambiÃ©n nos extraÃ±as ğŸ‡²ğŸ‡½â™¥ï¸
Joceline Gutierrez	Like si eres de MÃ©xico y Amas A Camila!ğŸ˜Šâ¤ğŸ˜
Eu ;-;	DONA DO BRASIIIL!DONA DO MUNDOOOOO!â¤â¤â¤â¤ GOSTOSAAAAAAA
maya naik	*Camilla lovers show some support*  *hit likes fast*
Lediane Aparecida	Te amoooâ¤ï¸â¤ï¸ğŸ‡§ğŸ‡·
Yazmin Naranjo Naranjo	You are the best person in the world!!!! He dicho!!!  I love you!!!! Muaks!!! ;)
Andrea B	Te amo con todo mi corazÃ³n ğŸ˜­ğŸ‡²ğŸ‡½ğŸ’•
yerlys cortes	Que hermoso todo ğŸ˜ğŸ˜ğŸ˜ğŸ˜ğŸ˜­ğŸ˜­ğŸ˜­ğŸ˜­ğŸ˜­ QUE orgullo por tu paÃ­s, tu familia, te amo mucho â™¥ï¸â™¥ï¸â™¥ï¸â™¥ï¸ Eres la mejor, eres un . Gran ejemplo para tus fans
maria clara Andrade	Gente eu amo essa linda d+â¤ï¸
FERSTARK	I love you so much and i am so proud  of you â¤ï¸â¤ï¸
Adriano Nobre	Amo essa mulher ğŸ˜â¤
Mar	Si era de MÃ©xico por quÃ© no hablaste en espaÃ±ol?
Barry Allen	olÃ¡ DÃ¡vylla Kassia que eu sei que tÃ¡ lendo esse comentÃ¡rio
Cookie Lover	Who else loves Camila Cabello? ğŸ˜
MÃ©lody 63	Camila Cabello you are perfect ! ğŸ˜¢ğŸ˜˜ğŸ˜â¤ I love you ! TÃº y tu padre... Hay una conexion magnifica !!!
Olivia Rodriguez	Lovely...ğŸ˜
AL 16	I I L I LO I LOV  I LOVE I LOVE C I LOVE CA I LOVE CAM I LOVE CAMI  I LOVE CAMIL  I LOVE CAMILA  I LOVE CAMILA' I LOVE CAMILA'S  I LOVE CAMILA'S M I LOVE CAMILA'S MU  I LOVE CAMILA'S MUS  I LOVE CAMILA'S MUSI  I LOVE CAMILA'S MUSIC I LOVE CAMILA'S MUSI I LOVE CAMILA'S MUS  I LOVE CAMILA'S MU  I LOVE CAMILA'S M I LOVE CAMILA'S I LOVE CAMILA'  I LOVE CAMILA  I LOVE CAMIL I LOVE CAMI  I LOVE CAM I LOVE CA  I LOVE C I LOVE I LOV I LO I L I
TeamBreezy X	LOVE YOU CAMILA!!â¤
Nats	Ni por tratarse el video de MÃ©xico hablas en espaÃ±ol, puro open english:( La yo no sabe que dices Te amo jajaâ¤ï¸
Nalle H	Te amo!!!!!â¤ï¸â¤ï¸â¤ï¸
katia Guerrero	Que generosa Camila, te amo â¤ï¸â¤ï¸â¤ï¸â¤ï¸â¤ï¸ Saludos desde Estados Unidos,(aunque que irÃ³nico que no pude estar en mi paÃ­s, mi CDMX para ver tu concierto; soy de ahÃ­ pero estoy en E.U estudiando) Espere toda mi secundaria para llegarÃ¡s a MÃ©xico, pero ya que entre a la preps en gringolandia me lo perdÃ­ ğŸ˜“ -Saludos de una mexicana ğŸ‡²ğŸ‡½desde MaineğŸ‡ºğŸ‡¸
Yo Carina	VIVA MÃ‰XICO, NO PUEDO CREER QUE FUI PARTE DE ESTE TOUR! INCREÃBLE!!#NBTSTOUR
Trouxa por 5h	JÃ¡ estou sentindo falta da NBTS Tour
Ashly Cadena	Te amo mi amor
Larryisreal	TE AMO TANTO MI AMOR
Cristy Flores	Mi princesa ğŸ˜ğŸ˜ğŸ˜
Fernanda Valdez	I'm so proud of you â¤ï¸   El never be the same tour fue lo mejor
Neymar Jr Number 1	Camila Cabelloâ¤
althea jahan aguilar	te amoooooooooooooooooooooooooooooooooooooooooooooooooooooooooooooooooooooooooooooooo
itzayana albohe	Ay La amo
Pricilia de Assis	SÃ“ SEI SENTIR MUITO AMOR E MUITO ORGULHO DESSE ANJO. ğŸ˜»ğŸ˜»ğŸ’œğŸ‡§ğŸ‡·ğŸ‡§ğŸ‡· #TeAmoCamz
Karly Coniet	I'm so so proud of you and the path you been chasing since 5 or 6 years ago and how you grow each year.... that concert was the best one in my entire life. was really special and fun and breathtaking. for many more
fer quintana	NUNCA OLVIDES QUE EN MÃ‰XICO ESTAMOS ORGULLOSOS DE TENERTE, TE AMO â™¥ï¸
gÃ©nesis MembreÃ±o	Como Siempre Luciendose Mi Camilita !!!! ğŸ˜ğŸ˜ğŸ˜ğŸ˜ğŸ˜œğŸ˜µ
Isael Santos	Is we brazil kkkkk
Rafaela Perminioo	Eu amo uma pessoa ğŸ˜ğŸ’›
Luiza Galliani Da Silva	Camila minha fada cubana, te queremos no Brasil novamente. ğŸ’œğŸ’œ Para vocÃª comer mais brigadeiro ğŸ˜‚ğŸ˜‚ğŸ’œ
à¸™à¹‰à¸­à¸¢ à¸«à¸™à¹ˆà¸²	à¸Šà¸­à¸šà¹†ğŸ’“
Jonetta Grace	#early love the video
DamiÃ¡n Mozqueda	Mexico loves you ğŸ’š
FrANciS Martinez	No soy mexicana,pero con este video me dieron un orgullo tremendo
Cami Gomez	COLOMBIA LOVES U CAMILA! come hereeeeeeeeeeeeeeeeeeeeeeeeeeeee
Patos En la Luna	Siempre divah ğŸ˜
Milena Barroso	EU TE AMO â¤ï¸
LizzieXwolf L	Yay Iâ€™m early finally
Mafalda Faria	ğŸ‡µğŸ‡¹ğŸ˜ğŸ’•ğŸ’•ğŸ’•
Luisa Cruz	Camila, MÃ©xico es tuyo y tÃº eres parte de el donde quiera que sea que vayas o vivas...porquÃ© ese sentimiento de pertenencia a esta tierra, nos trae siempre de regreso. Y eso los que somos mexicanos y hemos vivido fuera lo sabemos. A HUEVO!!!! ğŸ™Œâ¤ï¸ğŸ‡²ğŸ‡½ğŸ‡²ğŸ‡½ğŸ˜­ğŸ˜­ğŸ˜­
YULIANA TORDECILLA HERNANDEZ	QuÃ© hermosa,  ojalÃ¡ vengas algun dia a COLOMBIA,  te amamos!
Maria Hallasi	CAMILAAAA ! Espero que pra tu segundo tour vengas a PerÃº y pueda ser parte de la hermosa experiencia que creas <3
Clarissa Ortega	Eres increÃ­ble ğŸ˜ğŸ˜ğŸ˜ te amo ğŸ’–
Camz Rojas	gracias por brindarnos una experiencia inolvidable, !VIVA MÃ‰XICOÂ¡  te amamos y te estaremos esperando el prÃ³ximo aÃ±o <3
Fernando Ledesma	Vas a venir a Argentina? :3
IZAAC DRAWSSS	Rainha camila.  Quem  acha o msm curt
sad sad	te extraÃ±o ğŸ‡¦ğŸ‡·ğŸ‡¦ğŸ‡·
Jakelin Torres	Te amo, sin duda eres un Ã¡ngel. â¤ï¸ğŸ‡²ğŸ‡½
Lizbeth Alvarez	Te amo camilağŸ˜
Power in Havana	Next one: Camila Cabello's diary of winning a Grammy 2018âœ¨
Richar romero  chumbes	eres  lo maximo  exitos camil.
YourFan	Cutest baby
Elisa Reyes	MÃ¡s Mexicana que otros  , Te amamos Cami ğŸ˜ VIVA MÃ‰XICO CABRONES!
Guilherme Martins	O Brasil te amaaaaaa CamilaağŸ˜â¤
Karina Abigail	Esto es lo mas hermoso que mis oidos han visto :'v â¤â¤â¤
Ù…Ù‡Ø§Ø±Ø§Øª ÙƒØ±Ø© Ø§Ù„Ù‚Ø¯Ù…	camiliaâ¤â¤
Vanessa Truong	Omg ğŸ˜® listening to this its emotional ğŸ˜­ and listening what u have to say itâ€™s just... I really donâ€™t know anymore. we love you Camila thank you for everything that you did for us. P.s I love this dairy!!! â¤ï¸â¤ï¸â¤ï¸â¤ï¸
Stacey Soukup	Second
Melanie Perry	Hehehe camila
Douglas Hueender	Camila tem que colocar com legenda kkkk
Joana Moreno	TE QUIERO MUCHO SOY TU MAYOR FANâ¤ï¸
J.Margarita	I'm so proud of you loveğŸ’™ Espero a conocerte en persona pronto ğŸ’›
Aglaia Xasreti	Mexicoooo
JÃ©ssica Dantas	Te amo â¤ RainhağŸ‘‘
Yeye Ortiz	Llore no mms salgo ahÃ­ toda culera pero salgo
Boredbored Panda	love your music Camilla your so cuteğŸ’–ğŸ’–ğŸ’–ğŸ’–
Abigail Gaona	OMG, I LOVE YOU â¤ï¸ğŸ˜­
Sarah Alton	These are srsly the cutest things ever
im bored	ğŸ˜­ğŸ˜­
Geovanna Souza	Brasil te ama gostosaaaa
Lisete Rodriguez	Awuevo....!!!ğŸ™†â€â™€ï¸ğŸ™†â€â™€ï¸ğŸ’ªğŸ˜
Queenpez	I see camila i click!
Anna Laura Torres.	Amo, amo, amoooo.â¤â¤â¤
Leticia Silva	Te amoooâ¤
joo2004	Where is Portugal ://
Alexa Williams	PLEASE RELEASE THAT VERSION ON HAVANA OH MY GOD
Levente TÃ³th	Love from Hungary!:) ğŸ’—
Reem Hany	ğŸ’œğŸ’œğŸ‡ªğŸ‡¬Fans From EgyptğŸ’œğŸ’œğŸ‡ªğŸ‡¬
Alberto Cervantes.	I love you ğŸ‘‘ğŸ˜ğŸ˜˜ğŸ’˜ğŸ’–ğŸ”¥
Mariana Silva	TÃ£o linda! Te amo â¤ï¸
Luisana Torres	TE AMOOOOOO
Fernanda Fonseca	ğŸ˜ğŸ˜ğŸ˜ğŸ˜ğŸ˜
Lesly Ramirez	Es tan taaaaan taaaaaaan HERMOSAAAAAAA):â¤
Natalia Palacio Leonel	Te amo ğŸ˜
Sara Petrevska	Love you!!ğŸ˜˜ğŸ’œğŸ¤˜fromğŸ‡²ğŸ‡° like this commend if you new ğŸ‡²ğŸ‡° camila please go to ğŸ‡²ğŸ‡°ğŸ™ğŸ¼ğŸ¤™
Tsveti Angelova	She is so sweet
Miguel Molina	Tan orgulloso de haber estado ahÃ­ para ella â¤ gracias Camila por tanta entrega y por ser la mejor persona, espero vuelvas pronto MÃ©xico te ama! â¤ğŸŒ¹ğŸ’ƒ
lÎ¹Ï„Ï„lÎµ rÎ¿âµ¢Îµâµ¢	Te amoğŸ’•
Joselin Rosales	Yo esperaba esto en espaÃ±ol ğŸ˜
T h e m o o n & t h e s u n	TE AMOOO! ğŸ˜â¤
Emmanuel Aguilar Zamorano	Te amo infinitamenteğŸ’•
Camren Norminah	Te amo
Michy Torres	Ver cÃ³mo comes elote me enamora me pinches encantas Camila â¤ï¸ğŸ˜­ğŸ’“te amo que bonito haber estado ahÃ­ â¤ï¸
Ajop Nami	TE AMO MUCHO â¤
Linda Maj	ğŸ˜ğŸ˜ğŸ˜ğŸ˜
Viridiana JimÃ©nez	I love you so much...â™¥ï¸
JÃ¨ssica Maldonado	Â¡A Huevo!
Fernando VelÃ¡zquez	Like si estÃ¡s orgulloso de ser MexicanoğŸ‡²ğŸ‡½â¤
Megan !	I love how proud you are!!!!!!! Immigrants are so important because without them this world would be so basic. We are all important and we all have to come together and love each other
Aulin rahman	Hi cutie!love from Bangladesh..
Suadiz M.L	ğŸ˜ğŸ–¤
The DragonGiirl	Gracias por hacer este hermoso vÃ­deo!! ğŸŒ¹ğŸŒ¹â¤ï¸ Te amamos! MÃ©xico ğŸ‡²ğŸ‡½ te ama! ğŸŒ¹ğŸŒ¹ğŸŒğŸŒ
Barbara Conde	donde estÃ¡ chile???? :))))
Gustavo Gonzalez	HERMOSA CAMILA!!!!!
Efrain Martinez	yeaaaaa !!! monterrey nuevo leon
Helen GonzÃ¡lez Sangama	Alguien aki abla EspaÃ±ol ???
Valentina YouTube	Love camilla cabello
Claudia Olivera	Ya te quiero de nuevo en Argentina, amo tu risa, amo escucharte hablar, sos todo lo lindo de Ã©ste mundo.
Alma H.	Balkan ? ğŸ’•ğŸ’•ğŸ’•
Jacqueline Navarro	QUE NO SE INGLES LPM
Ska Mpo	Camila i love you â¤â¤â¤â¤â¤â¤â¤
Dance Lucyellen & Adrielly	ğŸ’–ğŸ’–ğŸ’–
daniela padron	Eres la mejor saludame
robert craig	CAMILA YOU ARE THE QUEEN,,,AWESOME,,LOVE YOU BABY
Itzel Cristobal	Este video es tan perfecto ğŸ˜­â¤ï¸ Te amoğŸ’™
Brissa Palomino Frisancho	MI AMORRRRR QUE HERMOSAAAAAA
Naye Cortez	Te amo mucho â¤ï¸ğŸ‡²ğŸ‡½ğŸ˜­
Sandra Hernandez	VIVA MÃ‰XICO CABRONES ğŸ¤ŸğŸ‡²ğŸ‡½
Tamales Harry Styles	Camila te amo, a ti y a tu culo.  BACK TO MEXICOOO!!!
Bets Music	You make my heart meltğŸ˜©ğŸ˜mi niÃ±ağŸ˜
Sabrina Reyes	Ven a Guatemala!! Hay muchas Camilizers aquÃ­ :)
Vanessa Andrade	TE AMO! â¤
Enrique Javier BolaÃ±os Lopez	Camila mi hija te admira
Thomas Manoel	My princess
Martina	AAH LPM TR AMOğŸ’–
lexa bae	te amo
Shorty Gisa	Si que bien
Unnamed User	Who else LOVES Camila Cabello??
moonlight as	VIVA MÃ‰XICO!!! TE AMO!
mysterious	Give a like for Camilla
PAOLA ESPINOZA	AsÃ­ se lleva MÃ©xico en la piel chingao ğŸ‡²ğŸ‡½ğŸ‘ğŸ» Por esto y mÃ¡s te amamos
Amanda Ramos	Ewww ğŸ¤®ğŸ¤®ğŸ¤®ğŸ¤® 6:25 matthEWWWW
Joko Borja	I love you Camilaaaaaaaaaaa!
Iidia Maria	Te amo
atzael cisneros	Gracias por ser de las pocas artistas que toma en cuenta a MÃ©xico ğŸ‡²ğŸ‡½ğŸ˜ğŸ˜ Te amo Camiâ¤ï¸â¤ï¸â¤ï¸â¤ï¸
DIPPERCOOLCHERRY	Iâ€™ve so inspired by u as a Mexican Iâ€™ve never felt so represented and proud by the most amazing person which is Camlia cabello
Julieth Mosquera	Por k vergaz habla en ingles, peer deeees!
lourdes ballesta	TE AMO MUCHISIMO
Andrea Mendes	Muy corto este video debiÃ³ ser de 1 hora
Henk	I'd literally die in peace if cc2 would be totally Spanish or at least 4 complete Spanish songs
Adela Gamez Hernandez	Â¡Â¡Â¡Â¡Â¡Â¡VIVA MÃ‰XICO CABRONES!!!!!!
Mebarki Selma	I love you so much camilla, ğŸ˜ğŸ’œğŸ’œ
luis VÃ¡zquez Grande	Mexico ğŸ‡²ğŸ‡½â¤ï¸â¤ï¸â¤ï¸â¤ï¸
Astrid fernandez	Te amo camz
Evelyn V	This was the best concert ever, Iâ€™m so glad you did a tour diary ğŸ‡²ğŸ‡½â¤ï¸ğŸ‡²ğŸ‡½â¤ï¸
Samsung br	*pqp*foda*
igor 03	She is so amazing. I love herğŸ’“ğŸ’“ğŸ’“ğŸ’“
Video Everyone gonna want	I FUCKING LOVE YOU TO DEATH CAMILAâ¤ï¸â¤ï¸â¤ï¸
Brenda Ahumada	Te amo Camila ğŸ‡²ğŸ‡½
lola Visita	This video will always makes me shake bc I can feel the love coming from Camila and papa Alejandro straing to Mexico and this is powerful and magical, the way Camila put everything out on stage is lovely and incredible. I'm proud to be a Camilizer â¤ï¸
Andrea Calderon Lauzo	Me hubiese encantado que hable EspaÃ±ol en el video pero  yo sÃ© que habla mucho espaÃ±ol pero hubiese puesto subtÃ­tulos
A Camilizer From The CPF	ğŸ’šğŸ’šğŸ’šğŸ’šğŸ’šğŸ’š
Quá»‘c DÆ°Æ¡ng Nguyá»…n	Camila <3
ONCE AND ARMYë‹¤í”„ë„¤	Mexico ? ğŸ˜
Fernanda Renteria	Te amo mucho Camila ğŸ’–
Adolfo Hernandez	Te amamosğŸ’•
Ot5h fds	Vai lÃ¡ com o MÃ©xico
Andrea Nieves	ğŸ‡²ğŸ‡½â¤
Maite Marinez	I LOVE YOU CAMILITAAAA
Maria Chatzipendidou	Guys in two minutes this video has twenty thousand views OMG I love camila cabello
DAN DANIELA	Camilaaaa :c â¤â¤â¤â¤ğŸ˜
Yasmin Steefanny Cunha Araujo	E  o Brasil?
Ann baig	Beautiful ğŸ’œğŸ’œğŸ’œğŸ’œ
Hakan GÃ¼ner	ğŸ˜ğŸ˜ğŸ˜
Isabela Chaves	O BRASIL TE AMA GOSTOSA!     VOCÃŠ MERECE O MUNDO!
Juana Ramirez	Camila por que no vienes a cancun ğŸ˜£ muero por conocerte y mi hermana tambien somos fanaticas de tu canciones
adjaratou anna	Camila's army Â¿Where are you?ğŸ˜âœ¨â™¥
emily solo	im beyond proud of youâ¤ï¸
Itzel Saju	ğŸ˜ğŸ˜ğŸ˜ğŸ˜ğŸ˜
Katy Albiston	Everything was fine until 6:26
Luli Novarese	ğŸ’–ğŸ’–ğŸ’–ğŸ’•ğŸ’•ğŸ’•ğŸ’•
Cesar Espinoza	MÃ‰XICO TE AMA ğŸ’•
Sheyla Sagubay	AHHHH TE AMO CAMILA!!!!!!â¤â¤â¤â¤
kiki rani	My love â¤ï¸ğŸŒ¹
Kallyne PicanÃ§o Mendes	Gataaaaa
â€¢kaka- chanâ€¢	*quem Ã© do Brasil curte aqui! Para mostrar que somos tops!*
jeremie osbourne	my weave flew to Mexico
Maksymilian SÅ‚owik	Love u so much! Canâ€™t wait for next tours <3 (never mind that I didnâ€™t even be on this, Iâ€™ll be on next)
Maria jose Vega	De miami a MÃ©xico esta cosa se prendiÃ³ bebe ğŸ”¥ğŸ”¥
Marisela Zavala	viva MÃ©xico cabrones ğŸ‡²ğŸ‡½ ğŸ‡²ğŸ‡½  Te amooooo camila mi amor ğŸ˜
LuÃ­sa Ferreira	Faz do Brasil ğŸ’—ğŸ’—
Mariana Louyse	Cheguei com tudo pra o meu amor
Romy SchrÃ¶der	Coole nummer
Shark #2	she's intelligence she's talent she's beauty  she's art she's love she's unique she's strength she's power she's kindness she's mystery she's happiness        she's the moon she's also the sun she's the stars she's the universe  she's my world      She's everything  she is Camila CabelloğŸ˜
Sarai Reyes	Saquen a Matthew por favor
Zamtrios	Queen
Miriam Manrique	Te amo Camila, cÃ¡sate conmigo ğŸ–¤ğŸ¤
Esther Ani	So proud of you love from Nigeria
adib mouhanna	Many love and respect from Syria ğŸ˜ğŸ˜ğŸ˜ğŸ˜ğŸ˜ğŸ˜˜ğŸ˜˜ğŸ˜˜!ğŸ˜šğŸ˜šğŸ˜™ğŸ˜—ğŸ˜™ğŸ˜ğŸ˜˜!!!!ğŸ‡¸ğŸ‡¾ğŸ‡¸ğŸ‡¾âœ‹ğŸ–ğŸ–
â€¢EVERY DAYâ€¢	Camila, I admire very much since Childhood listening to your songs and your music I love that you're so good when you go to other countries and respect all their customs thanks Greetings from Costa Rica
Mariana Gutierrez	Me emociona tanto ğŸ’• porque tuve la oportunidad de estar ahÃ­ âœ¨ Guadalajara, MÃ©xico ğŸ˜
Madalena AraÃ¹jo	Love Camila cabello
Eralia Katsakiori	I jus wasnâ€™t ready
yo yi	Baby I love you so much. The never be the same tour was amazing
Laura SÃ¡nchez Rubio	La mejor noche de mi vida CDMX,te amo â¤ï¸
Alexandra Vslr	Queen â¤â¤â¤â¤ğŸ¦„ğŸŒš
Lizzeth Lozoya	:0
AMM	Fadaaaaâ™¥
mimi otaku girl	camila im from algeria and i  love you soo much you are the best â¤ï¸
K Swag	Love this.
zoe soriano	1:44 cuando tu padre se aburre PER TU HIJA SE MUERE POR VER A CAMILAğŸ˜‚ğŸ˜‚TE AMO CAMILA
Sara Bila	Love herğŸ’–ğŸ’–
Cindy Martinez	y yo esperando el de Colombia, que obviamente NO va a suceder
roses in the dark	Oh por dios, realmente estoy llorando, no puedo explicar lo que sentÃ­ de estar ahÃ­ para ti en tu primera gira como solista, aunque estaba algo lejos de ti, debo admitir que lo Ãºnico que querÃ­a es ir corriendo a abrazarte.
Sparkling Unicorn	Hai!!
ikram mahmood	Funny that I was literally scrolling her channel down hoping there is a new vid to watch while listening to Havana and then boom I get the notification â¤
romy c	DE MIAMI A MÃ‰XICOO ESTA COSA SE PRENDIO BABYYY ğŸ”¥ğŸ”¥ğŸ”¥
Luh Gomess	Sou de fato a melhor namorada do mundo.. O vÃ­deo da Camila mal postou e eu jÃ¡ fui correndo enviar o link para minha namorada haha â™¥
lucy heartufullia	Here before 100K
barbs f	ğŸ˜™ğŸ˜šğŸ˜šğŸ˜™ğŸ˜ğŸ˜ğŸ˜
Claudia Yurani Meneses	BellÃ­sima ğŸ˜€
tÃ¢nia dias	Camila makes me proud of Mexico and Cuba and i'm not even from those countries
Rocio Gonzalez	DeberÃ­as Hablar En EspaÃ±ol Camilaaâ˜¹ï¸
bruna iochem	Maravilhosa ğŸ˜â™¥ï¸
Geovanna Felix	Camila Cabello? #AmoDeMontÃ£o
las reinas de la pista	like si no sos de Mexico,comentario si si lo sos
Just meee	*_LATINOOOOS_*
delica Herdezs	like si cuando saliÃ³ Alejandro gritaste "te amo SUEGRO"
jossbally	ğŸ˜‰ğŸ˜‰ğŸ˜‰ğŸ˜‰ğŸ˜ŠğŸ˜ŠğŸ˜ŠğŸ˜Šeres una persona muy linda
Karen Xiomara 18'	Saludos  ğŸ‡µğŸ‡ª Tacna - PerÃº ğŸ‡µğŸ‡ª
claudia yannet montoya tello	Bella mi CamiğŸ˜ğŸ˜ Quiero un vÃ­deo asÃ­ para PerÃº ğŸ˜ŠğŸ˜Š
sarah _xox	Im dieying
Mayra Leonela	Like si amas a camila...ğŸ˜™ğŸ˜™ğŸ˜™ğŸ˜™ğŸ‘
Jes Moncaleano	Lo acaban de poner y ya hay 10.000 visitas y 700 comentarios que internet usan ustedes a ver si me uno vaya que si es rÃ¡pido ğŸ˜‚ğŸ˜‚ğŸ˜‚ğŸ˜‚ğŸ˜‚ğŸ˜‚ por cierto amÃ© el diary (MÃ‰XICO)ğŸ’—ğŸ’—
Anonymous CamrenShipper	ğŸ’“ğŸ˜ğŸ˜˜Te amo!!!ğŸ˜‹ğŸ‘‘ğŸ’‹
Ximena Brito	camila eres la mejor te quiero eres sÃºper <3
Sam Owen	Niiiiiiiiiccccccceeee Live ya much
juan jose martinez	Me facino ..desde colombiağŸ˜˜ğŸ˜˜ğŸ˜˜
littlemix are snatching wigs	When you realize that you'll never see Camila because she probably doesn't even know about your country's existent
MT Reactions	I'm subbing back to everyone that subs to me! Comment when you subbed.
Nikilandia Costa	ğŸ’•ğŸ’•
Eleandra Fernandes	ğŸŒ·
Brianna Richardson	I love you so much Camz, so happy youâ€™re happy. Much love â¤ï¸â¤ï¸â¤ï¸
Sweet Dreams	I'm so happy i was on this journey with U and all the Camilzers..I love U so much.Hope to see and hug u 1day...Thank u for EVERYTHING..We're here for i foreverâ¤â¤Can't wait for the next era!!!ğŸ’•ğŸ’•ğŸ’•ğŸ’•ğŸ’•ğŸ’•
Roberto Ramos	Porque no hablÃ³ en EspaÃ±ol? Es MÃ©xico, digo, no somos tan brutos y si sabemos algo de Ingles, pero, es MÃ©xico y aquÃ­ se habla espaÃ±ol... AhÃ­ si no me gusto mucho... La verdad... Este documental tuve que salir en espaÃ±ol NO en Ingles!
ragad Play	â¤â¤â¤
Vanessa Alguaca	I LOVE
Titan . VictorCC	ğŸ˜ğŸ˜ğŸ˜ğŸ˜ğŸ¤—ğŸ˜€
Dulce Maria	*Camila* ğŸ‘‘ğŸ™ˆğŸ˜
Marisol Huaman Moscoso	Te amoooğŸ˜˜ğŸ˜˜ğŸ˜˜ğŸ˜˜ğŸ˜˜ ven a PerÃºğŸ˜­ğŸ˜­
Livia Pereira	O Brasil te ama muito gostosaaaaâ¤ğŸ‡§ğŸ‡·ğŸ‡§ğŸ‡·ğŸ‡§ğŸ‡·
Melanie Misses	BRAZIL LOVES YOU ğŸ˜ğŸ’—ğŸ’™ğŸ’š
Dwaipayan Datta Roy	Bolodh laagchey ekkeybaaray
Soraia Ferreira	Amo-te Rainha ğŸ’• You're the best Camila, I'll love you for the eternity ğŸ’ğŸ’ğŸ’ I loved this video ğŸ˜ğŸ˜ğŸ’•
Mony LR	Omg! I love youâ¤
Gucci Joseph	ESPERO EL DE CHILE AHHHHHH. TE AMO BEBÃ‰, ESTOY TAN ORGULLOSA DE TI. En serio, te amo muchÃ­simo. Gracias por todo. â™¡
Suraj Singh	LOVE YOU
Kailane Mendes	amo tanto â¤ï¸
flor pampa sulca	Te amo Camila me encanta tu mÃºsica ;) todas...
JelenaFans4Ever	I love this family
Wib Camila JungKook	I love you fada cubana
LaÃ­s Garcia	Te amo muito Camz
*Adele & Bruno Mars*	Wow.....ğŸ˜ğŸ˜ğŸ˜these gives me goosebumps & feel so good to see  artist like her is having such a wonderful  joyful journey other than some overrated artist ( no hate though ) . Many immensly artist deserve this kind of moments . Hence , we audience should love them . Camila loads of love and respect from Nepal ğŸ‡³ğŸ‡µ .  It's random & may sound funny ..... But I want you here ( which I don't think will be in 100 years ğŸ˜‚ğŸ˜–ğŸ˜–ğŸ˜­ ğŸ˜­)  Anyway love you ğŸ˜ŠğŸ¤—â¤
Lu RodrÃ­guez	Viva MÃ©xico cabrones ğŸ˜‚ğŸ˜˜ğŸ‡²ğŸ‡½
Bruna Kelly	LoveğŸ‡§ğŸ‡·â¤
Talissa Toso	Wow thatâ€™s so cool
Rushil	â¤ï¸â¤ï¸
Ana Nitu	I am so sad i couldn't come at your concert!
Stacey Molina	The best person in whole World!! You're our light, loveeeee yağŸ˜ğŸ˜¢
Aouali Hamza	â¤
Liza Zoe	Yesss omg....yes yes yes.....I can never stop Fangirling over Camilla.... she is like my favourite all the way through
beltran BELTRAN	Te amooooo!ğŸ˜ğŸ˜ Apoyando desde MÃ©xico
Arunima xoxo	I am so happy.. finally she is living her. Best  life ,I love her so Much
william cayco regin	I LOVE YOU .... <3
BMW Freaks	Formula 1 was in Mexico too! From 26-28 october 2018!
Jeisca Gonzalez	Has uno de Puerto Ricoo!!! Fue el mejor concierto!! Love you espero que vuelvass!!â¤
Fiona Escamilla Franco	Te amooooooğŸ˜
Adrian JD2019	*â¤TE AMAMOS CAMILA!!!â¤*
Mizu Love	Que hermoso video ğŸ˜ğŸ˜ğŸ˜ğŸ˜ğŸŒ·ğŸ˜—
miguel guerrero	kien mas fue al concierto:)
Sofiz	Aaaa
Melanie Rempel	Aguante Argentina papaaaaa o mejor dicho camilizerlandiaaaağŸ’•
Fan n1 Selena GÃ³mez	Camila te amo tienes que ir a *ECUADOR* a cantar
vale tabo	ğŸ’šğŸ’šğŸ’šğŸ’šğŸ’šğŸ’šğŸ’šğŸ’šğŸ’š
bel sullivan	Ai sim ğŸŒ¸
CAMREN Is Real	CAMILA GOSTOSAAAAAAAA. BUNDA DO TITANIC ğŸŒš
Laylma Silva Costa	Brasil ğŸ‡§ğŸ‡·ğŸ‡§ğŸ‡·ğŸ‡§ğŸ‡·
APAIXONADOS POR DISNEY	Aqui tem comentÃ¡rios de vÃ¡rios idiomas!!!!! Camila Cabello tÃ¡ dominando o mundo!!!!ğŸ‡§ğŸ‡·ğŸ’–
Stefanie Pleines	Du bist so cool und rappen kannst DU auch ğŸ˜Š
NathÃ¡lia SerrÃ£o Melo	ğŸ‡§ğŸ‡·ğŸ‡§ğŸ‡·ğŸ‡§ğŸ‡·ğŸ‡§ğŸ‡·ğŸ‡§ğŸ‡·
arianagrandebuterafan 69	FranÃ§ais ?â¤ğŸ‡«ğŸ‡·
plume Bleue	Oh ! Pour une fois que j'arrive quand la vidÃ©o sort ! ğŸ¤” Le hasard fait bien les choses ! ğŸ‡¨ğŸ‡µâ¤ï¸
Kytsel Benitez	ğŸ˜®ğŸ˜®ğŸ˜®ğŸ˜®ğŸ˜®ğŸ˜®ğŸ˜®ğŸ˜®ğŸ˜®ğŸ˜®
Jayanti Kirtenia	Omg uploaded 3 mins ago and so many comments and views!!!!!!camila u rock !camilizers where u at????
Elena Gatita Lover	Y cuando vendrÃ¡s a PerÃº ğŸ‡µğŸ‡ª?? Soy tu fan Profunda de mi vida y nunca que olvidarÃ© CAMILA CABELLO!!
Drunk Breadsticks	My scalp has been officially balded ğŸ’€
Ruth Calderon	ğŸ˜ğŸ˜ğŸ˜ğŸ˜ğŸ˜
Leidiane Carla	Te amo meia brasileiraâ™¥â™¥
MdNajaMarie	I wish you would come where I live...
Priss Tapia	Esta bn hermosa la Camila ğŸ˜ğŸ’•
Laura Isabel Jaramillo Salazar	Miami and MÃ©xico ... Esta cosa se prendiÃ³ğŸ˜
u'r da best	Hey Camila, i love you ğŸ˜â¤
Aida Garcia	Te amoo ğŸ˜ğŸ˜ğŸ˜ğŸ˜ğŸ’•
brendalt	y argentina yeguaaaa
Nico Robles	Your awesome! -From Greece
Evelyn Guevara	camila cabello hermosa ğŸ’ğŸ˜ğŸ˜ğŸ˜ğŸ˜
Fio Kang	A wuevo jajaja lofiu ğŸ˜
DJ DÅ¼odÅ¼o	Pierszy
Marivi Santoshi	Meu amoooooooooor te amoğŸ’–
Filipe Goncalves	omg I love you queen
Toxic Cat	MEXICO :D ğŸ’
Paluten Paluten	Te quiero mucho espero que te vea una vez en ZÃ¼rich Suiza ğŸ‡¨ğŸ‡­
vida de um craft	love camila ğŸ˜˜
Lesly Valentina Granados Aguilar	Te amoooooo
beauty girls	I lovee youuu
Las locuras de Dara	I LOVE U â¤ï¸â¤ï¸â¤ï¸â¤ï¸â¤ï¸â¤ï¸â¤ï¸
Catherina Berti	Te amooooo
ornela 25	I love this latino part of her. And I love the fact that she embraces her roots and is proud of them. The list that "I love's" about Camila could go on and on, but let's just basically say I LOVE CAMILA CABELLO!!!â¤
Oswald Bear	Come to Zacatecas ğŸ’
SuperChiko4000	This is so Awesome
bruno silva	MY NEXT PRINCESA OF POP! CC2 IS COMING MY BABYSSSSSS..... LOVE U MILAAAA
Axel S'g	â¤
Darkx Alo	Love u ğŸ˜›ğŸ˜›
gay screaming	Apareciiii :')
s. Luck	Cameelaa cabeloo te amo cosita hermosa!!! Me encantÃ³ ir a tu concierto ğŸ˜
yenny Condor	â™¡â™¡â™¡
Ian MartÃ­nez	ğŸ˜ğŸ˜ğŸ˜
Anessa Dia	ğŸ˜ğŸ˜ğŸ˜ğŸ˜
Scarleth Fuentealba	Fantastic :3
MÃ¸Ã¸nlightati	Y ARGENTINAA??
Wejden Glouia	I love u so much i wanna see u here in Tunisia!!!!!ğŸ˜ğŸ˜â¤â¤â¤
Angel Fabrizio Vanegas Alvarado	QUE CHIDOO.. ME ENCANTA
Miguel Henderson Swift	Te amo!â¤ï¸
DiNa the Auror	U will be the same or not but still u'll always stay AMAZINGGG !!!!ğŸ˜ğŸ˜ğŸ˜
Omar Bezariuz	MÃ©xico te ama ğŸ’™
Mahi P	U came to came to india?!?!?!?!??!?!?!
Mijou Myra	ğŸ˜˜HavanağŸ˜˜ğŸ˜šI love you camilağŸ˜š
Tito	ğŸ˜
Clara Mercedes	Hermosa como siempre mi cantante favorita eres mi nÃºmero uno
I r i n e u	VAI,FADA CUBANA! â™¥
Anya Rahimova	ğŸ˜—ğŸ˜—ğŸ˜—ğŸ˜—ğŸ˜—ğŸ˜—ğŸ˜—ğŸ˜—ğŸ˜—ğŸ˜—ğŸ˜—ğŸ˜—ğŸ˜—ğŸ˜—ğŸ˜—ğŸ˜—ğŸ˜—ğŸ˜—ğŸ˜—ğŸ˜—ğŸ˜—ğŸ˜—ğŸ˜—ğŸ˜—ğŸ˜—ğŸ˜—ğŸ˜—ğŸ˜—ğŸ˜—ğŸ˜—ğŸ˜—ğŸ˜—ğŸ˜—ğŸ˜—ğŸ˜—ğŸ˜—ğŸ˜—ğŸ˜—ğŸ˜—ğŸ˜—ğŸ˜—ğŸ˜—ğŸ˜—ğŸ˜—ğŸ˜—ğŸ˜—ğŸ˜—ğŸ˜—ğŸ˜—ğŸ˜—ğŸ˜—ğŸ˜—ğŸ˜—ğŸ˜—ğŸ˜—ğŸ˜—ğŸ˜—ğŸ˜—ğŸ˜—ğŸ˜—ğŸ˜—ğŸ˜—ğŸ˜—ğŸ˜—ğŸ˜—ğŸ˜—ğŸ˜—ğŸ˜—ğŸ˜—ğŸ˜—ğŸ˜—ğŸ˜—ğŸ˜—ğŸ˜—ğŸ˜—ğŸ˜—ğŸ˜—ğŸ˜—ğŸ˜—ğŸ˜—ğŸ˜—ğŸ˜—ğŸ˜—ğŸ˜—ğŸ˜—ğŸ˜—ğŸ˜—ğŸ˜—ğŸ˜—ğŸ˜—ğŸ˜—ğŸ˜—ğŸ˜—ğŸ˜—ğŸ˜—ğŸ˜—ğŸ’ğŸ’ğŸ’ğŸ’ğŸ’ğŸ’ğŸ’ğŸ’ğŸ’ğŸ’ğŸ’ğŸ’ğŸ’ğŸ’ğŸ’ğŸ’ğŸ’ğŸ’ğŸ’ğŸ’ğŸ’ğŸ’ğŸ’ğŸ’ğŸ’ğŸ’ğŸ’ğŸ’ğŸ’ğŸ’ğŸ’ğŸ’ğŸ’ğŸ’ğŸ’ğŸ’ğŸ’ğŸ’ğŸ’ğŸ’ğŸ’ğŸ’ğŸ’ğŸ’ğŸ’ğŸ’
juan diego niÃ±o vargas	La Mujer Mas Hermosaaa ğŸ’“ğŸ˜ğŸ˜ğŸ‘
Yariskel Moran	Cami ven a PanamÃ¡ğŸ˜¢ğŸ˜¢â¤â¤ Te amoo!!ğŸ’–ğŸ’–ğŸ’«ğŸ’«
Thay ,_,	BRASIL TE AMAğŸ’›ğŸ’šğŸ’›ğŸ’šğŸ’›ğŸ’š
Lucimara Sousa	Te amo Camila cabelloğŸ˜ğŸ˜ğŸ˜â¤
God Speed	My babyğŸ˜
dulce vallejo	TE AMO ğŸ’˜ğŸ’—ğŸ’–ğŸ’ğŸ’“ğŸ’‹
lahari BTS fan	Te amo!ğŸ˜˜
Linda Islas	Que hermoso MÃ©xico presente ğŸ’—ğŸ’—ğŸ’—ğŸ’—
Ariana grande Loverxx	Love you ğŸ’‹ğŸ’„
OMAR ABDULLAH ABDO OMAR	ğŸ¤ğŸ¶ğŸ¹ğŸ¤ğŸ¶ğŸ¹ğŸ¤ğŸ¶ğŸ¹ğŸ¤ğŸ¶ğŸ¹ğŸ¤ğŸ¶ğŸ¹ğŸ¤ğŸ¶ğŸ¹ğŸ¤ğŸ¶ğŸ¹ğŸ¤ğŸ¶ğŸ¹ğŸ¶ğŸ¤ğŸ¹
Enna Vojtkiv	whoâ€™s here before 1 million?
Neagu Adelina	Omg love you!
Alexa Monroy	Eres la mejor persona del mundo.ğŸ˜ğŸ˜ğŸ˜ğŸ˜­â¤
Giovanna Borges	TE AMO ÃCONE
Luna 502	I LOVE you
best of camila	ESPERO CON ANSIAS EL DE ARGENTINA
Leandro TufiÃ±o	I loveâ¤
Mani Berisha	I'm from kosovo I really want to meet you but I can't that make me so sad
amnah syed	if ur plan is to Make me cry N jealous den ur doin a great job Coz am jealous i wasnt der N i didnt meet U n hug U ğŸ˜­ğŸ’–ğŸ’™
Anouar el qaddar	good <3
Izzee Music	LOVE YOU CAMILA!!! ğŸ˜˜
Leh Martins	te amoâ¤ğŸ˜
Land Ramirez	ğŸ˜ğŸ˜ğŸ’–ğŸ’–ğŸ’–ğŸ˜˜ğŸ˜˜
cyres gabriel superal	Iloveyou camilağŸ˜
Yasmin Sales	Deusa Aaaa aa
lola ore	ğŸ’ğŸ’–ğŸ’˜
Kristal Aviles	Te amoooooo Camila, eres inspiraciÃ³n. â¤ï¸â¤ï¸â¤ï¸
umarv2wild	First , but no one cares .
Martella Styles	Polska â¤ï¸ğŸ’ªâ¤ï¸ğŸ˜
Manu Nilsson	7:51 Owwwâ¤
catu mmzz	TE AMO AAA
Marilu Pecina	ğŸ‡²ğŸ‡½ğŸ‡²ğŸ‡½ğŸ‡²ğŸ‡½ğŸ‡²ğŸ‡½ğŸ‡²ğŸ‡½ğŸ‡²ğŸ‡½ğŸ‡²ğŸ‡½
Peek Aboo	Can't wait to tell my grandkids and great grandkids on 2078 who camila is
Nd Boss	Wish I couldâ€™ve met you ğŸ˜­ğŸ˜­â¤ï¸â¤ï¸â¤ï¸â¤ï¸â¤ï¸
ì”¨ë°œ	Te amoâ¤
Myar Ender	I LOVE U CAMILA AHHHH ğŸ’•ğŸ’•ğŸ’•ğŸ’•ğŸ’•ğŸ’•ğŸ’•ğŸ’•ğŸ’•
farah you	LOVE YOU CAMILIA AND HAVANAğŸ˜â¤â¤â¤ğŸ’®ğŸ’®ğŸ’¨ğŸ’¨ğŸ”¥
Radhakrishna Go Gokelaprakash ggp	ğŸ˜ğŸ˜˜ğŸ˜˜ğŸ˜˜ğŸ˜˜
Carla Soto	Te amamosâ¤ï¸ğŸ‡²ğŸ‡½
Carla Souza	Te amooooo
game BR oficial	Te amo muito
Volokiller	first ğŸ˜ğŸ˜ğŸ˜ğŸ˜ğŸ˜˜ğŸ˜˜ğŸ˜˜ğŸ˜˜â¤ï¸â¤ï¸â¤ï¸â¤ï¸ğŸ‡¨ğŸ‡ºğŸ‡¨ğŸ‡ºğŸ‡¨ğŸ‡ºğŸ‡®ğŸ‡¹ğŸ‡®ğŸ‡¹ğŸ‡®ğŸ‡¹
Emma Vega	Who else is soooo proud of how far Camila has come... always knew she would make it big
Alejo604	omg i love You
German Hernandez	Love her!
Nanine Stylinson	LOVE U SO MUCH
Sandra S	Aaaaaaaa Camila Cabello viva Cabrona â¤
Mica Sanchez	VIVA MÃ‰XICO CABRONES!!! ğŸŒŸğŸŒŸ
VitÃ³ria Ferrereira	AAAAAAA TE AMOOO
Caro Ramat	I love youu
Sofi Heldens	TE AMO MUCHO HERMOSA! ğŸ’˜
kuina_aq otaku	Ù…Ø²Ø²Ø²Ù‡Ù‡Ù‡Ù‡ ÙŠØ±Ø¨ÙŠÙŠÙŠÙ‡Ù‡ğŸ’™ğŸ’™ğŸ’™ğŸ’™ğŸ’™ğŸ˜”ğŸ’˜
dinela 26 arriver	Lleganda antes del millon amixes
Anali Amezquita salas	Te amo camila!! ğŸ‡µğŸ‡ªâ¤
Ana Julia Cruz	https://m.facebook.com/story.php?story_fbid=1162156580605204&id=100004326189034 Oi, se nÃ£o for pedir muito eu queria que tu entrasse nesse vÃ­deo e curtisse, Ã© uma tarefa e o vÃ­deo com mais curtidas ganha. Obrigada pela atenÃ§Ã£o.
Catarina Silva	Proud af.. hoping to see you in Portugal one day
laura rodriguez	ğŸ˜ğŸ˜ğŸ˜ cuando viene a Colombia Mija?
Ina Fray	Your voice is amazing â¤ï¸ itâ€˜s Full of Energy , power , Love and creativity â¤ï¸ğŸ’ CAMILA , CAMILA CAMILA CAMILA WHOAAAAAAAAAAAA(screaming) ğŸ¥€â¤ï¸
Semra Uslu	CAMILLA OH -NA NA
Yriimedov Volhebnic	ĞŸĞ Ğ˜ĞšĞĞ›Ğ¬ĞĞĞ• Ğ’Ğ˜Ğ”Ğ•Ğ ğŸ˜ŠğŸ˜ŠğŸ˜ŠĞŸĞ•Ğ¡ĞĞ¯ ĞĞ‘ĞĞ›Ğ”Ğ•ĞĞĞĞ¯ ğŸ‘ğŸ‘ğŸ‘ğŸ‘ğŸ‘
Ross Mashups	you are literally one of the best and truest singers in the industry. love u cami ğŸ’™ğŸ¦‹
Yesid RodrÃ¬guez TÃ¨llez	AlgÃºn latino
Sofia	Camila te amo!!
Gisselle Flores	Ahuevo VIVA MEXICO !!!!! I love you
CARLOS AMADOR SOSA RAMIREZ	Me encanto lastima que no se ingles you know.
chti HB	I Love Camilla Cabello ğŸ˜ğŸ˜ğŸ‘ğŸ‘
3D Soul	Keep moving we are with you
Iara Silva	You're so gorgeous
Youssef Mouaddine	Chi carina
aracely cueca	first
Brianda Ojeda	TE AMO CAMILAAAA!! DIOSAAAAAAAAA!!
Xorks Radio	First like
No Name	I love you from morocco â¤
lalisart	amo tanto a esta mujer :(
Nath	TE AMOOOOOOO
ana maria Moreno	Y nunca viniste a Colombia:), te amodio:)
Deborah Barros	Te amoâ¤
Klartsu	I LOVE YOU SO MUCH
Zuemy Mendez	Te amo ğŸ˜ğŸ˜â¤â¤ eres la mejor ğŸ’™ğŸ’™ no me cansarÃ© de decirlo ğŸ˜­ğŸ˜â¤
Isabella DÃ­az	She Is so beautiful ğŸ˜â¤
Iriel Diaz	I LOVE YOU CAMZ!!!ğŸ˜ğŸŒˆâ¤â¤
Osneidys Viloria	Te amo
MÃ©lany P. Forra	Lo hiciste MÃGICO @camila_cabello
jÃºlia Almeida	ğŸ’šğŸ’›ğŸ’šğŸ’›ğŸ’šğŸ’›ğŸ’šğŸ’›ğŸ‡§ğŸ‡·ğŸ‡§ğŸ‡·BRASIL ğŸ‡§ğŸ‡·ğŸ‡§ğŸ‡·ğŸ’šğŸ’›ğŸ’šğŸ’›ğŸ’šğŸ’›ğŸ’šğŸ’›
Sofia Simpson	cool
Isabel Vazquez	Graciaaaaas por tantÃ­simo ğŸ˜ğŸ˜ğŸ˜ğŸ˜ğŸ˜
Nubia Gonzalez	ğŸ™ŠğŸ™ˆğŸ™‰ğŸ˜ğŸ˜ğŸ˜ğŸ˜ğŸ™Œ
Noemi Rodriguez	Que bonito ya me gustarÃ­a estar allÃ­, cantas de maravilla Camilaâ˜ºğŸ˜™
Jefferson Luciano	Love you!
Joce Alvarado	El mejor dÃ­a de mi vida â¤ğŸ˜
A M	Wooweee first 100 ğŸ¤—â¤ï¸ğŸ’š
Aline Prado	*CADE O DO BRASIL?* *PRECISA POSTAR TAMBÃ‰M MEIA BRASILEIRA!!* *ğŸ‡§ğŸ‡·âœ¨â¤ï¸*
Emma V	*she's so freaking aMaZiNg*
belen bts twice	ğŸ–¤ğŸ’–ğŸ’–CAMILA ğŸ’–ğŸ’–TE AMOOğŸ’–ğŸ’–ğŸ–¤
Tropical	oh baby! ğŸ˜
heshw karim	ğŸ’‹ğŸ’ğŸ’
Norma Thais Becerra	que ganas de llorar alv ğŸ˜­ğŸ˜­ğŸ˜­
Dan loo	I am so glad i clicked within secondssss ğŸ˜‚ğŸ˜‚ğŸ˜‚
Emre ArdÄ±Ã§	Turkey ğŸ‡¹ğŸ‡·
Eric Hsieh	NOTIFICATION SQUAD
Puffo&Poeta	Love uuuuuâ¤â¤â¤
ZURIS Present	Love u â¤ï¸â¤ï¸
Maritsa Gonzalez	Yasss girl
Brandon Yepes	Your the best
Samira Yusuf	going miss best tour ğŸ˜­ğŸ˜¢
Evelyn Zagari	Hey
kxrwl	havana oh na na
Zoey -_-x3	love YOU CAMIII
Giovanna Sobral	ğŸ˜â¤
Viviana  Fajardo	â¤ï¸â¤ï¸â¤ï¸â¤ï¸â¤ï¸â¤ï¸
E Lyman	Hey Camilla love you ğŸ˜˜ğŸ˜˜
Fernando Bachega	love uu s2
Unicorn Gamer Grace	I love u ReinağŸ’œ
Anita Leon	CUANDO VIENES A GUATEMALAğŸ‡¬ğŸ‡¹ KARLA ESTRABAO!!!ğŸ˜’ğŸ˜‚ğŸ’•
maria clara silva	Amo muito essa mulherğŸ˜ğŸ˜ Ela merece tudo de bomâ¤
LifeWith Ramona	â¤ï¸â¤ï¸
Shawty Nisha	I love you â¤ï¸â¤ï¸
Mr0217ish	Por quÃ© si es en Mexico hablas en ingles? Jejsjs
Hayli Mae	Hi
ONTHEFLOOR MIJA	Lloranding......
Ğ’ĞµÑ€Ğ° Ğ¨Ğ°Ñ€Ğ¾Ğ²Ğ°	I am first
Mad RD	Hi from AlgÃ©rie â¤
Ximena S.B	ğŸ˜ğŸ˜ğŸ˜ğŸ˜ğŸ˜ğŸ˜ğŸ˜ MÃ©xico lindo y queridoğŸ‡²ğŸ‡½ğŸ‡²ğŸ‡½
Jejeu Vieira	Love you â¤ğŸ‡§ğŸ‡·
Ziliz 971	You are so pretty ğŸ’–ğŸ€
TwoSisters	I love â¤ï¸ you  TE AMO â¤ï¸
Angie Tejedor	Hermosaa te amamos
kenny IÃ±iguez	LLEGANDO EN PERRA A VER EL VIDEO
Darkzera	*_PERFECTION_*
Andreza Saraiva	MARAVILHOSAAAA ğŸ˜ğŸ˜
Jazzy Beats 219	Camila wooooh! Happy halloween
Vilions	Amazing â¤ï¸
Dam Fernandes Games	One
The Pollita triste	huevo viva  mexico cabronesss!!  Dia increÃ­ble para nosotros los mexicanosğŸ˜â¤â¤â¤
Alexa NY	Oooouh shit! ğŸ˜ğŸ˜ğŸ’–ğŸ’–ğŸ’–
Oscar Hudson	Fue un dÃ­a hermoso Camila, te amamos.ğŸ‡²ğŸ‡½â¤ï¸
Omar.king. x Gamer	We like to come with you â¤ï¸
Sarai MartÃ­nez	Te amo Camila â¤â¤
[[ J- Love ]]	Eres la mejor saludos desde Argentina ğŸ˜ğŸ‡¦ğŸ‡·
Nebbytastic3500	I wish I already moved to Mexico dang it Iâ€™m moving soon
Michelk Fonseca	LA MEJOR PARTE ES CUANDO SALE CAMILA EN TEQUILA ğŸ”¥
Daniel Colmenares	camila eres bien lindad
Claudia Leonguapa	Te amooooo
BÃ¼ÅŸra UzunkÃ¶y	I love you camilaa
Farah Wahab	â¤ï¸â¤ï¸â¤ï¸
jovem igor	Te amoğŸ’™
Janeth Rosas	I MISS YOU SO FUCKING MUCH
Ana alice Sousa	Quem foi o filho da puta que deu deslike ?
Mauricio Fuentes	Hermosa camila te amo mucho mi sueÃ±o es poder conocerte ğŸ˜ğŸ˜ğŸ˜ğŸ˜ğŸ˜ğŸ˜
Ravenclaw Boy	I love you !!!!!!!!!!!!
Ro Na	Camila â¤ï¸ Love that â¤ï¸ğŸ˜Œ
Biann	Te amooooo
Ryan Misquitta-Yip	Yaaasss QUEEN We love you and I wish the best for you and your family forever and ever â¤ï¸â¤ï¸â¤ï¸
anto Inze	Yasss queen
Fairy Minghao	when eres latina pero no mexicana :"v Â¡aquÃ­ en perÃº te espero camiiiiiiiiii! ahre <333 Â¡saranghae!!!
Aaron's Mashups	"first" Trump me, no deport camila
libby perks	love your music so much XXxxxxxxx
Rocio Alvarez	VIVA CHILE :D
Abigail Justin	Camilla you are so beautiful and have an angelic voice
Mira TV	Love you camilla
scarleth Mezas	â¤ï¸â¤ï¸â¤ï¸â¤ï¸
MinuteIron 321	OMG FIRST FIRST FIRST!!!!  Y LOVE YOU SO MUCH CAMILAA AAA ğŸ˜â¤ğŸ˜ğŸ˜ğŸ˜ğŸ˜ğŸ˜
VanessaHudgens954	Vuelve pronto! ğŸ˜ğŸ‡²ğŸ‡½
GutiÃ©rrez68 bros	Te quiero ğŸ˜
Yone Cruz	QUERO O BRASIL ğŸ’šğŸ’›
Legod is the best ever Some Legends gots no rings	Camilla hottest woman ever ğŸ’¯ğŸ’¯
Magui Plisetsky	Ã¡ngel ğŸ˜
Puppy Forever	Homework can waitğŸ˜„ğŸ˜‹ğŸ˜ŠNeed to watch my queen first
SOEF	I LOVE IT AND I LOVE YOU!ğŸ˜
PelÃ­culas Tio CJ	First One
Alicia Sousa	Melhor tour da vida, vocÃª Ã© demais garota! ğŸ‡§ğŸ‡·
Elizabeth Varela	Heeyyyyy love you like if you do
myboo4ever	ğŸ˜â¤ï¸ğŸ’¯
Eva Wiebing	Camila youâ€™re the best, I love you so much â¤ï¸
veronica volkova	CamilağŸ–¤ğŸ–¤ğŸ–¤ğŸ–¤ğŸ‰ğŸ‰ğŸ‰you are the bestğŸ™ˆğŸ–¤ğŸ–¤ğŸ–¤
Jocabed MG	Te amo sÃ­gueme en Instagram como @la_jocamg
Sweet 03	ğŸ’–
Alison Tostus	Mexicooooo gostozaaaa!!!!
Ê€É›áƒªÉ›Ï‚Ï‚Ã¡	love her! #camila #yougogirl
SOY ROCO	I Love You CamilağŸ˜
Maxx Almanzzar Official	AmÃ©rica central quien?Â¿ AmÃ©rica del sur??
deivid	- Te amoğŸ’™ğŸ‡§ğŸ‡·
Va_H_ny Tv	Camila i â¤ï¸youu
CrazyAshley	Thats beautiful ğŸ˜Šâ¤ï¸â¤ï¸ i love inside out and consequences â¤ï¸â¤ï¸â¤ï¸â¤ï¸â¤ï¸
Î—Î»Î¯Î±Ï‚ Î£Ï€Î±Î½Î¿Ï€Î¿Ï…Î»Î¿Ï‚	Before 10 million views?
My memes are danker than your moms kitchen	Shishter iâ€™m early and thatâ€™s the closest iâ€™m going to get to you
Yona Sancho	ğŸ˜ğŸ’–
Paola Mejia	VOY A LLORAR PORQUE NO LOGRE IR ME DUELES CAMILA PERO EN SERIO TE AMO ERES LA MUJER MAS HERMOSO ERES PURO AMOR BB
Dennisse Guadalupe	Me encanta que viva MÃ©xico ğŸ˜ğŸ˜
Wendy Santos juarez	Amor mÃ­oâ¤ï¸
Abdisamad Elmi	66 commenter
Bea Flower	AI MEU DEUS CAMILA ğŸ˜ŸğŸ‡§ğŸ‡·ğŸ‡§ğŸ‡·ğŸ‡§ğŸ‡·â¤â¤
Lina Adam	Loveyou ğŸ˜šâ¤
Anahi	Ahre CAMREN IS RIAL PUTOS
Katie ./.	Amazing!!
Hicham Haider	ğŸ’ªğŸ’ª
Ylli Sdrava	Î™ Love You ğŸ˜˜ğŸ˜˜ğŸ˜˜ğŸ˜˜ğŸ˜˜ğŸ˜˜ğŸ˜˜ğŸ˜˜ğŸ˜˜ğŸ˜˜ğŸ˜˜ğŸ˜˜ğŸ˜˜ğŸ˜˜ğŸ˜˜ğŸ˜˜ğŸ˜˜ğŸ˜˜ğŸ˜˜ğŸ˜˜ğŸ˜˜ğŸ˜˜ğŸ˜˜ğŸ˜˜ğŸ˜˜ğŸ˜˜ğŸ˜˜ğŸ˜˜ğŸ˜˜
Jayy Kom Trikru	The. fucking. Queen
EdSong	Like si crees que camila es lo mejor saludos desde mi canal , visÃ­talo es gratis
consequence	Eres hermosas por dentro y fuera. Que sigas teniendo muchos Ã©xitos mÃ¡s y que nunca cambie esa sencillez que te caracteriza.
basty noemi rivera medina	#901ğŸ˜
Wendy cardenia Wendita	â™¡â™¡â™¡
Layla Wilson	ğŸ’œğŸ’œ
Teya Dahabra	Woahhhhh ğŸ˜ğŸ˜ğŸ˜ğŸ˜
Iris Garcia	:')
maria berumen	Te Amoooo camilaaa ahhh
Amor De Meninos	Brasil? VocÃªs querem fada cubana ? Amoooo
Indira Soliz	You are the best
TDJNV 727	te pinche amo ğŸ‘‰ğŸ‘ŒğŸ‡²ğŸ‡½ğŸ‡²ğŸ‡½ğŸ’•
Aurora Wright	First Awesome ğŸ˜
Manglethefox XD	Love you Camila!
Matias Hernandez	La carreta se prendiÃ³ â™¥ï¸Chile
Aditi Alam	LOVE YOU !!!!!
Elisa Gamer	Love youğŸ˜
SantaFlow 1370	BebÃ© â¤
D Molina	âœ¨â¤ï¸ğŸ™ŒğŸ»â¤ï¸âœ¨
Ellie Sena Mendes	AngelğŸ˜»
juan jose	eres la mejor Camila Te adoro
Zayn	1 view â™¥
Dulce Veliz	TE AMO
Sara Cardoso	te amo!!!
xDamngirlx	MEXICO PRESENTE ğŸ‡²ğŸ‡½ TE AMO
Polina Kadyntseva	ĞŸĞµÑ€Ğ²Ğ°Ñ!
lea momora	Ø­Ù…Ø§Ø§Ø§Ø§Ø§Ø§Ø§Ø³Ø³Ø³Ø³Ø³Ø³ ğŸ’•ğŸ’•ğŸ’•ğŸ’•ğŸ’•ğŸ’ªğŸ¾â£ï¸
Jaili Contreras	Primera love Camila
Arzu PÄ±nar YanÄ±t	please leave a heart Ä± love you so much <3
Anto Cs	HERMOSAAAAA, por Dios estÃ¡ mujer no para!â™¥ï¸ğŸ˜
Roudha Shams	Send you love camzâ¤ï¸â¤ï¸â¤ï¸â¤ï¸âœ¨âœ¨âœ¨
Thay Nassiff	Faz do Brasil?
Its me	Te amooooo no puedo creer que por pobre no fui:(
RafaÅ‚ Klimuntowski	Nice
Martha Torres	Te amooooooâ¤ï¸â¤ï¸â¤ï¸â¤ï¸
Jitu Sarkar	Big fan ğŸ˜
Francine Fegeant	Woaw ğŸ˜
Daniela Figueredo	I love you
TETS BR	Camz i love u from brazil eu te amo
CroGamingNews	17 seconds and im 1000
ARIANA JIMENEZ	First te amo Camila eres la mejor te amooo ğŸ˜
I Don't know	Reminds me of camren again
Hallo People	Early squad
ANGELA Hernandez Flores	Yes Iâ€™m early love you camila ğŸ’•ğŸ˜
Kiomi Van Dijk	LOVEE you Camila, I can't wait for the next era!!!
Burak	Omg fantasticâ¤ï¸ğŸ˜˜ğŸ˜
BelÃ©n Isla	Camila te amoo! Saludos desde PerÃºğŸ˜
Tahoora Sayyed	Second view
Assil Assil	â¤â¤â¤â¤
Elena Coyago	â¤â¤Camila âœ‹ğŸ˜¸ğŸŒ¸
Sandra isabel Perez Sanchez	Me encanta ğŸ‘ğŸ’–ğŸµğŸ’–ğŸ‘ğŸµğŸ‘ğŸ¤ğŸ¤ğŸ¤ğŸ¤
JÃºlia Duran	Mi latinaaaaağŸ˜ğŸ˜ğŸ˜ğŸ˜ğŸ˜ğŸ˜ğŸ˜âœ¨âœ¨âœ¨âœ¨âœ¨ that remixxxx ğŸ˜ğŸ˜ğŸ˜ğŸ˜â¤ï¸â¤ï¸ i need ittttt
Giulia santos	BRASILğŸ’šğŸ’šğŸ’›ğŸ’›
Ali guitariste	CamilağŸ’“ğŸ’“ğŸ¸
Ma Lak	ğŸ˜ğŸ˜ğŸ˜ğŸ˜
Alexandre Carou	Camila â¤â¤â¤â¤
THE WORLD SECRET	ğŸ˜»ğŸ˜»
nivka	Early Gang likeğŸ¤™ğŸ‘…
Sergio LÃ³pez ManjÃ³n	ya estamos esperando que vuelvas a espaÃ±a <3
Dinhah Marques	Love you meu amor â™¥ï¸â™¥ï¸â™¥ï¸
Catalina V	Demasiada hermosura junta <3
Gabbie Somebody	Here with 40 likes
Laceymai Scotney	I'm earlyy yay love from England
IvÃ¡n Rocky	I love you so much ğŸ˜
Sasha Leigh krull	CamilağŸ˜ğŸ˜ğŸ˜
Martina Silva	Primera visualizaciÃ³n
Fortnite Bratans	I love u
Fatemah Alkhateeb	â¤ï¸
Eduarda Maria	Aaaaâ¤ï¸â¤ï¸
Bon Bons	Nooo it's the last tourğŸ˜­ğŸ˜­ğŸ˜­!!!
Mahesh Kumar	Love you camila
Chiquilinduras bb	Felicidades Camila
Lizdelia Gonzalez	Heyyyy
Kim Teodosiu	ğŸ˜ŠğŸ˜ŠğŸ˜ŠğŸ˜ŠğŸ˜ŠğŸ‰ğŸ‰ğŸ‰
Rivanda Lima	Camila, te amo gostosa ... Lindo demais. â™¥ï¸ğŸ˜ğŸ‡§ğŸ‡·
Mahmoud rr	B
Ana Paola Aranda Machaca	Llegue 2da perrosss
Higor Borges	Faltou o do Brasil
Luciana Stef	I love you Camila
Trawka	Hi Camila
Pain Lendariow	Aaaaaah â¤ï¸
_mikolasjosef	LOVE IT AND IM FINALLY EARLY FOR ONCE OMG
Kaori Fukuoka	ğŸ–¤ğŸ–¤ğŸ–¤ğŸ–¤ linda
Luana Santos	LACRA MESMO LINDÃSSIMA
Valeria GarcÃ­a MalagÃ³n	Te amoâ™¡
Belinda Pedroza	Omg. Love
Lilyy SM	I love you! â¤ï¸
Jhy Rodriguez	I love you CamilağŸ˜
Hilda Alvarado	MEXICOOğŸ‡²ğŸ‡½ğŸ’™
Rocio A Ortiz	ğŸ˜ I love you ğŸ‡²ğŸ‡½
Daniela Montoro	Love u camilaaaa â™¥ï¸ğŸ’™ğŸ˜â™¥ï¸
charlie brown	Te amo camila
Miricraft j	OMG i'm screaming!!!
Leandro Sousa	BrasilğŸ‡§ğŸ‡·ğŸ‡§ğŸ‡·
Odalis Garcia	Me encantaaaa â¤â¤â¤
Yuda Martinez	camila te amooo ğŸ˜ğŸ˜ğŸ˜
Fabio Solano	Firstâ¤
nizam uddin	I LOVE YOU
KOBEE !	Iâ€™m first
Carla Roberta	MEU AMOR O BRASIL DE TE AMAAAAAAAAAAAAAAAAAAAAAAAAAAAAAA <3
Sabe de nada inocente LÃ­n HuÃ¡	â™¡_â™¡
MoonMonkey	QUEENNNN
Nandito Deluque	first coment
Dulce Dulce	Like por Havana
Sorytips	Buen viaje Camilaaaa
Willian Del Rey	Brasil ğŸ˜ğŸ˜ğŸ˜
zainab r	OMG IM CRYING I LOVE YOU CAMILAAA ğŸ’•ğŸ’•ğŸ˜˜ğŸ˜˜â¤ï¸â¤ï¸ğŸ”¥ğŸ”¥ğŸ¶ğŸ¶â¤ï¸â¤ï¸ğŸ’ƒğŸ’ƒâ¤ï¸â¤ï¸
Eleana Singer	Camila Cabello â¤â¤â¤
Valentina Rozas	por Dios hija la rompiste
Carlo Gusto	O Brasil te ama gostosa ğŸ’šğŸ’šğŸ’šğŸ‡§ğŸ‡·
Slimegirl 369	â¤ï¸â¤ï¸â¤ï¸â¤ï¸â¤ï¸â¤ï¸â¤ï¸â¤ï¸â¤ï¸â¤ï¸â¤ï¸â¤ï¸â¤ï¸â¤ï¸â¤ï¸â¤ï¸â¤ï¸â¤ï¸â¤ï¸â¤ï¸â¤ï¸â¤ï¸â¤ï¸â¤ï¸â¤ï¸â¤ï¸â¤ï¸â¤ï¸
ahsan ali	The very first viewer and liker of this video
MÃ¦stro	3
Dunia Dardmand	Crying ğŸ˜­ğŸ‘€ğŸ–¤
Adventuring time time	First
Mufasa Silva	Hermosa experiencia que me tocÃ³ vivir gracias a ti!!
ADVlogz Gaming,reactions and more!	EEEEEEEE HAII CAMILA
Vale Chan	Temprano
trvxzen. music	ğŸ˜ğŸ˜ğŸ˜
Agus Wolhein	Greattt
oriya amram	first
wip-marih	3
Muhammad Umaid	2nd viewer
Jacky GÃ³mez	Te amo â¤ï¸ğŸŒ¹
Marco Antonio De La Cruz Garzon	I love You so much
Cris B.Rom51	First comment â¤ï¸
AD Squad LIFE	I love Camila cabello
Kirsty Sliker	ğŸ’œ
Isaac Formosa	First
Alexander Sad	Primer comentario #MEXICO te queremos!ğŸ’•
Valery Irwin	OH MY GOOOD TE AMO CAMILA
Ali Alexandra	Yeaaaaaaâ¤â¤â¤â¤â¤â¤
Noah Centineo is my husbandğŸ’˜ğŸ’	â¤ğŸ”¥ 3rd â¤ğŸ”¥ğŸ’˜
Xx. Sammy .xX1	W I G
Crazypotato Art	Omg hi
Alexandra Cob pacheco	Te amo ğŸ˜ğŸ˜ğŸ˜
Nicolas Arias	Camila te amo â¤ï¸
SrÄ‘ana JokiÄ‡	Suer
Annalaura Avagliano	Sei fantasticaaa
Barbara Molina Valenzuela	YASSS MI AMORRRR
Alex Silva	El primero ğŸ˜ğŸ˜ğŸ˜ğŸ˜ğŸ˜ Brasil ğŸ‡§ğŸ‡·ğŸ‡§ğŸ‡·ğŸ‡§ğŸ‡·ğŸ‡§ğŸ‡·ğŸ‡§ğŸ‡·ğŸ‡§ğŸ‡·ğŸ‡§ğŸ‡·ğŸ‡§ğŸ‡·
Allaboutbuteras	I LOVE YOUUUUUUU
Patrycja Kozikowska	159
CelEEnaSenOo	â¤
abderrahim vlogs	1 commanter
ola	I love u cam
ONCE TWICE	ğŸ’“
Omnia Alhasani	First
Nayon Park	â¤ï¸ğŸ‘
Ambar Urrutia	Hola te amo Camila con mi ser
Itzel GonzÃ¡lez	ahuevoooğŸ‡²ğŸ‡½
EyeZ	ROMANIA!!
SACD Cd	Te amo camila ğŸ˜
Supertram Goat	Second or what ever love you camilla!!
Meet Patel	Second
Sofia Lopez	MÃ©xico? â¤ï¸â¤ï¸
patricia zavala	Loveeeee
Jennifer Rouvroy	â¤â¤â¤â¤
Sofia victoria Castro garamillo	Like me plis
Sweet Moon	Divaaaaaaâ¤ï¸â¤ï¸â¤ï¸
Jose Bayugar	Goooooood this is so good
moonlightbae	hi love you
Aziz Salehi	Love you and your Songs from Germany â¤
Maria belen love	ğŸ˜€
VÃ­ctor Manuel Gordiano	I love u Camila
Exo L	love you <3
Camzzi Jergz	WOWOWOOW... Thank you!
Rafael Andres V. Gajardo	First!! From Chile ğŸ‡¨ğŸ‡±
Salma Youssef	Ayyyyyy
L o r r a y n e P e r e s M a r t i n s	Amoooooooâ™¡
Angie Via	Queen
×× ××œ ×©×’×‘×™×™×‘	ğŸ’‹ğŸ’‹ğŸ’‹ğŸ’‹
Nayely Santos Vargas	Yey Holis
Harini Har	â¤
AnxDep	Im in love with this
Skarlett Godbold	I love you soooooooooooooooooooooooooooooooooooooooo muchâ¤ï¸â¤ï¸â¤ï¸
Rafaela Rodrigues	AIN SENHORRRRRRR
Danah Mk	Clicked so fasstttt
Mahdi Jawadi	Love you
LÎ±dy Î±rĞ¼y	Te amo!â¤ï¸
Jhondere k pc	â¤ï¸â¤ï¸â¤ï¸I love camila
Denisa Ichim	â¤â¤â¤â¤
Julia Cholajda	LOVE YOU BABY!!!
Jair Garnica	Te amoooooo
Imelda Esteban	HI CAMILA!!!!! LOVE U SO MUCH!
Fiorella Piedra Rosales	OMG
Salma Amkhao	Good
GTA GAME PRO GLITCH	Hii
Katarzyna Niscior	ğŸ˜ğŸ˜
Kenzies VlogChannel	issa mini movie !!
Bananamila 97	Yes Queen
Ava ._.	â¤â¤â¤ğŸ”¥
Ù„ÙŠÙ„Ù‰ & Ø³Ù…Ø§Ø­ TV	ğŸ˜—ğŸ˜™ğŸ˜šğŸ˜ğŸ˜˜ğŸ˜ğŸ˜˜ğŸ˜ğŸ˜˜ğŸ˜ğŸ˜˜ğŸ˜ğŸ˜˜ğŸ˜˜ğŸ˜ğŸ˜ğŸ˜ğŸ˜ğŸ˜ğŸ˜ğŸ˜ğŸ˜ğŸ˜ğŸ˜ğŸ˜ğŸ”¥ğŸ”¥
Franxesca Madeleyne	AAAAA, I LOVE YOU.
Aless !!!	Comentario 1!!!
Anto Cancino	Primera
Anne gallagher	Hi
Olivia Evans	eeekkkk
Maria  Barca	Ù‚Ù„Ø¨ÙŠ ğŸ’œğŸ’œğŸ’œ
Anissa Anissa	Second ğŸ˜±
Iza Tangieva	Secondâ¤ï¸
Ayoub Ned	ÙˆØ§Ø´ Ù…ÙˆÙ† ÙØ±Ø§Ø± Ù…Ø§Ø®ØµÙƒ ÙˆØ§Ù„Ùˆ
Benjamin Christopher	Second
gumball syfo ãƒ„	3
luisdiego perez	Te amoo
ãƒ„ Zastoid	Hi
Yukumar Rana	Second
se dirvetino com a carol souza	É¦Ñ³Ê†Ê†É‘
Javier Burgoa	Wuuuu â¤ï¸â¤ï¸â¤ï¸â¤ï¸ğŸ”¥
Kauan Araujo	Br?
Eryk Janowicz	First
Giuli Weinmeister	AAAAAAAAA
Antonio Sees All	Second
Maria Fernanda AtehortÃºa Aguirre	I love you ğŸ˜ â¤ï¸â¤ï¸
Aroobian Legend	EARLY AF
Samara G:A	owww
THE FUN MOMENTS OF MY PUPPY DANTE	First I love you CamilağŸ’–ğŸ’“ SUBSCRIBE ON MY CHANNEL PLIS SUSCRIBANSE A MI CANAL ğŸ’–ğŸ’“ğŸ‘ˆ
Nelly Orellana R.	Ayeeee
X Fancy Sessy x	omg
Jat Pacheco	Aweeebo
Gaby KAWAI!	Primera
Pratham Srivastava	1st view
Miss_Panda012	First like
Nely Barrera	Hola.
Emely Sanchez	HDJAJDHSIDBWN
Adna Jessica	ğŸ˜
VKOOK Them love	H
Eldana Yosef	1
Dariana Osuna	ğŸ˜­ğŸ˜­ğŸ˜­ğŸ˜­â¤ï¸
Nincey the hedgehog	IlysmğŸ¤§ğŸ’œğŸ’œ
NANNET ARONI	First
El perro de BTS	First!! ğŸ’•
lele __rb	â¤ï¸â¤ï¸â¤ï¸
Hannah Lucca	â¤ï¸
Peppa Pig	Furst
Sofia Ojeda	Te amo
Damaris Zambrano	Agdkvlahg
Leona Rama	I LOVE YOU
Bobbie Parker	1
celine	â¤ï¸â¤ï¸
kratek1337	Kto z polski
Camren Shipper	FirstğŸ’•
