Tomo at	MIS BEBEEEEEEES ğŸ˜
Itzel Yocelin	0:04 me dio un paro  <3
Chaze Rivera	Jaehyun in black and gold: fckin regal. ğŸ–¤
Lee Min Hwa	Lit ğŸ”¥ğŸ”¥ğŸ”¥ğŸ”¥ğŸ”¥
bad taco	um excuse me JOhnnYy
yoongismybitch	No one cheered for my boy johnny :(
ê¹€DaniellÃ¨	My irregular boys
175 cm	Teail, Doyoung, Yuta, Johnny my godsğŸ¤§ğŸ˜²ğŸ™ğŸ™ğŸ™ğŸ™ğŸ™ğŸ™ğŸ™ğŸ™
Cherry Kpop	Haechan is the most talented maknae out there
Delight	Oh my.. the thumbnail of this video is so funny BAHAHAHA
GRACIAN	Gosh Johnny! <3
è€˜å­	LOVE MARK AND TAEYOUNG
Fransheska Rosario	This the only NCT  song the i find the Mark & Taeyeon have inecesary parts like ice ice or Mark in the bigenning
ariana gomez	is better than bts
Rae	Johnny outfit: When you got a track meet at 11 a.m but a rodeo show at 6
Anshita Sharma	Why lucas is not in this song??
unnie noona	Johnny looks comfortable ğŸ™ƒğŸ™ƒğŸ˜ğŸ˜
Catgirl gamer	Why was this in my recommendations? I don't even like kpop.
G. Love 64	Have to say, the boys are slaying the stage .... again ....
Jaehyun Jung	ğŸ˜
Aleah Kaonohi	is it just me or do some of them not look comfortable
Julie Ann	*JOHNNY* ğŸ’šğŸ˜ Even tho they made him wear those pajama again
Phuong Huynh	OMG JAEHYUN STOP
Nhu Le Thi	lip and teeth :)
NCTzen 127	Mark snapped!
Don't waste your Life	Taeyong's dance moves so sharp and elegant! HIS DANCE SO ON POINT MAKES ME ENJOY HIS PERFORMANCE MORE
M24 Stilinski	Finally a nice stage and good camerawork, thank you !!
amor Ty	The black suit on TAEYONG is killing me.ohmy!
aguus	TAEIL
EXO L	mark very handsomeğŸ˜ğŸ˜
mingloveta	I like Yuta's part from 3:20 - 3:23
Jenna Vergauwen	Is it so hard to just let me breathe?
Kim-Yi Phung	HAECHAN AND TAEIL A DUO I NEVER KNEW I NEEDED
anju sailor	how is it possible than yuta is hotter than usual !?
taehyungs pearlearrings	WHO ALSO JUST CLICKED ON THIS VIDEO BECAUSE OF WINWIN
- Ì—Ì€ matisse Ì–Ì-	I WAS WAITING TO SEE JUNGWOO PERFORM IN THAT OUTFIT _THANK YOU_
Bryant Alvarez	jungwoo is way too soft!!! and is that a skirt?
Natalie	Winwin's see through shirt omg
Martina Gomez	TAN HERMOSOS MIS HIJOS
llhcm	Johnny just pulled up in his pyjama
THE CHAIR HYUNGSEOB FLIPPED TO HELL	0:45 yes Lee Donghyuck, shoot me, itâ€™s an honor
BtsNctSnsdPristinBlackpinkLoona Trash	NCT IS NO COMMENT JUST SAYING
Natalia Andrea Perez Hernandez	bisssssssh Doyoung is S H I N I N G
junhehehe	sksksk everyone looks so good ???? (as per usual ofc but they just look extra stunning on this stage ğŸŒŸ) and even though the camerawork gave me a little headache from sudden moves, Iâ€™m grateful that winwin and yuta can get screentime ! and not to mention maknae line (Donghyuck and mark) out here looking so clean so fresh ğŸ˜”
BTS' ilLEIGHirl	Os far this my fave stage performance ğŸ’ dmn I'm loving YUTA ğŸ˜­ğŸ’“
å³ç¾æ¦®Wu Mei Rong	quem sabe faz ao vivo, meus amores
Milena  Cesari	Mini taeyong ğŸ˜‚ğŸ˜‚
pinxyun	winwin â™¡
p potter	Love you all ğŸ˜
Mich Monk	Mark went from baby-face to chisled features. <3 Taeil is rocking that color and hair cut. Yuta is a scene stealer w/ that dance intensity. Taeyong, don't worry, my gaze my stray, but you're still in my <3 LOL.
Skuukzky is my Bae *â€¢*	Our giant baby Winwin ğŸ˜â¤ï¸â¤ï¸
mumi	Johnnyâ€™s pajamas lmao
Yoon Beside	Johnny â¤ï¸
Grazel Basalo	Snong nabuntis?ğŸ˜‚
Nct in the houseee	Seriously, when is Taeil going to get the screen time he deserves for his parts? Our boi is shining yet they do him so dirty
ngá»c nguyá»…n	yuta is hot
Meu VALK	when they walk down on the stair, I just say WOW!!!
Jessica Hua	when you live on winwin's screentime
no name	The outfits ğŸ˜
jin park	ğŸ’šğŸ’“
STAN NCT DREAM	*Taeilâ€™s and Haechanâ€™s voices are so damn pretty. â™¡*
Frannie Ello	winwin in the thumbnail...inkigayo knows whatâ€™s up
z c	_those outfits_
An Le	I'm confused
Meg	why does no one talking about yuta? he's extra handsome in this performance or is it just me?
gummybear	winwin with undercut tho im living
Rak N Rowl	I find Nakamoto Yuta so attracting here. ğŸ˜
TFP	This stage is STUNNING
Mai Phuong	*MARK VISUAL*
diamonds on my neck ë³´ë‹¤ ë‚´ê°€ ë¹›ë‚˜ê²Œ	DOYOUNG NEEDS TO STOP SMIRKING THIS ISNT OKAY
MNKYMNKYMNKY	wow doyoung in that intro killed me that boy be giving some looks
Miss Idk	I just got my regular album today ğŸ¤© Iâ€™m so happy
Gabi G.	Cameraman you did it well ğŸ‘ğŸ»
Breona Alexander	TaeilğŸ˜ğŸ˜ he looks perfect!
Jeno's NOSE	haechan and johnny? i feel attackedt
Kim Anh Chung	fighting
Seoyoung (Stephanie) Moon	ì´ë²ˆ ê³µë°© ì—­ëŒ€ê¸‰ã… ã… ã… ã… ë‹¤ë“¤ ë„ˆë¬´ ì˜ìƒê²¼ì–´
Juliana de Lemos	Them with the dark outfits and THOSE background lights and stuff = THIS MUST BE WHAT YOU SEE WHEN YOU ENTER HEAVEN
JiU Kim	Now they are starting to sing live. Yas! I mean I watched all the NCT units and NCT Dream is the only unit who have a live sing performance.
awila	You guys talking about HAECHAN too much. itâ€™s time to shine, my full sun â˜ºï¸â˜ºï¸â˜ºï¸
kpop youtube	Markâ¤
bunnie	So glad they performed in these outfits. Probably my fav ğŸ˜ğŸ˜ğŸ˜
ì´ì§„ê²½	ì¹´ë©”ë¼ ë„ˆë¬´ ì •ì‹ ì—†ë„¤ìš”
Teethu	donghyuck lookin like a whole snackğŸ˜
sergio wrow	Where are the vocals all I hear is backtrack.....
beaglechen	Mark thooooğŸ˜
vanillablossoms	Johnny got many screentime again, thank you SBS :') anyway, all of them look so good esp Doyoung wow
chanyeolism is my religion	mARK LEE MARRY ME!!!!!! AAAAHHHHHHHHH
Osmelys Tremont	this is ma nct
Li Ka	MARK MARK MARK MARK ğŸ™ˆğŸ™ˆ
luwoo shipper	nct stylists did a great job
I want NCT Dream to become a fix unit	This look on Haechan. Waaaa~ I'm whipped.
orange_spider	Yessss the outfits from the music video ğŸ˜ why does inkigayo have such great stages but such dizzying camerawork tho lol
ten . .	ğŸ’–ğŸ’–ğŸ’–âœ¨âœ¨âœ¨
Kpop Lover Stan	*My boyfriend is the one wearing black*
Kayla Kookie	as a haechan biased, this comment section makes me so happy
Gerald Quanico	jungwoo in a dress in an unbothered k i n g
coreyc yj	JUNGWOOSHI YOU ARE THE BEST!!! NCT YOU ARE THE BEST!!!! REGULAR HWAITING!!!!!
miru	Just like the # this is POWERFUL
ewnq2	Jungwoo skarut
ence pence	I have to say that this stage is beautiful ğŸ‘
dor462	The amount of screentime everyone got is appreciated ğŸ‘ğŸ¾ğŸ‘ğŸ¾
amÃ¡lia costa	holy jesus they did that they really put jaehyun in that shirt
Jobellyn Bas	Haechan, Yuta, Taeyong & Jaehyun. â¤ï¸
Liza Kingg	they seriously are one of the best from the new gen~ just look at their performancesğŸ”¥ğŸ”¥ğŸ”¥
sayncho jae	Esta presentaciÃ³n fue mÃ¡s que perfecta ğŸ˜» AMO TANTO LA ATENCIÃ“N QUE ESTAN RECIBIENDO, PROUD OF NCT, PROUD OF NCTZEN ğŸŒ±ğŸ’š
NCity Resident	Sm's been making them sing live for a while now ğŸ‘ğŸ‘ğŸ‘
natytadora	DeberÃ­an darle mÃ¡s lÃ­neas al de pelito rojo , es el q canta mejor , tiene una voz hermosa ğŸ˜
ellmmoo	everybody say thank you to yutas stylist
ë¡œì•„	Jungwoo â™¥ï¸
thatâ€™s not mark lee thatâ€™s marcus antoine	iâ€™m sorry but they all look so good AND MARK PLEASE STOP HAECHAN IS MY BIAS
sugary_ eggs	that thumbnail is not doing ty justice XD
winwin's carat is as big as china	0:04 *uHm eXCUSE ME MR. DOYOUNG??? YOU'RE FLAMING!! ğŸ”¥ğŸ”¥*
Isabelle TenÃ³rio	THAT WAS SO CLASSY AND SWAG AT THE SAME TIME HOW
NCT VELVET	Inkigayo's stages are always so good AND THEIR VISUALS ğŸ”¥ğŸ”¥ğŸ”¥
Marissa Elizabeth	Mark is so gorgeous
Alison Mae	HAECHAN REALLY IS GOD
nct in the house	can we talk about hyucc and his beautiful hair
Slimey Gurl	help me w they names pls i wanna stan
Natalie Xu	This cameraman deserves a rase. Inkigay camermen are awesome.
Vi Fernandes	The more I listen this song the more I like it. The performance is amazing tho (as expected from nct). ğŸ’šğŸ’šğŸ’š
AleAlavarez	*Taeyong dancing is everything for me, he is so powerful*
infires man	*haechanâ€™s curls*
Ana G	yUTA WHAT THE FUCK
markadorablee	everything about this is just perfect
Unkrtvx	Can someone please tell me their names?
cyn	Some things: their makeup ğŸ˜ Johnnyâ€™s hairstyle and earring ğŸ˜ğŸ’ and Yutaâ€™s lil loop necklace â¤ï¸
jimin ordered suga biscuits and a caramel latTAE	*haechan lookin like a whole snack damn*
Leyla Canales	I love them so much ğŸ˜ğŸ˜ğŸ˜
yiyisidora	Jungwoo finally wore this outfit i was waiting to see it ğŸ˜­
Sydney Horn	0:28
C. M.	Jungwoo with the long skirt yas work it baby
visual stan	Yuta stan fighting
voidstef	JUNGWOOOOOOOOOOOOOOOO
Hyunjin's Shirt at Idol Room.	All these comments for Haechan make me so happy.
oreosfohlife	GODDAMN YUTA LOOKIN LIKE A WHOLE ASS BUFFET
Duygu Ozyer	seriously no one talk about video quality??
Fresa con Leche.	Johnny, omg... u re so fucking gorgeous. This outfit is my favorite. I love you, guys. ğŸ’šğŸ’•
Luna Granger	Finally haechan appreciation has come!
linnylovely772 linny	Taeyong ğŸ˜­
JEISA VIEIRA	Haechan 's hair I need a selca of that
Tasmia Chowdhury	YUTA WHATCHU WEARING IM SO ATTACKED
Liyana Rabah	*sung with the tone of Marks part*  Im not ready to be wrekT But im here yet again ğŸ¤§
Starlise Jun.from.17	Twerking to this in the shower
ê¹€ê°€ìœ¤	Is it only me who thinks that Haechan looks really tired in this performance...??
Irene's Tunes	WinWin is really out here SNATCHING all these THUMBNAILS! that's ma boi
Emily Saravia Etchell	Their performances are always so visually striking
sunnyseoul	is Johnny wearing pajamas lmao
trashley ashtray	who won this week?
Victoria Angeline YÃ©pez ProaÃ±o	Yuta looks so good. I love himğŸ˜ğŸ˜ğŸ˜ğŸ’šğŸ’šğŸ˜¢
gabriela ortega	Taeil âœ¨ğŸ’˜ğŸ’˜ğŸ’˜ğŸ’˜
â€¢ Zach â€¢	Taeil looks really good with red hair
M sb	can we talk about Johnny's Pjs and Jungwoo's lace shirt also Winwin short hair looks so good on him
Lovelyz Baby Soul, The one, The legend	I canâ€™t believe so many comments are about Haechan when the cameraman barely filmed him during his parts but Yes! the king gets recognized anyways âœŠ
saori	They're so good!!!!!! ğŸ’•â™¥ï¸ğŸ’œğŸ’¥
Amritha I.	this stage is flawless. I love the setting and the outfits. just. yes. snap.
Jo Sison	I LOVE THESE OUTFITS OMGGG â™¡â™¡â™¡â™¡
Lauren Vieira	90% of the comment section is about haechannie, is this a dream?? our angel is so talented he deserves it
GRAND JURY	Stop sleeping on taeil and doyoung
MakeB.A.P GreatAgain	Yuta owns this Era
gabylolos	0:18 yuta looks like taeyon wtf
Lisa	Doyoung looking so goood
sourirebts	okay but like taeil made my best friend an nct stan so THANK YOU
GOT7 EXO NCT Aghase ExoL Nctzen	WinwinğŸ˜ğŸ˜ğŸ˜ğŸ˜ğŸ’•
Riaz Staarz	ğŸ¤£ğŸ¤£ğŸ¤£ğŸ¤£ğŸ˜»ğŸ˜»ğŸ˜»ğŸ˜»
Maria Fernanda Fuentes	solo dirÃ©: que haechan se ve hermoso con su look ğŸ˜ğŸ˜ğŸ˜ğŸ˜
Ariel O'Gwin	They are all so gorgeous but this really is Mark, Taeil, and Johnny's ERA LIKE OHMYGOD I CANT STOP STARING.
Jei SÃ¡nchez	Okay but Johnny and Taeyong OH MY GOD beautiful kings.
Susan Liu	Here's the female version of NCT 127â€™s Regular eng. Ver: https://youtu.be/64GcFMEX3bI Here's the female version of NCT 127â€™s Regular kor. Ver: https://youtu.be/570Xwbtwro0
Merel Van Poucke	I feel bad for noticing just now how great Mark's dance skills are (probably because all of them are great dancers)
Little ShaSha	They need to come to my country and see me lmaoo.  I want Nct to perform in France !
dream tofu	they are all so amazing and talented and attractive !! i love you !!
baekhee g	Mark!!
Just A Random Person	Why they gotta do Taeyong like that in the thumbnail?
Precious Winko's Winnie	WINWIN ğŸ’šğŸ˜­ğŸ˜
NCT Yae-eun	ğŸ’šğŸ’šğŸ’šğŸ’š
Sun.	HaechanğŸ˜
Hillary Dinhs	can jaehyun stop being so goddamn perfect
Herbert l'ange	damned good our handsome boys again, love them all, yeahhhhhhhhhhh !!!!!!!!!!!!!!!
byyyk	Holy shit the lyrics are so cringey
Shara Sema	My favorite live performance ğŸ’•ğŸ’•
Kawaii Yoonseok	They are so good.I'm proud of themğŸŒ±ğŸ’—
Linh Nguyá»…n	Jaehyun is becoming a sexy prince :))
cjnsjnj jmc	Yutaaaaaaaaaaaaaaaaaaaaaaaaaaaaaa<3
Sofia Sapam	I always feel Kai's vibe in Taeyong... love them both..ğŸ˜˜ğŸ˜˜ğŸ’•
vamp mood	My Boys NCT ğŸ™ŒğŸ»ğŸ˜ğŸ’–ğŸŒŸâ¤ï¸ğŸ’•ğŸ™ğŸ»
jinyoung&free	JUNGWOO IS WEARING THE SKIRT IM CRYING THIS IS PURE BEAUTY
danitza saavedra	Dos cosas hermosamente Ã‰PICAS de esta performance: el peinado de Haechan y la camisa de Winwin <3.<3 no podrÃ­a ser mÃ¡s perfecto <3
i love tea	Johnny lookin like a rich cowboy
Irina Antipins	Yuta ğŸ˜ love him so much , he is so beautiful and strong , ğŸ¤—
Gummy bears?? Teddy BearJelly.	New fan here...â¤ï¸ my eyes are tired from trying to focus on each and every member and trying to recognise their face and guessing the names...phew!!!
JMelon	This song is really their best yet! And the concept, dance, etc
Zehra M	I think Nct will arise in 2019-2020 . Their style is so unique . Maybe they will be next Exo. ğŸ˜
Safary Smith affleck	Wow amazing!! I love Nct 127  Jaehyun Oppa
JigglyChocolateman	Can we get a SM Station for Yuta because damn he's so talented
RubySalma ApazaTarqui	mi hermoso taeil te adoro eres mi todo
Yuta's my ult bias, do not bother him.	Donghyuck with curly hair= my religion. *cough * I made a mistake: Donghyuck= my religion. ğŸ’–
Soft Stan	TAEYONG LOOKS SO GOOD!!! I'M SCREAMING
Yutong Sun	Haechan finally getting recognizedğŸ‘ŒğŸ‘ŒğŸ‘Œ
Xing Xing	Handsome boy
Seo Soojin has saved us all	Oh my gOD. Yes! I think this is my favorite stage. They all look and sound so good ğŸ’š But Mister Jaehyun... there is no need to be this RUDE!
NEOSHINEE	they all look so expensive RICH KINGS
nonenally	1:58 so sassy~~ğŸ˜ğŸ˜€
Dismaler Xuá»µch	Haechanie
TheOrginalFatUnicorn	Kings are slaying , winwin bae â™¥ï¸ğŸ’œğŸ”Œ MV outfits
MaddieMoon ë§¤ë””ë¬¸!	*sexy taeil alert*
jaymi	donghyuck is seriously such a great dancer and vocalist and performer like what CANT he do omg i love himmmm
chloe' gonzales	3:00 yuta made a mistake oof
winwin's tears	winwin on the thumbnail..... i'm crying
shock thunder	ì¸ê¸°ê°€ìš”ì˜ ì•„ë“¤ ê¹€ë™ì˜ì”¨
Connie	Wow this stage is amazing from their all black outfits to the stage effects
Ohunivers	each member is glowing. i'd never get bored of watching them perform. so proud.
giovana m	haechan looks so fineğŸ˜ğŸ’“ğŸ’“
leneta	HAECHAN AND WINWINS HAIR AND AVERYTHING
Aerielle Anne Beltran	mukang prinsipe si Jaehyun OMG
bai jk	AAAAHHHğŸ˜â¤
Minh Tran Hoang	both SBS Inkigayo and SBS The Show are very love Winwin because they put him in the thumbnail  OMG! Doyoung in the beginning so fxxking hot!
cris	this performance was AMAZING. completely live, the outfits, hair styling, makeup.. DONGHYUCK. SICHENG.
Beatriz L	winwin getting screen time is all i need
moodle	I'VE BEEN WAITING FOR THESE OUTFITS  AND THE STAGE IS GORGEOUS   MOST IMPORTANTLY, NCT KILLED IT ONCE AGAIN.
Gabriela Gutierrez	it is amazing how SM or whoever produce NCT just want to put Mark and Taeyong in front, consistently, permanently and in my opinion even aggressively, so the people that watch the NCT performance just have to see them all the presentation, no breaks for the audience. Not sure why they doing this when they have 8 other talented guys and actually very well looking too. But what amaze me the most is that after watching several presentation of NCT and even when Mark is always jumping for the whole stage like a little bunny and Taeyong is trying to fullfil the order of the producers to look like the "malo" leader guy, there are other members that quietly stand just for theirselves, I am talking about Yuta for example, what a manly man, very good looking and he just do his job behind or in front, wherever he has to be, he just slay the presentation. I can talk about Haechan that his moves in all coreographys are very sync, and of course the main vocalist Taeil and Doyoung that never dissapoint in their short opportunities to sing. How ever I insist in Yuta, he doesn't even try to got the attention but just watch the guy and you can see how he shines.
Akash Singh	Ty in the house
tael moon	Taeil is a cutie. I'm so proud of him, he always does his best for every performance. ğŸ’–
Paige Forth Lestrange	Now that I think of it, this is literally the first comeback as NCT 127 where they almost have the same outfits every stage!!! Lololooool, I remember those times when we were still petitioning to SM artists on Firetruck and Limitless era bcs they got one of the weirdest outfits of all. ğŸ˜‚ğŸ˜‚ğŸ˜‚   LOOK AT THEM NOW! THE GLOWUP AND THE UPGRADE OF THE CENTURY. ğŸ‰ğŸ˜‚
minao â€¢	these were the outfits ive been waiting for they all looked so good
Isabella Newman	are we gonna ignore the fact that jungwoo is wearing his skirt thing today???  he's so hot
EXO Suho Lay	NCT 127!! So cool!!! LIT AF ğŸ”¥
S A F W A oth.	Babies ğŸ’šğŸ’šğŸ’š you did so well
rap vernonie	For everytime Yuta e Jaehyun appear at the same time i had a heart attack
BLACKINK BTS	Poor my taeyong the tumblr LMAO i
Dian	Looking fly as always, gosh these people
sooyoung choi	do you know why i dont see nct on m countdownm
markhyuck loves	HAECHAN OMG SO DANGEROUS! BB I LOVE YOU!
Jilian Andrea Romero	Taeyong
Chelsea	Mark looks so good in every performance HeLP
BÃ¡rbara Aravena Faray	I think taeyong is not okey :( he is out ? I dont know :(((
æ—äº®å›	ä¸­æœ¬æ‚ å¤ªçš„æ·±Vï¼Œæˆ‘å…§å¿ƒçš„é‡ç¸æ­£åœ¨ç”¦é†’ğŸ˜
Artemis Lingersaker	YUTAğŸ˜ğŸ˜ğŸ˜ğŸ˜
stan pristin	whoever styled donghyuckâ€™s hair PLEASE keep doing it.
rawan al	what is nama the boy with red hair?!
Clarice Xu	Ok but who gave Johnny pajamas ğŸ˜‚ğŸ‘Œ
*All* *Black*	How to not be attacked by their visuals .... I mean *killsuals*
TVT Vlogs	OMG JOHNNY !!!!!!! OMG OMG OMG !!!!
Listen Boy	You who ever put yuta in that tanned shirt ğŸ˜­ğŸ˜­ Fck Iâ€™m emo
Riana Park	wHY TF MARK LOOK LIKE A KID BUT HE'S SO HOT AND FIERCE HERE
Joice Butterfly	Haechan with curly hairğŸ’›ğŸ’›ğŸ’›
Open your rice and appreciate Lee Donghyuck	HAECHAN
Jamie Sanoy	Markâ€™s hair should be illegal
Hello olleH	I SERIOUSLY LOVE TAEILâ€™S DANCE MOVE THAT HE DOES
Red Vagilidad	What is up with Taeyong on the thumbnail. ğŸ˜‚ğŸ˜‚
Michael Gentiles	Mark is the epitome of PERFECTION
Okay But Listen	Thanks for putting winwin in the thumbnail. Appreciate it
Being multi is GREAT #ComebacksAreNoJoke	Can we talk about the *AESTHETICS*
laura x	the way they went down the stairs so fast is really funny dskjjddj
Marie G	can someone please point out to me haechan's waist? /eye emoji/
æ¥Šç©	é…·ï¼O(âˆ©_âˆ©)O
Booming system Up uh	This is the best stage for Regular come back
Muted Muffin	OHHH HEK! JUNGWOO IS WEARING THAT SKIRT AND IT TURNS ME ON. HEACHAN'S PERM AND EYELINER IS A MASTERPIECE!!!!
park SLAYoung aka JOYsus	THEM VISUALS ARE JUST GETTING BETTER AND BETTER EVERY SINGLE DAY!!! ALSO DO YOU HEAR HOW THEY SOUNDED MORE STABLE WITH THOSE ON-POINT MOVEMENTS????? WOWOWOWWW
Joie Lastimosa	Ma boys haechan and taeyong bringin back kpop's iconic eyeliner game
Ya-ha	They look so good todayyyy
Shraddha Laghate	Can we discuss how awesome MARK is here?? Damn, the energy!!! Gosh, I love him!
Win Win	Did they win?
SungHanMin	Jaehyun ğŸ˜ğŸ˜ğŸ˜ğŸ˜ğŸ˜ğŸ˜ğŸ˜ğŸ˜ğŸ˜ğŸ˜ğŸ˜ğŸ˜ğŸ˜ğŸ˜ğŸ˜ğŸ˜ğŸ˜ğŸ˜ğŸ˜ğŸ˜ğŸ˜ğŸ˜ğŸ˜ğŸ˜ğŸ˜ğŸ˜ğŸ˜ğŸ˜ğŸ˜ğŸ˜ğŸ˜ğŸ˜ğŸ˜ğŸ˜ğŸ˜ğŸ˜ğŸ˜ğŸ˜ğŸ˜ğŸ˜ğŸ˜ğŸ˜ğŸ˜ğŸ˜ğŸ˜ğŸ˜ğŸ˜ğŸ˜ğŸ˜ğŸ˜ğŸ˜ğŸ˜ğŸ˜ğŸ˜ğŸ˜ğŸ˜ğŸ˜ğŸ˜ğŸ˜ğŸ˜ğŸ˜ğŸ˜ğŸ˜ğŸ˜ğŸ˜ğŸ˜ğŸ˜ğŸ˜ğŸ˜ğŸ˜ğŸ˜ğŸ˜ğŸ˜ğŸ˜ğŸ˜ğŸ˜ Calmate por favor ğŸ˜‚ğŸ˜˜ğŸ˜˜ğŸ˜˜ğŸ˜˜ğŸ˜˜ğŸ˜˜ğŸ˜˜ğŸ˜˜
Karin Cerovsek	can we talk about haechan's hair? bc damn, he looks amazing
Karthee 2493	Alll...black
Tracy gdrgn	ğŸ’šğŸ’šğŸ’šğŸ’šğŸ’šğŸ’šğŸ’šğŸ’šğŸ’šğŸ’š
Lyn'n	JAEHYUN <3
Dilankin 2001	HAECHANâ¤ï¸ğŸ˜»ğŸ™ŒğŸ”¥ğŸ”¥
jaebuddies	THEIR VOICES! THEIR OUTFITS! THEIR HAIRSTYLES! THE MAKEUP! A BITCH IS L I V I N G
Shimx Zap	ğŸ˜‹ğŸ˜ğŸ˜ğŸ˜ğŸ˜
Code 7	Couldnt they find a better screenshot of taeyong for the thumbnail? Istg ğŸ˜‚
trixdapix1	they did a great job! camera work was a little iffy though (but why are so many people talking about haechans waist? was it because of the v cut of his top?)
jeojanged by ongseongwoo	MOST OF THE TOP COMMENTS ARE ABOUT DONGHYUCK? I'M IN
Jemina ReneÃ©	I could never get tired of this song
long ass ride	this stage is beautiful
Jess	I love to see a lot of comments is for Haechan. this boy slayed this performance ğŸ’š
Megan	I'm in LOVE with Haechan's eyeliner/shadow
kass	MarkğŸ’–
Jelliexinxs	bueno, estÃ¡ de mÃ¡s decir que AME ESTA PRESENTACIÃ“N !!!!!
nanami haroka	Ù†ÙŠØºØ§ ØªØ±Ø¬Ù…Ù‡ Ø¹Ø±Ø¨ÙŠÙ‡
Nutty Nuttaporn	I want Jungwoo focus of this performance.
ã…ã……ã…ë²¨	winwin on the thumbnail ughhh ğŸ’•ğŸ’¦
Supichaya Daprasong	Jungwoo with pleated skirt + dynamic dance moves ğŸ’šğŸ’šğŸ’šğŸ’šğŸ’šğŸ’šğŸ’šğŸ’šğŸ’šğŸ’š
Franca P	These guys are so talented!! Luv luv
Rh. Official	Woow
A. tiny girl87	their performances are always on point despite their crazy scheduals ğŸ˜ğŸ‘ğŸ»ğŸ’š NCT127 deserve more wins â˜¹ğŸ’š we support you guys â˜¹ğŸ’šğŸŒ±
Josie Darley	Can we appreciate Winwinâ€™s new hair?
Rei Cardenas	Winwin is our angel ğŸ’šğŸŒ±
I STAN SMent	Did they choreograph the way they went down the stairs??? Cause I think they did ğŸ˜‚
é‚“å¯æ¬£	We stan kings with stable vocals
Worldwide Handsome	THE OUTFITS THE OUTFITS THE OUTFITS THE OUTFITS THE OUTFITS THE OUTFITS THE OUTFITS THE OUTFITS THE OUTFITS THE OUTFITS
í¬ì—°	finally get to see jungwoo's kilt ğŸ˜ğŸ˜‰
Zoe Baur	Ugh Kings ğŸ’š
Panda Playz	someone needs to get them better mics or like turn their mic sound up like seriously there were so many parts where i can BARELY  hear them over the fans
Yuki Haru	my fav outfits..esp winwin and jungwoo
Mei flor	A child is in there ranks? Winwin are you really an adult????
Ice Saborriboon	I really luv Taeil's angelic voice !
TÃ¢m KhÃ¡nh	0:16 I feel attached :)
Kuma min	Im loving the attention Haechan is getting, my haechan praise kink is being fed well
Be quiet don't cry	THIS PERFORMANCE IS SO GOOD   AND DONGHYUCK PLEASE omg
Nightcore Sweetheart	Why are their movements so stiff? Usually when someone dances its kinda like a flow but this just looks stiff i dont know why
n c t	ahh this stage was so perfect ğŸ’š
wife baekhyun's	Sbs promotes winwin better than sm
Reem Almostafa	Haechan my love â¤ï¸
WinWin Win	Baby WinWin â¤ï¸â¤ï¸ğŸ’•
PandaBeer21	Taeyong has such bedroom eyes....Goodness gracious babe stop making my heart acheâ¤ï¸ğŸ˜
Háº¡nh Pháº¡m	OMG Mark Lee is a murderer :((( He killed me with his sexy
Painted Pepsi	That thumbnail ğŸ˜‚
PhÆ°Æ¡ng Quá»³nh	Máº·c vÃ¡y sao anh tÃ´i nháº£y Ä‘Ã¢y =))
johnny johnny yes daddy	Thank God, Johhny exist.  ğŸ˜
empathy L-1485	*The VISUALS*
Pauline Javellana	I'm living for Jungwoo's outfit!
sehun wifeu	they are so swag â¤
kaibaek exo	Winwin taking the spotlight he really deserves such a precious little tiny baby arghhh
Greengreen Grasseu	Nct 127 looking like a whole snackeu
Rimmy	Wow this stage looks so cool and *can we talk about the cheers for Haechan when he did his part at **1:33** â™¡*
luckyy 6	1:03 who's he?
4everwithoutu	the cameraman has done such a good job
Larissa Oliveira	KINGS ğŸ‘‘â¤
meiqi	kings
Zeusâ€™ mood	wow this performance was sooo goood!!!
myqwertymind	I'm so sorry Inkigayo but your camera works made me throw up literally, I felt dizzy and can't stand watching the performance anymore.. I'm so sorry NCT, I love to watch Taeyong so badly but the camera don't stay still even just for few seconds, it was like every 2 seconds it changes to another phase.. (+_+)
K-pop Bunny	No one can forget Taeil and his hair.
JL Lee	*haechan*
alfiani nurlina	it's just few seconds into this performance and doyoung is already trying to murder me with his ethereal beauty
ALESSANDRA LOISE PINEDA	reading the comments like. OMG! I LIKE DONGHYUCK TOO!  He's so beautiful! and his voice is so unique! I like their hairstyle and outfit in this performance!
EDEN	THE STAGE IS BEAUTIFUL AND SO IS THIS PERFORMANCE
bangtanvelvet BtsandRvmakemequestioneverything	I'm a newby but that dude with the small waist can GET IT
Fran PR	Never be so early before i think, less the 800 views is the 5:40 a.m  in my country the outfits & stage so good
Iâ€™m at war with myself.	The one in black is my bias and I love him so much ğŸ˜
lj	0:36 He does this move and I forget to breathe. ğŸ˜³
Anne ELF	Kings
Itâ€™s been a while Mi	I swear I am a loyal Haechan ,Taeyong and Jaehyun stan but daam they all look so damn good.
Yevheniia Bashtannik	Every time I can hear but not see Haechan, a blood vessel pops somewhere in my brain
Katrin Kang Daniel Fangirl	ğŸ˜ƒğŸ˜ƒğŸ˜ƒğŸ’—ğŸ’—ğŸ’—âœŒï¸âœŒâœŒâœŒâ­ï¸â­ï¸â­ï¸ğŸŒŸâ­ï¸ğŸŒŸâ­ï¸ğŸŒŸâ­ï¸ğŸŒŸâ­ï¸ğŸŒŸâ­ï¸ğŸ’–ğŸ’–ğŸ’–ğŸŒˆğŸŒˆğŸ’–ğŸ’–ğŸ’–ğŸ’–
Jamila Phillips	Really!!! They did great but come on, Taeil barely had any screenshots when it was his parts. He is an amazing talented member too !! ğŸ˜«ğŸ˜«ğŸ˜«ğŸ˜«
nouf	Doyoung omg so handsome!!!
Bus Bil	Winwin  is new hair??!!!!ğŸ¤©
Amitha Alex	Theyâ€™re 18th??? WTF
minh phuong	Jungwoo. Ahh!
Chaengmunk's Acorn	Sorry but what was jungwoo wearing ?
erika alexandra	*THE SUPERIOR OUTFITS!!*
Joey Nardo	*mARK LEE*
Cute Potato	Donghyuck having the time of his life
Shania Rosslyn	THIS STAGE OMG ğŸ‘ğŸ‘ğŸ‘  JUNGWOO WEARING THE LEGENDARY OUTFIT ğŸ‘ğŸ‘ğŸ‘ EVERYTHING IS JUST ğŸ‘ğŸ‘ğŸ‘
Haechan's Drop The Beat	The cameraman is in love with Donghyuck and I don't blame them
gabi ocampos	Jaehyun ğŸ˜ğŸ˜
seulgi xxx	DO NOT SLEEP ON HAECHAN Y'ALL HE'S HERE TO CARRY THE WHOLE FCKIN INDUSTRY ON HIS SHOULDERS.     YOU'RE DOING SO GREAT DONGHYUCK SWEETIE I'M SO PROUD OF YOU!!!ğŸ’›ğŸ’›ğŸ’›  Fullsunâ˜€ï¸ğŸ’›
JÃºlia Valero Bartual	Amazing intro!
Fighting Haeyadwae	Scream more K-Czennies pleaseğŸ˜‚
ko ko bop ;;	kings
Mark your Fullsun	Haechan just being beautiful himself and I found myself crying because of it ??  This performance so far is the best although i still prefer mb* camera works. They really deserve the whole world.
Articles Faith	thank you love it so much
sitra	HAECHAN IS THAT BITCH
Helen Styles	Everybody say thank you Doyoung!!!
Shou Ryn	I can't believe visual Haechan, vocal Haechan, dancer Haechan...He is so talened, SM push him a lot, pls!!
Edyta p.	I'm not satisfied with Yuta's screen time.
obviously mayen	i thought we left the skirts in firetruck era lol
KimTae world	Doyoung ğŸ˜ğŸ’¯
starfox	doyoung looks like a whole snack
Ana Margarida	EVERYONE HERE IS COMMENTING ABOUT DONGHYUCK AND THAT'S EXACTLY WHAT HE DESERVES
Katherine Caylao	Doyoung's stare gets me everytime ğŸ’˜ğŸ’˜ğŸ’˜
jikooks eternity	step on me nakamoto yuta
melow shawol	Regular is Winwin's era â¤â¤â¤
BTS Popularity WithAverageTalent	Woah Mark is sooo handsome
I just want some milk	Baby boi Jungwoo wearing lace and skirt at the same time ğŸ˜
Soft for Winwin	Winwin babe what a whole snack
ELF *NCTZEN	TaeilğŸ’ JohnnyğŸ’ TaeyongğŸ’ YutağŸ’ DoyoungğŸ’ JaehyunğŸ’ WinwinğŸ’ JungwooğŸ’ MarkğŸ’ HaechanğŸ’ NCT127ğŸ‘‘
mama peach	Damn. What highlights were they usin??
Minh Pháº¡m Tuá»‡	Why is winwin and doyoung having new hair :)) is NCT U having a comeback soon lol ??
Ã‰lÃ©onore_ Junia	What is Jungwoo wearing ? ğŸ˜†
VIDA H	*WHEN YOU NEED FANCAM EVEN FOR ENCORE STAGES !*  Can't they Just fixed the camera somewhere ?! I swear that will be a better camera work!
Shiva Tokimiya	I'm asking this myself for days: Who's voice is leading, starting from 3:20 ?
Phinda Wande	yuta des winwin sarange
i am the cypher to your taehyung	It looks like Jungwoo is wearing a khamis ğŸ˜‚  Also YUTA YOU HOTTIE They all hot
ê°€ì¦ˆì•„ë°”ë°¤ë°”	ëª»ìƒê¹€
Mich Mich	man thisnis their best stage icmksmxid istg how can a group have full visuals and talents god im nxksmxi
Hang Nguyen	This stage is so beautifullll
saida learner	Why I can't get enough of them!!!??? The Question of the century that's my Quesso!
Study With Sakura	NCT ARE KILLING ME
bo xian	ahhh donghyuck OWNS that hairstyle im telling you his stylist needs a pay rise
Tiara Ko	did we win???
Yutaâ€™s.	Taeil gets me every time when he does his high note
ThÆ°Æ¡ng Chuyn Chew	please support my boys â¤ï¸ğŸ’•
WeAreSoOne	This song make only for taeyong and mark??????? other members is backup!!!???????
K- POP	OMG HAECHAN 0:45, 1:35, 2:29 ğŸ˜±ğŸ”¥ğŸ˜±ğŸ”¥ğŸ˜±ğŸ”¥ğŸ˜±ğŸ”¥ğŸ˜±ğŸ”¥ğŸ˜±
Jichu Orallo	TaeilğŸ’šğŸ’šğŸ’š
yutas puta	JUNGWOO *skaret*
Inseong993 Fanta	I thought they were nominated for 1st place???????
miracle 1	Doyoung at the beginningğŸ’™
Zehra Nur Yanar	0:45 sHOot mE
shakira asakura	they use their mv outfit...  taeyong, jaehyun and yuta slayed it...
haruna suzuki	THE INTRO THO
polabear	Is it even legal to look this good ???
doyoungie's collarbone is my life	Still shocked at doyoung in the beginning
Daisy June	WINWIN IS THAT A DAB? 2:20
Aboihi Kawilam	Just when we thought the bad outfit era was over we see Jungwoo wearing skirt and Johnny is that a pyjama you're wearing. I still love them ğŸ’š
Kaila Angel Pagtakhan	DONGHYUCK YOU DIDN'T HAVE TO GO ALL OUT LIKE THAT
N 127	OMG Yuta looks superior.  ğŸ”¥ğŸ”¥ğŸ”¥
Princy Paonam	Taeyong's visual is killing me!!
Burcu	Why Jungwoo why?
Ranilo Autida	They all look so fine. â™¥
ChÃ¢u Tuyáº¿t Nhi	Jaehyun look so good ğŸ˜˜ğŸ˜˜ğŸ˜˜ğŸ˜˜â¤ï¸â¤ï¸â¤ï¸
Amberle Rains	winwin getting the screentime he deserves
MaraAnnelisa	My boy Winwin out there yesssss
Winter Moon	But... Taeyong's face in the thumbnail... ğŸ˜‚ğŸ˜‚ğŸ˜‚
ee_jae dkh	I'm always here to watch each and every promotions so happy to see them perform each timeğŸ’šğŸ’š
EyesOnU	Taeyong kill me ğŸ˜­ğŸ’—ğŸ’—ğŸ’— his voice is amazing
Haechan is comming to saves kpop industry	Haechan beauty is unreal... Even his waist is beautiful, it looks just like my arm OMG i can crai rite now :(((
Anne Mikee Diao	Taeyong so handsome ğŸ˜»
Soph stans ikon and stray kids	Winwin getting screen time actually happened that's a miracle ngl Yuta lookin fly af go my nct 127 bias
gray ooh	J A E H Y U N
Jungkooksgoldenrottenstrongegg itsme	ğŸ’šğŸ’šğŸ’š
Candy C	Yuta is so hot my heart says "I'm scalding!!!"
Nikki 1233	Mark ğŸ˜ğŸ˜ğŸ˜
Im.meeks P394	Jaehyun look soooooooo good in that outfit. But it'll be better if he has TY's shoes. Excellent performance btw! ğŸ‘
jess !	Doyoung really never gives me a second to BREATHE huh
SNOOPWOO	Jungwoo finally wore that outfit. I've been waiting
æ¥è‡ªæ¢¦å¹»å²›çš„å›½ç‹æ˜€æ˜€	This video quality went 360p to 720p when Taeil came in front of the camera
thamtham93	Mark nailed this comebackğŸ’šğŸ’šğŸ’š
Mary Wainer	YOU DONT EVEN NEED AN MR REMOVED TO KNOW THAT THEYRE SINGING LIVE AND KILLING IT
Haneen KF	YUTA ğŸ”¥ğŸ”¥
Nanna Larsen	Johnny and Yuta this stageğŸ‘€
à¸ªà¸¸à¸ à¸±à¸—à¸£ à¸ˆà¸±à¸™à¸—à¸£à¹Œà¹à¸à¹‰à¸§	Great job boys
NCT nians	*is it okay to fall in love again & again??*
LALISARAH	all those commentd about Donghyuck makes me happyâ™¡
Aneta TrudiÄovÃ¡	Their live singing has improved so much! I'm proud of them, you can tell they work really hard to get better every comeback. Also, hope that Mark and Haechan get to rest soon
Kijuto Pháº¡m	MARKKKKK IS BREAKING HANDSOMEEEEEEEE
Cinderella Laygo	Did haechan change his hairstyle?
ArmyBlinkMonbebe Igot7Once	Caralho ZÃ© buceta, amei â¤ï¸â¤ï¸â¤ï¸
Full Sun	Haechanie is so talented, mom now i can die in peace , i saw an angel
NCT The next king of kpop	CAN WE TALK ABOUT JAEHYUN??! HE IS REALLY THAT SEXY PRINCE ğŸ˜
v95	*thank u for giving winwin actual screentime*
Elionore Cajucom	Taeyong looks weird in the thumbnail
Nursel3355 Kocmen	Mark
Steph	Haechanâ€™s hair is so cute
jungwoo's skorut	EVERYBODY SAY THANK YOU LEE DONGHYUCK
xxxtaeyong	THAT TAEWIN THUMBNAIL
Janet Huang	jungwoo with that outfit!!!! slayyyyyy
j. -	all these comments abt my boy hyuck make me so happy. he finally gets the love he deserves :')
audrey m	yuta is looking goood with that shirt
BLANCHE	Listening to NCT every day is a *regular* for me
KING_NCT NCT is the BOSS	KING NCT
Stefy Hadjistoqnova	Snack = Haechan, Voice = Haechan, smooth moves = Haechan ğŸ”¥â™¥ï¸ğŸ’‹ğŸ˜Š
Diana Curtolo	I'm really curious to know who screamed GO! with such power at 3:20 ğŸ˜‚
Alennah	HAECHAN IS A BLESSING!!! AGREE??
imblackcha	I love inkigayo because inkigayo love doyoung. ğŸ˜†ğŸ˜†ğŸ˜†ğŸ˜†
Ğ²Î±Ğ²Ñƒ Ğ²Ï…Ğ¸	*IM SO CLEAN SO FRESH AFTER HEARING HAECHAN'S VOICE BLESS HIM*
lil mint	I wanna thank their make up artist for all these glorious eye make up and can we talk about their live performance ğŸ’š
Augustus K	Ugh Taeil not getting enough screen time for his parts......
Thanh NhÃ n	PerfectğŸ’šğŸ’šğŸ’š
Kristel Gab	90% comments is for HaechanğŸ˜ Donghyuck being so talented and slayed this performance
Otaku Scrub	Haechan be stealing the stage.
turbotastico edna.lalala	aaah are so beautiful, I love them all
Crystel Selidio	My gawd! If this is the clothes they wear in ama. I dont know anymore, they look so freaking hot
V. Pao. Z	0:04 God he looks so surreal! Fact #1: Doyoung's look is dangerous.
itian bkhyn	My top 2 bias in the thumbnail ğŸ˜ğŸ˜ğŸ˜
Alliyah Loves kpop	Damn...18?!
cisly myr	Haechan visual is no joke
åŒ…å­	Jungwooooo
gowon loona	jaehyunğŸ˜
Elli	the best outfits !ğŸ’¯
Xah Nah Park	Jungwoo wearing a skirt finallllllllly!!!
Feliks Wilkowski	BUT can we talk about Haechan's beautiful tiny waist?
Anh Tran	Taeyong is so hot ğŸ˜.I love their outfit
Alicja Lis	Everybody say thank you Lee Donghyuck for carrying entire music industry on your back!
mark tuan can't relate	Yes i love that music shows are putting winwin as a thumbnail. Theyre finally recognising his visuals.
Eku	*H A E C H A N*
nadiindaeyo	*my bias is safe, i love the one in black*
Alex C.	P O W E R F U L. ğŸ’•ğŸ’•ğŸ’• and that outfits are my FAVE. THANK YOU HEAVEN FOR GIVING NCT TO ME ğŸ’šğŸ’šğŸ’š and BUB HAECHAN. ğŸ’•ğŸ’•ğŸ’•ğŸ’•ğŸ’•ğŸ’•ğŸ’•ğŸ’•ğŸ’•ğŸ’•ğŸ’•ğŸ’•ğŸ’•ğŸ’•ğŸ’•ğŸ’•ğŸ’•ğŸ’•ğŸ’•ğŸ’•ğŸ’•ğŸ’•ğŸ’•ğŸ’•ğŸ’•ğŸ’•ğŸ’•ğŸ’•ğŸ’•ğŸ’•ğŸ’•
evil joker	Awesome performance ğŸ’šğŸ’šğŸ’šğŸ’šğŸ’šğŸ’šğŸ’šğŸ’šğŸ’šğŸ’š
gyungyunminmin	Mark baby you look so amazing
