Adoma Geraldine	I love you ğŸ˜‹ğŸ˜ğŸ˜˜ but l have a guy Hahaha see you again nice song
Sam Oppong R.	Sarkodie want's Strongman to be recognized for his unprecedented talent and not for his influence as Sarkodie. That is how much the King believes in him. Many people arguing how he doesn't take him to the shows he is booked for and so forth. He doesn't want him to be living in his shadows.
Ã’baapÃ  Stinzy	too muchğŸ”¥ğŸ”¥
Kibab Kibab	waooo my man ğŸ˜ğŸ˜ğŸ˜ğŸ˜ğŸ˜keep it upâ¤â¤â¤ğŸ‘ğŸ‘ğŸ‘ğŸ‘ğŸ‘ğŸ‘ğŸ‘ğŸ‘ğŸ‘
In Phared	word play punch I'm killing it ğŸ”¥ğŸ”¥ğŸ”¥
Shykid the Barber	There is no king anywhere but you are my king
Frank Duku	Far better than the wack rapper have call your king, higher than your highest, he's scared of your prowess so he bought u just to keep u low key, BREAK OUT BRO
Shatta Kobi	U get bars
Dj king	THIS IS STRAIGHT ğŸ”¥ğŸ”¥ ğŸ”¥ğŸ‘ŒğŸ¾ğŸ‡¬ğŸ‡­ . Can you please drop some mixtapes... Rap attack ğŸ™ŒğŸ¿
Rich Horla	you good
solomonk alorgo	Wow!
k d	Y3 m3 m3 Nyum na 3sa, me ky3n bentua  .. lol.. punches
Adwabour kwabena ababio	We need it on Spotify please!
Skab Burner	am i the only who ain't tire of watching this genius?  #WateAnaa #STNEP
evans kwarteng	burn it for me strongman
Nana Kwame	Where is the sarkcess music logo? I hope he is still with sark
thatboy kalusha	Real rap.... Strongman is a Genius.....Thatboy kalusha
Jerry Opoku	strongman you are the dupe i like u very much. Afoakwa frm dubai
Mili.	France love uuuuu
David Owusu	Soi posted on facebook last three day â€œ this is my best rap song so far in 2018â€ and still believe so!!  Strongee are good by try and add some nice hooks or choruses to your subsequent tracks. You must blow with this huge talent!  -davido-
K. Maali	No flow this year can be comparedğŸ’¥
Mishael Agyei-Boamah	Okay, no hating here. He wanted to sound clever but ended up missing the target a lot of the time with his punches 1. Girl no y3 tall koraa; boys y3 blackberry, boys y3 bold. ( I get trying to be witty with 'Blackberry Bold' talk but that meant nothing) 2. "Girl no ne heel/hill na egu tantra" is utterly meaningless. (by the way make nobody tell me sey e bi Tantra Hill reference) 3. Nana, wo police mma ky3n Central. Another clueless bar ( Don't tell me he is referring to Central Police) 4. Na me nyini no mehu s3 )bra y3 b4. Charley )bra y3 bonah. (This one was close enough to its intended meaning 'B4Bonah' but still didn't land) 5. Ma me dough ah, na w'aso ay3 s3 Bajie was clever. Very hilarious bar. Good bar! 6. Wo a run girls anya diarrhea could've been put better Track could've been better without all these cringey bars. Like Sark said, 'Wo taa punch pii aah, you sound immature.' Okay song, could've been better. No hate though. Still proud of how far he has come
Kwame Ever	ğŸ’¯
Belinda Esiape	Most Ghanaian will never understand rap music and music in general. To them it's just entertainment. What's this rap about? I finished listening without grabbing the concept and it lacks serious content... U guys better stop the sugar quoting and praises and be real for once. Let's push our artists to do more because what they put out there is a reflection of who we are.. Sark don't want to see this guy make it he keeps him low so he can ride above. Sark y3 p3s3 minko menya, abr) and always wants to see only him on top. Couldn't he have helped strongman make better music with all his resources? This get 1 out of 10 for me..... the boys are not learning at all u guys stop bumping ur heads, analyze things before u comment pls the allo praises are too much.
daddy Kei	Ghana is rap n a dancehall country in africa!......... Very important,no competitor in Africa!
alfred birikorang	Y is strongman not sign ed to sarkcess music?..I want to know cos dis song does not show any sarkcess
Chris Lokko	Charley! Mad Massive lyrics!
Eugene kwabena	This guy spits fire ğŸ”¥
Mickey Mike Jnr	The next Sarkodie in Ghana
Anim Bismark	wow  hitup likes for the hit
Abdul Muaz	Thats a rap
Ernest Gyamfi	None stop
Regina Kakari	Asuwer say he is better than his master
Sinbad Samanie	Shihâœ”ï¸ğŸ‡¬ğŸ‡­ğŸŒ¹ğŸ’“
Michael Antwi	30 ppl need to smoke herb. why disliking this rap..?
rakim jnr	Dude has to make more songs to storm the industry, he's too good ğŸ”¥ğŸ’¯
Rich King	Strongman dat spoil thereâœŒ
MATIA MULUMBA MUKASA	i hope sark will bless this one
Prince Essien	Rap burner ğŸ’ª
Kwame Breezy	ğŸ
Lartey Reindolph	Young coming art aaaaa wonkoaa girls five  3te  one area. That verse dey kill me waaaaaaaaaa!!!!!!!!!! U large strong Geee ........
Kofi Yeboah	Omg this guy is out of this world. Whaaaaaaaaaaaat! What a rap!
Raul Boozen	Masa rush for another record label
Silas Kwame  Addo	ğŸ”¥ğŸ”¥ğŸ”¥ğŸ”¥ğŸ”¥ğŸ”¥ğŸ”¥ğŸ”¥ğŸ”¥ğŸ”¥ğŸ”¥ğŸ”¥ğŸ”¥ğŸ”¥faaaaaaaaak
Benjamin Boateng	So Strongman released a single without sarkcess music as the label clearly displayed in the video...it wasn't released under sarkcess music channel here on YouTube... He didn't come on stage with Sark.... Is something happening in the camp of Sarkcess??
Deborah Eastham	I'm not envying but its painful you signed for sarkodie...That guy cannot manage you strong gee...damn it!!!!
Prince Annan	Vgma better wake up and listen
BOAKYE KWAME	Who else noticed there wasn't #Sarkcess logo i think he's out of tha label.  Dope Bars Family #Oseikrom To Tha World
Yayah Zhorri Ibee	Sark is wasting this boy
MrTargee	How can I super like this MicBuners . Someone help me....
Aisha Amarh	Tunnneeeee ğŸ”¥ğŸ”¥ğŸ”¥ğŸ”¥ğŸ”¥ğŸ”¥
mercy akuffo	u de best my nigga. u know something, try and rap some little more english rap in your songs to break barriers. Trust me u are dope
Emmanuel Boadu	Big ups to the strong G burner.. who else hit like before listening? I know you all donâ€™t disappoint.. this is fire !!!!
Abubakar Lukman	Heâ€™s Good than sark tbh
Believers tv	If you believe hit ğŸ‘
Latif Mumuni	RAP MONSTER
Clyde Davies	This guys punch lines are funny ğŸ˜‚ but his flow is everything tho. Big up strong man. London like!
Daniel Hanson	Under Beatz
Jaedon Skyro	Bad,Bad,BadğŸ’¥ğŸ‘ğŸ”¥ğŸ”¥
Randy Ofori Gyimah	Dang I can't stop listening to this masterpieceğŸ”¥ğŸ”¥ğŸ”¥ğŸ”¥ğŸ”¥
Enae Berg	Your ears make like bagyie  - From Journey to the West   Piggy bank   - Susu Box Paa bobo time cocoa vibe - Old Glory .. Wodi Sisimuden be face  - Good sex alone can't help you keep your lady.. Running girls enya Diarrhea - Running Stomach  B4 (Bonah) Artist - Bonah in twi also means Life is Tricky or Not easy Man dema Rasta  - Preaching Peace
Maabena Nyarko	Coming from the best camp, sarkcess music u do all.
Jturnupthamc YG	â­â­â­â­â­ğŸ™ŒBlessUp #SB
Burrdmizzle	this is what Strongman needs to get back to the BARS no need to dumb it down for dummies the track'sğŸ”¥ğŸ”¥ğŸ”¥
Ted Royce	ğŸ”¥ğŸ”¥ğŸ”¥ğŸ”¥ğŸ”¥ğŸ”¥ğŸ”¥ğŸ”¥
Quophi Atta	Now u spitting sense.....................
Mikky Flinkz	Ghanaians what else do you want from this guy to do again before you will recognize him,fuck Too good to be call good
Fred Yeboah	hard knock.....flow
G-S Dance TV	He is strong in rapğŸ¶that is why heâ€™s call StrongManğŸ’ªğŸ¾ğŸ’ªğŸ¾ like, give ağŸ‘ğŸ¾ up for the YOUNG-STRONG RAPPER  ğŸ”¥ğŸ‡¬ğŸ‡­ğŸ”¥ğŸ‘ŒğŸ½.
Nicki Morgan	Sick beat ğŸ”¥ğŸ”¥ğŸ”¥ğŸ”¥ğŸ”¥
AJ Kwarteng	Eiiii Awurade, akoa rappo ahhhh ğŸ”¥ğŸ”¥ğŸ”¥
Sheikh Wahn Mbaba	From another universe,ğŸ’¯ğŸ‘ğŸ‘ğŸ”¥ğŸ”¥,,,Strong Geeee the mic ğŸ¤ burner ğŸ”¥,,punches ğŸ’¯ğŸ”¥
Mantse Niini	This guy really need a good record Label sharp. ğŸ”¥ğŸ”¥ğŸ”¥
Prince Teddy	i cant even stop repeating to this track strong gee big ups
PalmerGh Online	KINDLY SUBSCRIBE to our YOUTUBE CHANNEL for more updateshttps://www.youtube.com/channel/UCta5jNSglWmPEZ1V1ixSaWQ
Kwabena Fosu	Dope
Patrick Addaetawiah	y3de me nnwom na 3sa...
Kelly Dre	Omg. Raw Talent. Clean cut
Solomon Dadazie	This is rap ğŸ”¥ ğŸ”¥ ğŸ”¥ ğŸ”¥.  #Words
hudu abdallah	ğŸ¤¯ğŸ¤¯ğŸ˜³ğŸ˜³ğŸ”¥ğŸ”¥ğŸš¨ğŸš¨
Rek Essien	Who has noticed that,,anytime tee phlow Drops,strongman Drops,,by the way love you all,,
israel nanevie	ğŸ”¥ ğŸ”¥ dope
TRACE GAHANA	Dhope rap. Love it ba waste of quality video..ğŸ˜´
kwasi's vision	Best rapper hands down
Lady B	Dope
King Madingo	Strongman has better punchlines than Sarkodie. PERIOD!
Alonye Herod	Mic burner 4real
ike aboagye	Woy3 Hero wati
Oposty Gh	Strongman u are too good  Herrrr  Donâ€™t even know wat to say
African Invasion	i dont understand one thing here oh but why did strongman all of a sudden post on this channel .....i taught this should have been on the team channel ...like how lynx and stuff do their own ,,,even davido squad demma ow n type ....hmmmmmmmmm
Stephen Asante	King sark ur boi be dhope
Braimah Mahamah	I pray dat you will get one hit bi dat will shake de whole country like Shatta hits. Likes if u agreee
Biggi Gets Fit	I hope u are on a different record label now
Sarfo Bismark	he is now recovering from his senses ....
Vivian Love	That place where he spoke the GA language and was like â€œ Baji33â€ Damn ğŸ˜†ğŸ˜†ğŸ˜†
Gbadago Wonder	ğŸ”¥ğŸ”¥ğŸ”¥ğŸ”¥ğŸ”¥ğŸ”¥ğŸ”¥ğŸ”¥ğŸ”¥
Augustine Boadu	eish rap nie  bro goodğŸ˜
Emmanuel Danquah	low bar man...
Omenztizzel Samuel	This is rapp
Kusi Emmanuel	crazy rap Bro you 10 much
KANVIKT finaswyne	akoa wc lyrics ğŸ”¥ğŸ”¥ğŸ”¥ğŸ”¥ğŸ”¥ğŸ”¥ğŸ”¥
Baffour Joseph	ei strongee,wano mu nsem!
DEE TRAID	Fire ğŸ”¥ ğŸ”¥ ğŸ”¥
Osei Sarfo Sekyere	Strong Man seriously I dont like rap music but when I hear your rap it gets into my brains, you are too much, you are the mehn.
abukari nuhuman	Sarkodie will not help until no more relevant in the industry. This guy needs international collaborations to blow up
FLIX-ZY GH	Comments reader am here ğŸ‘¨â€ğŸ’»ğŸ‘¨â€ğŸ’»ğŸ‘¨â€ğŸ’» I will never stop following you #strongman
Kudakwashe Magava	Talented famğŸ”¥
Exceeding King	Strong man forward ğŸŒğŸ”ŠğŸ”¥
Samuel Asante	Champion
Rich Lord Prince	What the fuckkkkk .. Strong ğŸ’ª You Nailed it..@richlords6
samuel aboagye	Meeeeeennnnn... damn . This is real man. Strong man charle. Dope.
daclow Wilson	Fucking good!
Angela  Oppong -Gyan	StrongmanğŸ˜
Kofi Quaye	U are tooooo good please leave sark and do ur thing ğŸ‘Œ
fred osei kwame	You spoil inside!!
BEN BADY	Ghana boy
IM A KING I DONT WORK	*one oÒ“ Ñ‚Ğ½e Ğ²eÑ•Ñ‚ rapperÑ• alÎ¹ve*
Boateng Daniel	Too much GğŸ’¯ğŸ”¥ğŸ”¥ğŸ”¥ğŸ”¥
odi sika	ğŸ”¥ğŸ”¥ğŸ”¥ğŸ”¥ğŸ•µğŸ•µ
SPANKY TV	SOO SERIOUS  FANTASTIC
joe keche	dis real rap. u be strong ampa
Limanat Asante	ğŸ”¥ğŸ”¥ğŸ”¥
George Oduro	â€œThen times no P4, y3de life to SEESAWâ€ ğŸ˜‚ #Facts ğŸ”¥ğŸ”¥ğŸ”¥ğŸ’¯ğŸ’¯ğŸ’¯
Nana Yaw	Long live sarkcess music
julius wordie	Heavy artillery rap! Don't mess with  the Strong-G
Abdul Razak Jibril	fire
ArtSlave254 Official	Amazing Sana
Acquah Harrison	hmm
Andrew Cobbinah	Strongman you are too much
Chapters Asare	hitt Nice talk strongman on point and sensible
Aboagyewaa Augustina	From Ivory Coast ğŸ‡¨ğŸ‡®,I'm feeling this tune.......but you guys should stop  those things like "sarkodie is sitting on this guy's career" ğŸ˜¶ğŸ˜¶ğŸ˜¶
Asare Boamah	ğŸŒğŸŒ¹ğŸ’¦ğŸ”¥
Ashtrake Anny	man u wayyyyy DOPE
OXTONY_GH	SARKODIE PAVE THE WAY LETS NOT FORGET THAT BUT THIS GUY RIGHT HERE IS EXTREMELY GOOD AND THE BIGGEST BETTER RAPPER OF TODAY .
Precious Ayivor	#RapğŸ’¥ğŸ’¥ğŸ’¥ğŸ§ ğŸ§ 
Gongonman Coolman	heeeeeeeeeerh. eish rap paaaa?
AndroFiles Channel	First time Ive really enjoyed the rap tho I've always liked his style.. The wordplay has really improved.. Punches are always intact but still #Team_PhlowğŸ˜‚
Dennis Korankye	Sark never made a mistakeğŸ˜˜ğŸ˜ he knows the future...
Hajj Huzaif	ğŸ”¥ğŸ”¥ğŸ”¥
Ishmael mensah sark	10.00 k next week. More Dan mic burner heeerrrr
Jerry Amoah	Girls yi p3 teddy bear, enti my padi y3 sturdy there, nawan sei wu piggy baenkğŸ™‡ğŸ‘ğŸ™Œâš¡âš¡âš¡
Nana Kwesi	No disrespect but this guy shouldnâ€™t have gone under Sark! Diamond in the dust ! Let the guy out ffs!
Kwadwo Ofosu	Kweeee what a rap Chaley you be too much
Stanley Nyarko Appiah	Bad.! Bad.! Bad.! You're the rap and not a rapper.. burn the microphone.
Kunta Abeiku	Jack,just leave Sarkcess music and build your own brandğŸ”¥ğŸ”¥ Only if you will take it,it will help you
GhNow Tv	Strongman got bars
Adamti Dzirasah	The rapper.... you dope
Jacob Dolphine	This guy eerh. I don't know why he is still not hitting. Sark need to help him waaaa
Malode 10	ğŸ”¥ğŸ”¥ğŸ”¥ strongman
Kweku Ankomah	Waow.. Genius I beg we want all your music records on Apple music.. It's very difficult getting them in a catalog, I will be very grateful
Jose Cobby Dream house	Dope  rap But  where is  the sarkcess  music label in this  video
eryckjeep	Why the needless comparison. All he need is your support so just share and like for him to get more views.
jonathan afriyie	sarks vice president
ID Show	This guy is dope aswear but the truth is once.. Sark sign this guy to step on his competition. He shouldn't have been on sarknation record. I hope and wish he bring a colourful  feathers next year
Edward Mcloving	The 14 people that disliked this is sick . This shit goes ğŸ”¥ğŸ”¥ğŸ”¥
Maxwell Osei	ğŸğŸğŸ
Edem Augustine	His punch lines so good StrongMan u the best in Africa ğŸ‘‘ğŸ”¥ğŸ”¥
WJP Degas	Straight fire, if only it was in englishğŸ”¥ğŸ”¥ğŸ”¥ğŸ”¥ğŸ”¥ğŸ”¥
Gilly Nti	Wo ni sika wo si adowi ba... is he dissing MDK..?
Augustine Ackamowu	Seriously serious Omg
Osagyefo Tv	ğŸ”¥ğŸ”¥ğŸ”¥ğŸ”¥ğŸ”¥ğŸ”¥
Emmanuel Amankwaa	fire fire fire
Yaw Billy	too strong..WtF
Franc_dinero	Hands down the best rap song of 2018 ğŸ”¥ğŸ”¥
lindalove love	Strongman kill itğŸ‘ŠğŸ’ªğŸ”¥
George Kordie	De guy dey rap but he is not mature enough.. He raps raw.. I listen to him within 15secs then am fed up with his rap .he keeps repeating himself in different words. He should spice it up a bit.. The one way rap I too much.. It will be very hard for him to break borders with this kind of rap..
Wireless TV Ghana	Good
Star-Line Studios	ğŸ™Œ
Zidiin Issah	In my opinion, his Better than sakordie
Afrolead Media	This is lit ğŸ”¥ğŸ”¥I almost thought you gave up on rap ! U gotta put lot of this fire out strongman !
Desmond Ternor	U punch medikal...u go hear from him...Amgbeyonkontrol Yaa pono take your greetings though
IMMA PHELPS	Great lines mahhhmnnnnn
screen5	Please if you know the names of the *13* idiots who disliked this video, write their names down ğŸ˜¡ğŸ˜¡ğŸ˜¡ğŸ˜¡ğŸ˜¡
Agonadehyie Nhyiraba Kwadwowusu	masa diz is rap,,,ghanaian musicians to the world *Agonadehyie* *Nhyiraba* *Kwadwowusu*
Bopak Bopak	All he needed was a lil hook to this amazing rap to blow more minds.. #strong
Spicy Bolero	ğŸ”¥ğŸ”¥ğŸ”¥ğŸ”¥ğŸ”¥ğŸ”¥
StÃ¸nÎµ KÎ›LLIGĞ¯Î›FF	O.M.G ğŸ”¥ğŸ”¥ğŸ”¥ğŸ™ŒğŸ™ŒğŸ™Œ
kisses gh	Strong gee...dope
Nick Fizzy	Better than Sarkodie ğŸ‘ğŸ½
yeboah obiri	Strong we the kezie guys is advising you OK sark go kill ur brilliant yooo see how you dey throw it has even affected him cus he can withstand u if he like he for try.
Nate Souljah	Straight from his auditions to now! I been loving this guys flow!!
yyy ooo	ğŸ”¥ğŸ”¥ğŸ”¥ğŸ”¥ğŸ”¥ğŸ”¥ğŸ”¥
Slim PaCc	Strongman ğŸ”¥ğŸ”¥ğŸ”¥ğŸ”¥ğŸ’¯
ato kwamena	I can save your videos offline, monetize your account
Nana Kojo	Mic burner ğŸ”¥ğŸ”¥ğŸ”¥
Jackmoro Nation	ğŸ”¥ ğŸ”¥ ğŸ”¥
Kweku Mensah Sika	Strong Man on the Mic ## Kweku Mensah Sika
Stephen Masel	I repeat saaa
Salim Mohammed	Chaiiii keep it up bro you are too much STNG
Opoku Ebenezer	Strongman more ğŸ”¥ğŸ”¥ğŸ”¥ğŸ”¥ğŸ”¥ğŸ”¥
Ghana Baal	This wack  rapper needs to be schooled by Chimny crane
Godfred Achido	This is rap waooooooooooooo I'm just seeing next Sarkodie in Ghana big up
Sarfo Ernest	The monster is on fire ğŸ”¥Good bars by all standard ğŸ’¯
Torfik Abdulai	Ooh u came at the wrong time...where is hammer?  this is one of his artist...reminds me of Edem  and co dema times
Rexford Mensah	Paa Bobo mu time na y3d3 cocoa twa mpoağŸ˜ğŸ˜
Pax Well	Are sure that strong gee still rep sarkcess
Richie Hill	What A Talent,chale guys watchout for our big thing Ghana,I present you Strongman BurnerğŸ‡¬ğŸ‡­âœ”âœ”âœ”âœ”âœ”
TraPPsta	Strongest. ğŸ™ŒğŸ¾ğŸ¤ğŸ¾âœŒğŸ¾ğŸ‘ŒğŸ¾ğŸ¥ğŸºğŸ·ğŸ¤
Kwabena Haroon	FireğŸ”¥ğŸ”¥ğŸ”¥ğŸ”¥ğŸ”¥ğŸ”¥
Frank Amankwah	RapGodğŸ”¥ğŸ”¥ğŸ”¥
till casket	Why is he not showing his talent to the world? Strongman we don't just need 1 BANGER and keep us waiting but just give us more bangers
Bernardo saturdayborn Mireal	Herrrr Strongman Burner be too much #BERNARDO
Faris Bill	i alws feel proud to say u re a Phobian.... #Micburner
Ohene Yaw	I bow to your Greatness Champ ,This is Rap,Who heard that "B4bonah"line
thomas kesmo	This is a mixture of flowkin and sark.
Yaw Mireku	ğŸ”¥ğŸ”¥ğŸ”¥This is Strongmann
Happy Koko	ğŸ”¥ğŸ”¥ğŸ”¥ğŸ”¥
Young Becks	SICKKKKğŸ”¥i feel like 2:32 was too shorts ğŸ”¥ğŸ”¥
Kyere Afia Jacqueline	WOW  STRONGMAN. ğŸ‘ğŸ‘ğŸ‘ğŸ‘.
Dee lings	Abowa Bowa . Ma rap eeee  ma aban gye ho lampo
Davis Dedhope	HE IS BACK!!!ğŸ”¥ğŸ”¥ğŸ”¥ğŸ”¥...I TOLD YOU SO ğŸ‘ŠğŸ¾ğŸ‘ŠğŸ¾ğŸ‘ŠğŸ¾
Amina Alhassan	Dhope
Mubarak Issah	The mic burnerğŸ”¥ğŸ”¥ğŸ”¥ğŸ”¥ğŸ”¥
Alangadwoa Alangadwoa	Strongman u the bestğŸ”¥ğŸ”¥ğŸ”¥ğŸ”¥ğŸ”¥ğŸ”¥ğŸ”¥
papa gageo	Big ups to u bro!
solomon Bawuah	Undefined ampağŸ”¥ğŸ”¥ğŸ”¥ğŸ”¥ğŸ”¥ğŸ”¥ğŸ”¥
Lloyd Tetteh	This guy is something else mehn!!!!!! Beast mood paaaa oooooo. Strongman this is too dope mehnğŸ”¥ğŸ”¥ğŸ”¥ğŸ”¥
Enock Allotey	Strongman burner the MONSTER
Joseph Kwadwo Asare	Baddest
Shaddy B	ğŸ”¥ğŸ”¥ğŸ”¥ğŸ”¥
Pele Ahubley	You make Sarkodie distroy your career.
Hadi Mohammed	Chymny crane said it, strong gee raps better than Sark now but my worry is that he only raps in twi. If u want the world to recognise you pls try blending it with English wai.
Dave	Sark And strong King ğŸ‘‘ of Rap Gh.... Akoa nkyen ne wura de3
Sperm Dealer	That B4Bonah line tho.....a lot of people didn't catch that.
bernard boateng Akuamoah	Too much man... this guy ....wow
Boadi Ken	Honestly sarkodie knew dis boy was gonna take over the rap game thus y he signed him  I'm in the Bronx and still wants to sign him from sark like soccer transfer cuz this boy full of lyrics
princess Fatima	Strongee keep it up. Full support âœŒï¸âœŒï¸âœŒï¸ğŸ˜ğŸ˜
King kwakudro the supplier	Still a banger ğŸ”¥
Ben Asmah	dopest
Gabriel Gyimah	Put MDK on the remix boss... you den him de3 anka 3b3y3 bloody. Sick punchesğŸ”¥ğŸ”¥ğŸ”¥ğŸ™ŒğŸ™ŒğŸ˜‚
Randy Opoku	No size
larry izzy	My Arab friend had to ask "Who's that?"  It's a lit
jersi jones jnr	y3digi wo flow 3ch3n miner ..dope
Antwi Eric	T. I AMASS forever!!!!!!!!!
Candy Man	Dis  guy is good.
Smith success	This guy punches always get me laughing any like for me
Mbaeng Paul	Heerrr
Kojo kojo	Too much
ThisisGH TV	#DOWNLOAD AUDIO: https://thisisgh.com/strongman-undefined-prod-unda-beatz-audiovideo/
El Hajj Abdulai	Our artiste from SarkNation ,where dey demma own label ğŸ¤—ğŸ¤—ğŸ¤—
Quansah Ebenezer	You're deep Strong G..DhopeâœŒâœŒ
Daniel Quansah	nice instrumental and great delivery
Peter Kwakwa	ğŸ”¥ğŸ”¥ğŸ”¥ğŸ”¥ğŸ”¥ğŸ”¥ğŸ”¥ğŸ”¥ğŸ‘ŒğŸ’¯ğŸ‡¬ğŸ‡­ğŸ‡¬ğŸ‡­ğŸ‡¬ğŸ‡­
Frimpong Augustine	Eei fire paaaaaaaaaaaaaa
Small Djaba	Herrrr good ponchlines ğŸ”¥ğŸ”¥ğŸ”¥ğŸ‡¬ğŸ‡­ğŸŒ
atobrah emmanuel	Y3de me rap na 3sa menky3n b3ntoa.. Who heard that.. This guy be serious
Evans Osei	Strongeeeeeeeeee
Amazing World	Whereâ€™s SarkCess Music Logo??? Hmmmm Iâ€™m just asking ohğŸ¤·ğŸ½â€â™‚ï¸ğŸ¤·ğŸ½â€â™‚ï¸ğŸ¤·ğŸ½â€â™‚ï¸ğŸ¤¦ğŸ½â€â™‚ï¸ğŸ¤¦ğŸ½â€â™‚ï¸ğŸ¤¦ğŸ½â€â™‚ï¸ . The song de3 ebi dhope . Classic ğŸ”¥ğŸ”¥ğŸ”¥ğŸ”¥ğŸ”¥
tukay kay	MHADDDDDDDDD  DE MIC BURNER ğŸ‘ŒğŸ‘ŒâœŒâœŒâœŒğŸ”ğŸ”ğŸ”ğŸ”ğŸ”¥ğŸ”¥ğŸ”¥
King Jahblex	Skyy Gh Chill out Strong G... Coz u do all
á¥á¦á¾ fáªá¥sháªá sá¢áªá’á†áªá	This is fayağŸ”¥ğŸ‡¬ğŸ‡­ğŸ”¥ğŸ‡¬ğŸ‡­ğŸ”¥ğŸ‡¬ğŸ‡­ğŸ”¥ğŸ‡¬ğŸ‡­
Nharnhar Yhaw Sarkodie	ğŸ”¥ ğŸ”¥ ğŸ”¥ ğŸ”¥ ğŸ”¥
Asonaba Kwabrafoso Obuasi	Pure and raw rap. Oseikrom rappers ano ate. Asonaba Kwabrafoso Obuasi.
lifestyle Gh	ğŸ”¥ğŸ”¥ğŸ”¥ğŸ”¥ğŸ”¥ğŸ”¥ğŸ”¥ team Sarkeses ğŸ‘‘ğŸ‘‘ğŸ‘‘ğŸ‘‘ğŸ‘‘ğŸ‘‘ğŸ”¥ğŸ”¥ğŸ”¥ğŸ”¥ğŸ”¥
Kwabena Ebow	Sarkodie is blocking yr shine don't be  underground
benard bonsu	Sark can't help you, he will seat on you.
Oscar Fiifi	@strongman: This is what Im talking about! Craziest verses on craziest beats especially danceable tunes. DJs of all sorts will play and hype a danceable tune song with crazy rap. Sark climbed up after his Baby and Lay Away hit songs which all had crazy raps and sick beats. You got our hearts just catch a feet to dance more. Its a showbiz and the world is expecting more. We love the hip hop but we got to dance as well.
Daniel Grant	The mic burna
ANKRAH ELVIS	Chale ğŸ”¥ğŸ”¥ğŸ”¥ğŸ”¥ğŸ”¥ğŸ”¥ğŸ”¥
Justice Brown	Sark second ğŸ”¥ğŸ”¥ğŸ”¥ğŸ…
Dennis Amponsah	eiiiiii chaley rap paa nie  toooo much strong gee.
john atta	This guy be better pass sark but abi u know life no fair
Eric Shakra	Masa you are too much eiii play back play back
Anthony Gyau	Sizeless ğŸ”¥ğŸ‡¬ğŸ‡­ğŸ’ğŸ¤©
Rock Majeed	Best rapper  Upcoming legend
daroyalmusic	strongest man! power
Daniel blessing	Allah Wattiii young king *BigUp*
R&B MULTIMEDIA	sick boy forever
ibrahima Toure	OMG, Strongman too dhop
Starbwoy Junior	Same old vibe x style
Theophilus Boateng	Strongee the mic burner
Dee Tutu Burner	Fire ğŸ”¥
JJ Dwumfour	i have a question here, did he split ways with sarkcess,? if not then why is this video uploaded on his private youtube channel and not the labels channel, and since when did this begin ? i loved the raps tho. MONSTROUS.
Isaac Kwabena Ayi	Wow that's rapper, fantastic rap music ğŸ¶ğŸ¼ğŸ¤ğŸ·ğŸ¹
Big Boi	Dope bro
Steve Wilson	The mic is burnt indeed ğŸ˜¯ğŸ˜¯ğŸ˜®ğŸ˜®ğŸ˜±ğŸ’ªğŸ¿ğŸ™Œ
Koranteng G Prince	ğŸ™Œ Strong
mobutu mobutu	Iiiiish  I canâ€™t stand the heat ğŸ”¥ğŸ”¥ğŸ”¥ğŸ”¥
Rapha kwadwo	Too much ğŸ”¥ğŸ”¥ğŸ”¥ğŸ”¥
Owusu Bright	This guy is Dope
Kwasi Vincent	Strongman is dope ğŸ”¥ğŸ”¥
Adepa Vera	ğŸ”¥ğŸ”¥ğŸ”¥ğŸ”¥ğŸ”¥ğŸ”¥ğŸ”¥ğŸ”¥ğŸ”¥ğŸ”¥ğŸ”¥ğŸ”¥ğŸ”¥ğŸ”¥ğŸ”¥ğŸ”¥ğŸ”¥ğŸ”¥ğŸ”¥ğŸ”¥ğŸ”¥ğŸ”¥ğŸ”¥
seyram kulewosi	Strongman is on anoda level...
Fredick Anquandah	Strong gee
Richard Oduro	This is the guy u hate to love. Bars after bars, carefully nitted wordplay
Romeo Aduful	Mad mad mad
shadrack Osei-Fosu	Heeeeeeeeerrrrre.....Goodness. StrongGee
Obeng Friday	if kingSark didn't sign u then it will be his best mistake ever #Strongman the bunner #Sarksces music
Music Lover CJ	MaadlinkUp ğŸ”¥ğŸ”¥BARS ON BARS
Young Billionaire	agbenaaa.... no more debates... best after the king (SARK)
michael ameyaw	Charly this is ğŸ”¥ğŸ”¥ğŸ”¥
Ebenezer Boafo	More ğŸ”¥ğŸ”¥ğŸ”¥ğŸ”¥ğŸ”¥ğŸ”¥ğŸ”¥ğŸ”¥ğŸ”¥.... Chale one day feature Awal Mohammed then keep the ğŸ”¥ğŸ”¥ğŸ”¥ğŸ”¥ burning
Osei Kwadwo Francis	strongman I see  your monster l like itğŸ’¥ğŸ’¥ğŸ’¥ğŸ¤ğŸ¤ğŸ¤ kwadwo citizen
ohemaa palman	waiting for your track everyday and anytime....dopest
Anthony Bassaw	Rap!!!
clinton frimpong	You do all strongman
Miggy & Joseph	ğŸ”¥ğŸ”¥ğŸ”¥ğŸ”¥ğŸ”¥ğŸ”¥ğŸ”¥ğŸ”¥ğŸ”¥ğŸ”¥ğŸ”¥
Augustine Adjei	Strong Gee!!!!! Masa you bi dope. You got talent. God is gonna raise you up. Keep it up. Lovely...... na wo ate anaaa.... wo goro me ho a....wob3kc mad ooooo
Augustine Bonah	Future king
Jonathan Oduro	Strong gee You are too good God bless You
Kofi Dogbe	Best
Anthony Manitana	Nyc 1
Ebenezer Ngoah	More respect my man #TORONTO
Emmanuel Baidoo	this is some good stuff... I enjoyed it.. but in gh if u do rap without a catchy chorus, after one week, Ghanaians stop listening to it... you and teephlow are very talented but u re not blowing cos Ghanaians love to dance... your song with Kuame Eugene was a hit bcos there was a catchy chorus and that is what sells in the gh market .... I dont mind listening to this tune all day, cos I love rap.. I mean I really do love rap music... but how many ppl will listen to that all day? they will move on to the next danceable tune right after ... you are a better rapper than medikal.. but do u know what medikal does better? he comes up with some hook that will get anyone singing along and that is what u need to do strongee
Amissah Legend	Hahahahahahah FireğŸ”¥ğŸ”¥ğŸ”¥ğŸ”¥ğŸ”¥ğŸ”¥ğŸ”¥ğŸ”¥ğŸ”¥ğŸ”¥ğŸ”¥ğŸ”¥ğŸ”¥ğŸ”¥ğŸ”¥ğŸ”¥
Paul Philips	Sark for push this guy instead of Ghana 2pac ooooo
Rough Coin	Wate anaa
prince nsiah	Dope ğŸ”¥
BornBilli	Strong be Double TroubleğŸ”¥ğŸ”¥ğŸ”¥ğŸ”¥
TRVPHOUSE MUSIC	Strongman u toooooo much.....next RAP KINGğŸ‘‘ğŸ‘‘ğŸ‘‘ğŸ’¯ğŸ’¯ğŸ’¯ğŸ’¯ğŸ’¯ğŸ’¯ğŸ’¯ğŸ’¯ğŸ’¯ğŸ’¯ğŸ’¯â­â­â­â­â­â­â­â­â­
Hope Network	Always on point
Dave Nyarko	The Truly #Undefined Strongman BurnerğŸ™ŒğŸ™ŒğŸ”¥ğŸ”¥âœŒï¸ #NawaatianaağŸ’ªâ¤ï¸ğŸ’ªğŸ’ª
LA Vodka	This guy is pretty good...Kwaku you are too much but you ain't never gonna compare him to sark coz sark has passed this level before
African Money Gang	Dope ğŸ”¥ğŸ”¥ğŸ”¥ğŸ™Œ yâ€™all check us out https://youtu.be/fLzFu6iaaHg
Charles boateng	nice one bros
John Nyarko	Charlie the guy is a beast. Super litğŸ”¥ğŸ”¥ğŸ”¥
DeCheys Amponsah	Best Rapper in Ghana atm
Alexander Amissah	underated
Chop Box-Q3	Omg ğŸ”¥ğŸ”¥ğŸ”¥ğŸ”¥ğŸ”¥ So who are those ğŸ¤¬ğŸ’s & ğŸâ€™s that disliked this dope talent. I rebuke you guys in the name of Yesu
PHILIP EGYIR	This guy know dressing ooo.... If you ever schooled  in ucc... Tap the like buttom. PHILIP EGYIR
Benjamin Nature	Future Grammy award winner
Collins Asiamah	No chorus we breaking the law, â¤â¤â¤â¤â¤â¤â¤â¤â¤ğŸ‘¹
Clinton Appiah	The guy is good strong geeee
Krizz Krozz	Like father like son....well done bro...
Im Jay	This niggar never disappoint #Lit
Abdullah Bamba	My question is why you didn't  reply that fuckin ass hole who diss king sark..
Oscar Abandewor	Got all the rap  element
Hall	The mic burners mheeern
HAIL KINGPOB	You need a good record label.
Coldrick Danso	Lapaz Toyota m3mb3sei me vibe
Emmanuel Nti Boateng	Leave Sark nation cause they are sleeping on your career move to SM
Kwame Boamah	Eiii this is there strongman we know
Qwesi Pee	strongman #pampii_rap
lawrence bennyson	mame doe na waso ayes3 s3 Bagiye ( the movie journey to the west guy) ...lol
Lucifa TrobooGhai	Finally something from Naa SeiğŸ’¯ğŸ”¥ğŸ’¥  #Lucifa
Ahmed Sayuti	This is serious rap ...more fire
Samuel Dwamena Mensah	STRONG EMPIRE ğŸ™‹â€â™‚ï¸ğŸ‘‘
Efia Serwaa	ğŸ”¥ ğŸ”¥ğŸ”¥ğŸ”¥ğŸ”¥ğŸ”¥ğŸ”¥ğŸ”¥ğŸ”¥
amo ababio morrison	Dopeeeeeee.
Maputu Dordunoo	Rap burner
Nana Quame Klopp	Eii you still say somebody dey Ghana wey better pass Strongman
Scurry Harm	RapğŸ”¥
Michael Gyamfi	That's my man StrongGeeğŸ”¥ğŸ”¥ğŸ”¥ğŸ’¯
Paul Dwomor	Na waate anaa, ampa rapa bia nihoa osen woğŸ”¥ğŸ”¥ğŸ”¥ğŸ”¥
iray mcRoy	Y3de me ndwom na 3sa, me ndwom 3ky3n b3ntua... Wow.
Michael Ann	This dude rap more than sark,why did he stood so low to signed under sarkcess.Sark can't help him
Boakye Agyeman	ğŸ”¥ğŸ”¥ğŸ”¥ğŸ”¥ğŸ”¥ğŸ”¥ğŸ”¥ğŸ”¥ğŸ”¥ğŸ”¥ğŸ”¥ğŸ”¥ğŸ‘ğŸ½
henry walker	You dey raaaaaaappâ¤ğŸ˜©
ADUANABA films	Much love
Isaac Agyenim Boateng	Anytime your track dey come end, then edey bash me,,,,God should protect you strongman...wo y3 fly mpo sene bird. haha
Rexford Owusu Baah	I swear king sark wrote dis rap eeiii
Kwame Teddy Forever	Herrr
NanaKing Sark	Allah Strongman no size,ğŸ‘ğŸ‘ğŸ‘ğŸ‘ğŸ‘ğŸ‘ğŸ‘
Styl Jee	Can't stop listening...sarkteam
Kwe Ku	Strong man,sark knew u before he signed u....sark* even fear u!!!
De Ray	StrongGeezy...Damn! This is ğŸ”¥ğŸ”¥ğŸ”¥ğŸ”¥ğŸ”¥ğŸ”¥
bis mark	Daamnnn PunchğŸ‘ŠğŸ¿ upon PunchğŸ‘ŠğŸ¿ upon Punch ğŸ‘ŠğŸ¿.. no wonder them call u Strongman. U throw punches like Tyson ğŸ’ªğŸ¿
franky Curtis	Strongman ğŸ‘‘ğŸ”¥ğŸ¤˜ğŸ§
Benjamin Quaye	Herrrrrrr, BAD!!!!!!!!
Kwabena Kobby	Herrrrrrrrrrrr strongeeeeeeee, this guy b dope
Lewis Ata Bandoh	Strong this what i use to check u oo the delivery go higher wo flow no akye me s3 frytol
Felix Boakye Asare	Me nyom kyÉ›n bÉ›ntoa..... Herh...
TYGA WILLIAMS ENTERTAINMENT	Kwaku wo flow yi de3 3firi asikyirem oo...What a sweet...ğŸ‘ğŸ”¥ğŸ”¥ğŸ”¥ğŸ”ŠğŸ”ŠğŸ”ŠğŸ‘‘ğŸ‘‘!!!
BERNARD AGGREY	kwaku ur sunshine will come over the rain. mad love from SUAME
Donkor Evans	if u love strongee, let me c ur hands up
Asante Shadrack	Rap y3 bet Chale kye makyi
Abubakar Inusah	ğŸ”¥fire works .... Strong
Highest Kamaali	Strongman on the mic yooo  WateAnaa
Y impact	akuaa yi dissi miaa nka mi sii ni life....
Lydia Taylor	â¤â¤â¤â¤ğŸ˜ğŸ˜ğŸ˜ğŸ˜
HÃ¤mzÃ¤ BÅ«rqmÄn	Let me see your ğŸ‘if you rep #Strong_empire ğŸ’ª undefined ğŸ”¥ğŸ”¥ğŸ”¥
WHAT'S NEW	This guy b mall we will crown ğŸ‘‘u next of kingğŸ‘‘ (Africa rap god)
Evans Amoh Twumasi	This guy dey rap Bars upon bars ğŸ”¥ğŸ”¥ğŸ”¥ğŸ”¥ğŸ”¥ğŸ”¥ğŸ”¥ğŸ”¥
Nana Adomako	I will say it again strong gee youâ€™re next Sarkodie trust me ğŸ™Œ
Ilias Ibrahim	ğŸ”¥ğŸ”¥ğŸ”¥ğŸ”¥ğŸ”¥ğŸ”¥ğŸ”¥ğŸ”¥
Official Louis Tv	Ponchlines Strong Empire ğŸ’¯ âš¡ Subscribe to OFFICIAL LOUIS TV for your entertainment Vibs ğŸ“¸
DEE DON Ghana	Who is from kumasi
Frim Guy	ğŸ”¥ğŸ”¥ğŸ”¥ğŸ”¥ğŸ”¥ğŸ”¥
Eddy Ray	Dope from d bossâœ”
Klinsman Brefo	Bars on Bars ğŸ”¥ ğŸ”¥ ğŸ”¥
Prince Opoku	monster
kwaku forkuo	Fire ...
Nana Adom Jr.	Damn!
SUPERSTV GH	chale to be frank this guy dey rap pass king sark
Kwadwo Lartey	This is what scares Sark.
asamoah evans	Strong gee
bright amanor	Who like be4 I watch
Sarkc css	Good stong man ğŸ‘ğŸ‘ğŸ‘ğŸ‘ğŸ‘
asonaba nana poku menseida	Strong Gee the *wordsmith*
Kelvin Little	Strongee I know you can do it more fire ğŸ”¥ ğŸ”¥ğŸ”¥ğŸ”¥ğŸ”¥ğŸ”¥ğŸ”¥ğŸ”¥ğŸ”¥
PRISCILLA OHENE	ğŸ”¥ğŸ”¥ğŸ”¥ğŸ”¥ğŸ”¥
Majid Nyass	this boy they worry too much ,,strongeee...am here b4 asonaba kwabroso
Meek-kobby RICKY	I hit the like button before listening ...i knew ya never disappoint...and after listening "you did it once again "ğŸ”¥ğŸ”¥ğŸ”¥ğŸ”¥ğŸ”¥ğŸ”¥
DACOSTA ABOAGYE	Strongman ğŸ”¥ğŸ”¥ğŸ”¥
Emmanuel Anim	Liked before watchingğŸ˜ğŸ”¥
Selasi Elvis Wordey	Strong geeeeeeee
