OVODavid M	DvsnğŸ™ğŸ¼â—ğŸ
edgar kijo	Lit
kennedy alexis	Ugh, so proud ğŸ’›
Freedom Reigns	1:16 harmony was sweeeeet ğŸ¬
Shooc	<3
Austin Gleason	its crazy how talented of a vocalist he is. You don't see that in most signed artists nowadays. Hoping he comes to Tampa.
Sydni Williams	My fav group. Period. Iâ€™m ready for more music!!!
Reezy El OG	Dvsn is unique â™¥ï¸ for real guys #OvOFamAllTheWay
armani mojo	I hope dvsn never changes.  Both cds touched my soul! There are very few cds i can listen to all they way thru. ğŸ’–ğŸ’–ğŸ’–ğŸ’–ğŸ’–
Fuhk Shet	I just wish they got more credit....
Landon Ray	ğŸ’›ğŸ’›ğŸ’›
Eric Y	Dissapointing that Drake opened up for them but on the other hand it's nice to see Usher coming through. I hope they continue to have success.  Their albums are addicting.
Elijah Pantoja	At first I always thought it sucked for nineteen to never get love as the other half and producer of dvsn but after seeing them live and meeting him this past year it almost feels like he'd prefer it that way so now I'm just confused but hoping he gets the recognition he deserves but also wants, shouts to the producers in the game!
Dorian Medina	Yes!!!!!!
FAN OF EVERYBODY	DVSN making it where these r&b cats gotta sang!!!!! Lol no more sound effects lol
Jesse Fezia	My city! #HTown
Sara Righetti	love you DVSN, keep going the exccellent job
Jose Benjamin	More Life To DVSN. BTW waiting for that 3 third album!!ğŸ”¥ğŸ”¥ğŸ‘Œ4
Garrett Reynolds	So when they gonna stop playing with me and tell me that they doing these because some new music coming.
Ashley Johnson	DVSN is awesome. They need to come to Alabama...montgomery to be specific.
Darcy Knows	OvoğŸ’¯
Silili Jr	Mad love from Angola! Keep on!
love family101	The first time I heard Daniels voice I was blown away. DVSN is the best RnB group out!!! #GOAT
shady from the block	Their next album can be trash and i wouldnt be mad. These guys are that legendary to me.
parijuana1	3ROOOOOOOOOOOOOOOOOOOOOOOOO#OERYYYYYYYYYYYYYYYYYYYDIER555555555555555555DROGGGGGGGGGGGGGG
Quotemywords	it's time for some new music
CoilyLesa	You guys are the BESTğŸ˜ğŸ™ŒğŸ¾
Shakira Nae	creative direction. visuals. ovo. dvsn. smuch to love about this.
Amber Bell	I been a fan for so long. The song " the line" i will be playing at my wedding. Come to brooklyn plz cuz i will be there to see yall Dvsn
Elton Ali	Just straight talent... can't wait for new music from them.
Edmundo De Villena	From Peru, keep up the great music! More Life.
Nikki Mahua	dvsn is such a vibe you can't find anywhere â¤
JÃºlia Pereira	I'm so proud of you guys
bester waleng	â¤all the way from South AfricağŸ‡¿ğŸ‡¦
MARTINEZ MAFIA	Finalllyyyyyyyyyy
Sethabile Hlengwa	I love you guys ğŸ˜­ğŸ˜­ğŸ˜­â¤â¤â¤ Please come to South Africa ğŸ‡¿ğŸ‡¦
Amanda Mnyandu	I like before I even press play.â¤â¤
Compton	name of the song he was singing at 1:22 ?
TreniseSpeaks	Yeees DVSN yall are getting the love you deserve! I went from Memphis to Dallas this year  to see you guys with Miguel and yall didn't disappoint. Please keep making music ğŸ˜™
OV O	Keep being yourself, destined for big things. More life.
Kagiso Online	Too talented, too genius!
Aimee Karanja	Yass Kevin Hart I feel the same!!â¤ğŸ˜ I loved u guys in Seattle!! #ascensiontour
Idi	LOVEEEEE
JustFeedMe TV	Love Dvsn Hate Drake
immanuel williams	Best R&B artist PERIOD!!!
JP 10	I love everyone in OVO God damn. You guys run this industry with the RIGHT music
Estella star	OVO is a sweatshop for writers hahaa ...
boipelo zondo	PLEASE COME TO SOUTH AFRICA!!!!!!!!!!!!!!!!!!!!!!!!!!!!!!!!!!
Isaiah Watson	So we not gettin a video for Nuh Time?
Jamie zhuang	love you all! i am so glad i found you guys!
Mobolaji Azeez	iconic !
Catherina Raymond	Great footage
Tawanda Baka	If u by any chance come thru my comment, please release another album, I need a yearly dose of that rare mixture of magic and chemistry
Samantha Robbins	Please come to Denver!!! And let's do a duet!!
Jenny Lalruatsangi	Waiting so long for a new song that i'm in lowkey depression
Tholi	Shout out to Drake for showing love.
Zandile Mjandana	My stupid ass thought it was a new song ğŸ˜•ğŸ˜‘. I'm hurt ğŸ˜’ğŸ˜¢
Prod. J Patterns	Soon ğŸ‘ŠğŸ½
MsBellyMonster	I love you DVSN!!! Come to Cali please you got love here too... Keep it up baby
Drea James	BEAUTIFUL
bigwalt3898	They only know how to make bangers, DVSN is like my goto for that real r&b music with that old yet new flavor.  I think people think I'm a fanatic because I only play one album on the way to work everyday for months lol only changed it when that next album  dropped lmao.
Dana Vo	incredible â¤ï¸
Fergus Van Den Heever	Ovo fam* all the way from South Africa ğŸ‡¿ğŸ‡¦
Kristal  Martin	â¤â¤ğŸ’šğŸ’š
Shelley B	Please come to Maryland
Sheila AM SheiShei	Love it â™¡ from Spain-â˜†â˜†â˜†â˜†â˜†
YOHANNA TORIBIO	I love you guys! You guys are doing amazing work
ariferrarie	A rare glimpse into yalls world will always make my day. â¤ï¸
Evi	Division I think you should connect more with the fans :(. I honestly love you. â¤ï¸
Dahlia Hunter	loved this ğŸ’œ
Angel Matshiane	â¤â¤â¤â¤â¤â¤â¤â¤
Elise Thomas	â—ğŸ’œ
