Gogetag .C	Comment on fait pour avoir les mÃ©dailles du Satan lr
TensaYTB	c'est quoi la musique a 9 min
CC pad chance ou pas	C PAS 1 KAMEHAMEHA LAIS 1 MASENKO
Nomis Hakai	6:04 t'as quand mÃªme rÃ©ussi Ã  confondre Hercule et Tapion xDD
[DCF]Skenium	Brice je suis content et triste jâ€™ai farm 10 ds et jâ€™ai eu un deuxiÃ¨me doublon sur zamablack moi je veux un nouveaux lr
Mystique-Man Marabou	tu peux la mettre 100% f2p grace au lead du great saiyaman LR meme si pas si interessant
DAZ _TTF	Ã‡Ã  commence Ã  3:05ğŸ¤˜
Manouk Jarekian	J'aime beaucoup quand tu nous aligne des team F2P comme Ã§a. Continu comme Ã§a ğŸ‘ğŸ¼
Mr. ToxicManå°ã•ãªæ¯’æ€§	Â¿ snoÊŒ-É¹ÇllÉ Ê‡uÇÉ¯É¯oÉ” Ê‡nlÉs
Nasake46	Il n'y a pas besoin de jouer Super Vegeto Endurance pour avoir un Leader Saga de Boo, il y a aussi le Vegeto pui gratuit. Ces boosts sont mÃ©diocres on est d'accord mais tu as dit " Team F2p " dlnc autant aller jusqu'au boutğŸ¤·â€â™‚ï¸
LeyK	Dommage que cette team ne soit pas f2p car bon c'est bien beau d'avoir toutes les cartes f2p mais sans le leader c'est inutile...
Redelsou ãƒ¬ãƒ‡ãƒ«ã‚¹ ãƒ„	Le Satan LR peut partir aussi avec 195000 de Def. Explication. AprÃ¨s avoir vu la valeur de def du LR, qui est de 130000, il a juste suffi de multiplier cette valeur par le boost de lâ€™atk spe ultime, qui est de 50%, ou de 1,2. En multipliant ces deux valeurs, on obtient 195 MILLE !!!!!!!!!
TheMegaHole	J'aimerais bien jouer ta team sauf que je n'ai pas le Gohan Ultime TEC...mais j'ai tout le reste 100% (sauf Mighty Mask END Ã  90%)
Antei	La vidÃ©o du matin sa fait plaisir
sofianes69	Team F2P ? Elle est ou ?
ThÃ©o JOUY	Slt Brice fais une tram cyborg free to play avec juste un leader prenium comme tu vient de faire avec la saga de buu
Zoia derlir	Moi je me attendait a une team f2p saga de buu dans le Vegeto end en ledeaur
nono1980 TTFâ€¢NoNo	Vivement son dokkan sur la globale je l ai avec 2 doublons.
thomas4576 carre	Brice le vegeto end a le lien fonceur .
Gneu	Salut on peut se faire ban si on mod au battlefield ?
Fire FireFreeze	J'attend de rÃ©cupÃ©rer mon compte avec bandai namco, si Ã§a marche, j'ai drop recement bardock end lr donc croisons les doigts
Dryzery	Merci pour la vidÃ©o
Super gold Z	Tu peux me dire comment tu fait pour faire des video sur dokkan battle. Je sais que tu utilise la fonction capture vidÃ©o mais comment tu arrives Ã  filmer ta tÃªte
Failman	Moi jâ€™ai dÃ©cidÃ© dâ€™arreter Dokkan
BUCKET KFC	Team nuit blanche + notif discorde
Tatsuya Kuroko	J kiff tes vidÃ©os des le matin
Son Kamina	Level 497 ?? Tu as pris un compte Ã  quelquâ€™un ?
Warsajeff	Fais gaffe Brice, t'as mis 3 unitÃ©s qui sont pas F2P dans ta team x)
Jarod ZÃ©ro	Je l'ai aussi avec un doublon, bon TUR du tournoi en effet. Merci pour le test Brice.
Makhynb	Team 6h30 + notif discord
