Reece Mcfarlane	Your packs are unreal
Evaniscool - Great Videos	Chico blanco
PandaGaming Pascal	Mega Packs actually are shiet for me too
NORWICH TILL I DIE	Someone was bidding 200k on pepe ;)
Fresh Flame	Fred
Connor Sumner	Fred
Andrea Cillo	Fred all way
Ljbert1231	Your whole front line is under 5 foot 10. You have to be able to win headers
adem sulemani	I think the most expensive board is naingolan
Liam Whitehead	van jdic
Kyle Paffey	Chris you donâ€™t have prime maldini
Miyagi l l	Scream cards stats change over the weeks
Cian Joness	Alliâ€™s the best player ive used this year, ive got players like Mane, Hazard, Van Dijk in my team and heâ€™s the one that stands out most
Davorin Raspudic	i think van dijk is the best board
Tom Tilbury	Matt maybe instead of spending a fortune on Fifa points spend some time learning how to actually play the game with a god squad I donâ€™t know how bad you must be to only get 9 wins out of 20 with a 4 mil team
Official Umar	Get fred in cm he's so good
Alexander Murphy	van dijk is most expensive board I think
Mark Higson	451 with Jesus in cam and aguero in st
MysTiC iiNinja	Pls do not swear
NoodleKazoo	Make your tactics so that when you go attacking it changes to 4231. Play Gerrard behind Jesus, hazard and Willian LAM & RAM. Pogba and a new defensive CM in CDM. I play Fred in CDM
ItzJw	Most expensive board is the 85 icons 450k+ like so chris can see
Jordan Booth	Your back line is insane donâ€™t go for an icon fullback you donâ€™t need to look at attackers
Steve Williamson	Get prime henry
Hoger Vani	Inform Lacazette is better then Gabriel Jesus!!!
Cian Gilmore	Fred any day
Alek Kostovski	Whereâ€™s the pranks. Bring them back
MJ STARS	Do a hybrid with blue naingolan hazard and mousa dembele then Miranda and a any left back like sandro!! Chris needs to see this
Tyson Orr	My best selling players have been from 5 k packs both dembele and matudi
OCgaming H3AT	Son
TBK_Gaming	Kyle walkers an expensive board
Regal Private	Walker is expensive
Stijn Schunck	Use custom tactics and set it to switch formation when you switch to attacking/defending, it is a game changer.
Teckerzz	Matt or Chris?
AdzyVass56	i packed Niangollan 85 rated and he sold for 150k on ps4
Teddy Bj	Why de bruyne ğŸ˜£ğŸ˜£ğŸ˜£
Harrison Starkie	Dele he has shot on him.
Shae Delnon	Davison Sanchez
Rayzor240	i reckon its thierry henry
EM12	Get champions league Jesus
Majeed Butt	Keep hold and wait till the end
Elliot Roper	Matt I was 7-3 like u and shat the bed only got 11 wins I canâ€™t play fut champs again jesus gd vids lads
Juan Brown	Harry Kane is absolute quality
Mohammed Hasnain	Matt plz save for Cruyff
Phoeniixx	Van dijk and nianggolan
I_MOD_CUZ-_-	Nainggolan
Frailhealer 23	Id put in dele
andy nhu	Someone get George best!!
TB Smeri	Matt save up for kruyf
Sneebzz	I would get alli
HJEAZY	Chris is better at FIFA
PuRe OxYgEn	Naingolan 100k
XCIMC	Van Dijk is the best board pack, then Nainggolan then Fabinho ğŸ‘
Gurkeiret Gill	Please stop swearing my parents keep telling me off
Axronnn18_	Yeah Jesus is doing good 7 in 10 but an icon could do better maybe 10-10 or if not better
Nawwy Ali	if you want pace strength passing and shot take Oxlade-Chamberlain over fred hes much better
Idward Squidward	I think nainngolan is the most expensive board
Akys Gaming	Dele alii is a cracking player absolutely amazing
Sebastian Amaya	Most expensive player boards-van dijk
Chris Ewart	Chris get salah rw
Jake Hurae	Naingollan is an absolute banger of a board
The Everton Man	Why do you ignore the criticism you get? We want to see different content not just games and pack openings every single day. Bring back the mini games and pranks!!!
We53 D	I got both Fred and dele in the mid and Fredâ€™s far better
Vinny Thomas	Got an inform Lukaku out of a mega pack with coins
Fearful TSA	Luis Figo in right wing would be a good upgrade, still love the vids and got my brew
Miguel CG	Chris how often do you play
Hayden Carney	Upgrade Maldini to his prime, prime or nothing right?
Raft Og survival	Chris try Keita
Alex Simmons	Reus goes for like 70-90K and heâ€™s a board
Joshua Dransfield	I packed Pogba in a 45k pack and then aguero in a 35k in the space of 24hrs
Dunnion	I got the first pack luck today and packed 87 Alexis Sanchez not much but cracking plur
B2174	Play casimero at lcm and gerrard at rcm ğŸ‘ŒğŸ½
Kody Murphy	Naingolan board 130k i packed him
Alexandra TV	I packed messi yesterday
Worst day Ever	Dele Alli is good at long shots
Ltmanbonzo	Im the 13 thousand'th like!!!!
Kieran Byrne	Chris your right jesus is a cracking plur
British Spooderman	Whats your favourite fifa of all time
Marcus Pannunzio	Do u guys recommend Jesus , im thinking of trying him out your thoughts?   REPLY Do u guys recommend Jesus , im thinking of trying him out your thoughts?   REPLY
XX PRimalz	If u think getting 7 goals in 10 games is good for a striker then u have no Brain
Gerald Don	Son
Scorpio200	Van dijk is an expensive board
Joseph Townsend	Naingolan is 150k
LegitFifa	Chris move gerrard to the central cm, put pogba right cm, put ucl nainggolan left cm and replace Marcelo with Alex sandro
SnR Realms	Dele is horrible
Owen James	I feel the same I play against people I know I can beat but lose but I win against really good players but lost 3 times to penalties and people scored in plus 2 mins every time
Jacob Hastie	Van Djik is an expensive board
John Boyne	Nainggolan, Walker, Fabinho are the most expensive I think.
Jai Balestra	Kyle walker is expensive board
RunescapeGuidesTeam	Using the work Wi-Fi at dominos pizza to watch you guys :)
Ben Howley	Son
Default God	I had a fucking horrible Saturday started with 8-2 then I lost 10 on the bounce. Still got gold 3 though
Filip123 3	Fifa sucks
Lewys Price	Got 30mins of free WiFi using it best watching this
Baz	Should try inform Mitrovic some time.. his 65 pace makes no difference in the game. He's great.
Harry Clark	Try R9 up top. I played against him and he scored 6! Not even a one-sided game
Rob Truelove	Try prime okocha at ST
RaZe KiLZ	Watching aa9skilz, he said Gerard isnâ€™t amazing cause of his agility thought Iâ€™d let u know.   Keep up the good vids tho
M L T	Did everyone else see the 2nd scream Pepe on the market selling for 200k
Dominic McAuley	Van Dijk most expensive board
Logan Lowe	Get inform gundo back
alan croke	Got Nainngolan yesterday hes a board and hes worth 150k
Joshs Backflipz	Dele alli
GamingAccess	I packed pele 95 rated card in a mega pack and plus I enjoy your guys vids cris get champions league merteins and out champions league naingolan
Dan Fleming	Chris use inform gundogan
Kiran James	Matt keep your Pepe until he gets a boost for his pace cause heâ€™ll go up quite alot
Mohammed Ammar	Alli 100% over fred, ALLIS long shots r flipping insane legit can score from miles away, his finesse are next level way better then fred ğŸ”¥ğŸ”¥ğŸ”¥ğŸ”¥
Gianni Lendino	Fabinho Son Jesus are best 3 I think for non walkouts. Also goretzka
Finlay Lyon	Did SBCs Earlier And got aubamyang so just bought 45K Packs With Coins And Packed Messi
lynsey keeble	Cruyf isnâ€™t that good cause he doesnâ€™t have the finesse shot trait
REE	Get butragueno I have played 32 fut champs and division rivals matches and he has scored 73
Rory Medlock	naingolan is the best board
Will D	Never sell Stevie
Adicd	Chris buy Messi next
Spencer Candlin	swap the two centre backs around as theyâ€™re both on their weaker side. This will allow passes across the back much more easier and less mistakes bound to be made ! Love the content keep it up ğŸ‘‘
Cam No	Absolute crackin vids keep up the amazing work love u guys donâ€™t stop enjoying yourself making the vids ğŸ‘
RT Ryan Turner	Bet this comment wonâ€™t get featured, best vids on yt by far keep up the good work crackin plurrrrr
Jack stamford	fabinhio is the most expensive board the runners up are son jesus martial and alaba
NickLikes FIFA	Mega Packs are the most underwhelming packs for me
BB HD	Matt the bang same happens with me bro
Aqil Iqbal	Chris if you need help with your midfield why donâ€™t you try Casemiro and swap him into lcm and put Gerard in RCM love the vids
Willsgamez	Matt get rivaldo as striker
Sebastian Ellis	Matt I have prime Larsson and he is actually insane, 8 goals in 4 games so far!
Ant 154	Chris get inform gundogan
Ruben Michaelsen	i did
Unsuboi	why did that 'greeat' at 4:18 sound so weird and special hahah
John Dowle	put fred LCM then put gezza in the middle
Dig D	Matt get baby Cruyff heâ€™s still sick
AbsoluteShadow	Dele Ali is sick
Reece Cressy134	Chris - I would 100% take Fred heâ€™s a cracking plur and he wins a lot of balls and bangs in laods if goals, dele alli loses the ball to easy and his work rate his shambolical ğŸ’¯
Cormac Naughton	Chris use 4222(2)I think thatâ€™s it it so good I win every game with it
Ian Stone	Keep him
Childish Socks	Chris dele alli is a cracking plurrrrrrrr for me
Louis Phimister	Fred all day man Fred is a hell of a plur
Nathan C	u said prime or nothing but maldini isnâ€™t prime
Joe Futcher	Matt get pele when ur legends have sold
Jakemoore 05	Use alli heâ€™s a crackin pluur
Joshua Liley	4-3-2-1 isn't the best formation, either variant of the 4-2-3-1 or any of the 4-3-3s
Yosef Khudhir	Joshua king inform is the best striker in the game
Jack Trice	One player I would recommend is lewandowski heâ€™s scored and assisted 29 in 13 games 18 goals 11 assists. Cracking Plur!
Daniel Powell	Save for cryff
Ali Stachan	Who do you support?
Kumar	With scream cards, every â€˜spookyâ€™ event/date the two 90 stats will re arrange to different places.
ZaYn NaWaZ	Chris should have got Socrates instead
Manesh Sarup	Swap Gerrard and Pogba around Chris and get Roberto Carlos at lb if you have the money
Chug God	Get blue Fred Chris
Lukey08 -	I use 41212 wide or 433(4) it's so good
bradley hurley	Get KDB back
Tom Rowland	Sell degea and get buffon in goal
GC2x Wolfy	van dijk
Harvey Parker	Van dijk most expensive board player
luca bearded man	keep
Patrick Brown	You should do a forfeit every Sunday to make it more entertaining.
Markus Guttormsen	Chris OR mat, try Shevchenko! He is sick
Jack Ross	Fred
Harry Howarth	Got gold 2 in fut champs, love the vids watching from South Africa
Jackoh	Fabinho
Mayeco Portuguez	Get ones to watch Fred have him so amazing
Tom Wolstenholme	I've got 700k. What icon should I buy?
Harry Drain	Fred
Bentekersaurus FC	Fred because all of his stats are pretty good
Velocity Siege	You say you can't drop Jesus but you dropped Vardy so get Alan Shearer
AzY Dodger	Fred
Sahand aghvami	Put naingolan in midfield and get sandro he will get the links from icons and hazard and he is a beast!!!!!
Michelle Cox	Easy fred he's crackinggg
Cal Ludwig	One of the biggesr assets you can have in this game is flexibility of formation and tactics. Set a starting formation, then have two more defensive variations of your team, and two more attacking.
Ieuan Mainwaring	Fred
Magnus Myrvold	Naingolan: 150k NON walkout player
Lewis C	Aguero eventually he is sick curl out box sunk every goal keeper except legend gk.s
Otis Dekker	Naingolan expensive board pack
Zeph_official	Get KDB back!
HDGaming 12	Kyle Walker 90k
Chrismeist	gerrard is not worth it
Charlie Unknown	Put Fred in the middle as on the 4321 formation the middle cm is more defensive
Woj Nowak	good job Im not the only one that loses games in fut champs in the final minutes
Liam harland	Lampard with gerrard
Jack Gyte	Naingolan is a board pack. I got him the other day. He sells for 140k
Kyle Anderson	Van dijk is an expensive board
Damon Besoff	Is mat really mat without Henry
James Forsyth	Kyle Walker one of the most valuable boards
frederik gammelgaard	get r9 in RF instead of Hazard
Krishen Goswami	Sell him
adnan  alarjawi	Naingolan most expensive board
Cameron McDonald	You need to get Sandro at LB, then put Gerard at CCM, put Naingollan in at LCM and Pogba at RCM. Everyone gets chemistry! Love your vids
seammy 1232	Keep him matt and use him when you have a full icon defense and midfield
RyanN_ Fortnite	Get lampard so Gerrard and Lampard=OP
Callum Hendry	Chris if you put Fred lcm stevie g cm and pogba rcm you can get Marcelo on full chem and play stevie g in the middle like you wanted
Elvisgaming 123	Dele alli is a better attacking cm, but fred is a better all round cm
Jack Slattery	Who thinks they should play some fans
TBD	Son is an expensive board
Troll Boss	From mega packs the best i hav got is cavani and neuer
Charlie Chillingworth	Get Alex Sandro, then put in raja in CM and move Gerard into middle, all get Chem would be really nice
ENTER_NEW_NAME?	Get icon ST I am sure about that
Theodor Makki	I think the most expensive non walkout player is Virgil Van Dijk
Ace senseii	Get prime gullit for rcm
jahseh Thomas	Matt getting silver 1 with that squad lmao
kian kelly	Keep up the great vids boys best videos in a long time cracking vids â¤ğŸ’¯
Tibor Petik	hugo hugo son is expensive cracking plurrrri
Mohammed Alansary	Matt get cruyff
Olly Wycherley	I packed Reus and he sold for 90k
Kyle Playzz	Is it just me or does anyone else vote when thereâ€™s a vote on the vid see what has the most votes then invote cause itâ€™s just fresh
rudzz3	Kyle walker s
Ross McGregor	Imagine getting silver 1 / gold 3 with that team ğŸ˜‚ğŸ˜‚ğŸ˜‚
- r12345ryan678910 -	Play firmino in CM better than Fred by far
WillShepherd	Naingolan
Taylor Thorne	Both got khedira at simular times. Can tell there brothers ğŸ˜‚
HMI Gamer	Most valuable boards are Mharez Fabiano Jesus martial
Wayne Theet	All this time havenâ€™t been subbed and not realised, when I saw that I hit it so quick
Fuzzy SiKnEsS	4-2-1-2(2) is op you just need to adjust your custom tactics and make sure you have a good middle ground on width and how high your defender line is i win so much with this
FezzaGames	Donâ€™t always go for primes because baby gattuso is better than his prime
Harry Smith	Hi guys, quality content when you open promos, show us the probabilities
Nikolai Bartholdsen	Naingolan is the most expensive oneğŸ‡³ğŸ‡´ğŸ‡³ğŸ‡´
Clipz	Chris I think you would play amazing with 4-4-1-1 (2)
Hayder_786	How long have you guys been on 1.4 mill subs
Josh Simpson	Van Djik I think
darck matter64	what ever you god dame whant ffs
Louis Dilworth	Son , martial , Sterling
Jack Baket	Nah mega packs are the best I packed Messi in one ğŸ˜‚
Jack Sprat	Why arent  you doing super sunday in 2 parts
Fljh 08	Naingolan is like 120k
the legend 27	Try champions league Trent Alexander Arnold heâ€™s a cracking plur
Robbie Hall	Van Dijk
Fine Fathers	Matt get prime Stoichkov or eusibio
Christian Take Your Dad Fishing	Alli, heâ€™s taller, stronger, and his shot seems a lot higher than what it is.
connor Mcgregor	Van dijk
Hamza Khan	Kyle walker is the most expensive board
Finley Staton	Matt get Prime Henry up front with Auba
Kasper Eriksson	Sell pepe buy three cheap scream cards for The Ultimate scream sbc
ikareakoko	Chris says â€œprime or nothing,â€ yet doesnâ€™t have prime maldini
The Wolf	Chris get Fred he is a Beast
Lewisâ€™s Lewis	Son is expensive
Noah Moss	Dele alli is broken
NED	fred is god
Jonjo Baggins	Fred
Cory 654	Matt get George Best he is amazing
Nathanialbowler Daviei5	Get UCL Jesus have him for some reason better than normal
Daniel Mahood	Get George best âœŠğŸ»
Kieran Moloney	Naingolon
Elliott Atkinson	Use dele alli. He is so broken and can score from anywhere within 30 yards
Injury Time Ireland	Van djik
Lewis Neill	Fred defo
Makrell FlÃ¸isvik	naingolan is the most expensive
Gary Turner	Fred!
Baggy1234	Hi guys I'm commenting on every vid! Been here since FIFA 15!
George link0	Get matuidi
MIKEYH4GAMES	Chris put POGBA rcm gerrard in the middle and naingollan on the left
Fifa Gamer 11	Nainggolan
Muhammad Chaka	Chris get Eusbio best player in the game for a CAM or ST. Doubt il get featured tho.
Calum Wright	Sell Ali and get inform gÃ¼ndogan
Stxzy	I got a de bryne in a mega pack
Ian Hamilton	As a spurs fan I am still choosing fred good in the mid
Lennon Barrett	Get Fred coz heâ€™s left footed put him on the left and put gerrard on the right because his weak foot isnâ€™t the best
Philip Dewsnap	Get a right winger
Dizzo Gaming Fifa 19 Filters.	I have been hear since raider games
Ben Bottomley	Van dijk he sells for 150k Chris
Jamesmr04	4-2-4 is a crackin formation
Tyler Vine	TOM IS A CRACKIN PLUR
ImToxic	Amazing vid! Subbed since 4k. Keep it up!
LKJ	Chris save for a prime cruyff, cracking plur
Moritz MÃ¼ller	Chris get matuidi in right cm and cancelo if in rb and mat get eusebio
hassan Al ibrahim	Matt get prime Dennis bergkamp and prime Frank rijkaard
Captain Jack468	Chris schweinsteiger has a ultimate scream card on sbc!!!!
danny boy	Chris I have noticed your  attackers are small should try a tall CF as ST
Jake MADZER810	I had Jesus but he didnâ€™t do it so I got if King and he does
wizardinio aaa	Naingolan is the most expensive board
BeastBoy 17	You should get Luke Fraser inform at lm and Mandy at lb also you should try matic crakcking vid (To Chris Btw)
James Metcalfe	get Eusebio in st or get makelele in cm. keep up the good vids
Adam Barnett	I have Fred in my team and he is amazing honestly use him he always pushes the opponent of the goal
Alex Bonnington	Naingollan is over 200k he's not a walkout
Finley Price	Chris use 4312 and put gerrard CAM
Joel Bell	My iPads on 10% so Iâ€™m leaving this video on
Ryan Cavin	Sitting enjoying the video with Marley bain
â€¢ Petti	Keep Pepe and get icons to give cem plus love the vids keep up the good work
Cjbirkenhead 2003	Got mane out of a rare mega pavj
SnapbackSnoddy	Try out scream Fellini
Charlie James	Chris said go prime or nothing but he has middle maldini
Ibraheem Qureshi	Dele alli is amazing btw he wins all headers and his long shots are sick
Lucas Mcphun	Do a draft
tacky_cobra9 gg	Son is the best non walk out btw love the work keep it up
JamoHD9	Nainggolan is not a walkout and amazing he goes in my team and worth 150k
Mattyboi73	Love your vids keep going
Will Perkin	ğŸ‘‹
Isco Disco	Chris is the credit card boy this year ğŸ˜‚
James Sygrove	Get prime Hernandez Chris
Luca Rakic	I packed de Gea out of a mega pack
LouisWille	Chris go with fred
Milan Bayer	Try If ArnautoviÄ he is god
Kenzie McCabe	Chris what team do you support
Adam Weir	8 losses isnâ€™t that bad  a decent fifa player in div 3 and I didnâ€™t win in 25 games and got relegated to div 5 and itâ€™s because of scriptin in the game
Georgeclark7	yessss super sunday at 8 best
XxFifa19PlayerxX	Mat get hazard he would fit so well in your team
Gurjeevan Singh	Firmino is better than both
ZENOX	CHRIS get icon keane 560k 88 ove
Austin Julovich	sell he is in a very bad league that you would never use(pepe)
Alec Vidal	DELE ALLI IS A BEAST IN FIFA BRUV
G7268 _	Put gerrard as a player and A manager , come on the rangers ğŸ’™
Scott Stevenson	Chris dele alli is mint. For me he has played 59 scored 26 and assisted 23.
Caine Lee	Look at otw jorginiho he's sick
JackBatty3	GEORGE BEST
Declan Murray	Thanks for buying my fav player
chompunut wanasethi	I guess we are getting the video early then
Halwa Hewews	Can I understand how Chris has a player who is worth more than my teams in all the last FIFA games combined
Luke Lowey	Spent 20 uero on packs and got no one not even a board
Pedro Goncalves	Get Roberto carlos
Alvar Nordlund	Buy aguero ive heard heâ€™s an absoulute beast!
Finlay Dale	4-3-3 attack is honestly the best formation this year in my opinion . Currently on holiday but still watching the videos , keep it up !
Lewis Smith	Youse always get walkouts when your taking about the most random things ğŸ˜‚ğŸ‘ğŸ¼
Gene Bean	Naingolan most expensive board
Tom Anderson	Cracking plur
Jo'nathan Buxton	Chris do the SCHWEINSTEIGER sbc
Matthew Hughes	Iâ€™d play Dele Alli as I have him untradeable and he is amazing! Iâ€™ve used Fred and played against him, he isnt the best...
lukes Gaming	Dele Ali is really good use him
morgan Fillary	Chris only gets prime icons yet he doesnt have the prime maldini
Sam Mcnamee	Yes itâ€™s coming at 20:00 tonight YES
empireJonty !	Use Fred
Taylor Pinsent	Nigolan is like 100k
Freddie Tyson	Anyone else see that person bidding on Pepe for 199k lol? 6:45
JSL Curry	Get Neymar at lf he will get the link from Gerard and Jesus
_ Jimbo145-0wen_	Matt, if you can get Henry and play him at cam heâ€™s sick
Oliver Kendall	Chris sway maldini and canovaro around because of there weak foot
Kieran. Met	Not a fan of alli, donâ€™t know why he just doesnâ€™t do it for me
Daniel Brown	The 92 maldini isn't prime
Tilz	Chris not asking for 10k likes? What alternate dimension is this - oh wait there it is
arsh sodhi	kyle walker
TheChosenOne HD	My giroud played 30 scored 26 and 11 assists. Not got pace but can hold off defenders and if he gets a shot off it's pretty much a goal
ethan 123	Keep
Shea Doherty	Mega packs are amazing for me Matt I packed mbappe last Thursday and sandro at the start
Klevin _m	I got Balotelli and Pepe Halloween cards
Leephillip1 Bridges	Son
Ants	nainggolan is a board and he's 150k+
Harry Whelan	chris get erikisen
BRANDZ	Iâ€™m going 15-8 on fut champs shall I continue to get Gold 2 or shall I just stay in Gold 2
Elitechiefy	Buy jack whatmough and put him on bench or reserves please
HAM	Van dijk board is 160
Johannes Sandnes Vada	Try scream ampadu and scream fellaini they are gods
More CallumJS	Anyone know how to get unbanned from the market Iâ€™ve been banned for 1 hour and 45 mins
Charlie Stirling	Both get baloteli scream card he is OP and has 90 defence
II OliverGoring II	Whoâ€™s your favourite music artist?
Harvey d	Why donâ€™t you guys do pranks anymore
Harrison Hawksley	Most expensive board is nainggolan  200kğŸ‘ğŸ»
FunnyThings61	Chris who's better jesus or vardy?
Rhys Dwyer	Get scholes chris
Matetro	Get cruyff he is a beast
Karim The Gamer	Ive tried Dele and Fred. Fred is amazing all round, Dele has amazing shooting but his pace feels a lot lower than what it is... id go for fred out of the 2 but probably Dembele over both..
Cashew Nut	Sell him because he wouldnâ€™t fit into ur team and he sells for about   200k which u can use to get an icon (to Matt)like so he can notice this
noah vanooijen	Definetly naingolan is the most expensive board right? Then van dijk and walker maybe
Ix Harvey Skinner xI	I have Fred alli and dembele in midfield and fred is the best
Joseph Broccolo	Get champions league Jesus and put a attribute card on him
Sam	Matt defines the term â€œgoing baldâ€
Luca Winfield	Chris put gerrard in ccm and then put Casemiro in rcm and heâ€™ll get chem with Willian and Maldini,,,,,, keep up the good work guys keep grinding
Azaan Mir	Matt get prime van nistelrooy cracking plurrrr
Nilssen06	had an awful weekend in champs myself matt, won 9 lost like 14 so far, was aiming for gold 3 but if i can get silver 1 it'll be a miracle!
Anthony Smallwood	Van dyk is a non walkout and worth 170,000
Bradley Hickman	Harry kane has had more goals than games for me
Calvin  Hanes	3/5 mega packs walkouts. Pogba, aubamyang, and perisic so no, they were the best packs so far.
DUNNIT	I'd rather have Fred just because he's got an all rounded card
stheron107	What you should do with good players is use them I some games if there good then keep them if not sell them
PÃ¤rt Villem Kiho	Get prime Zanetti at RB
BranMuFc99	Watching two sync with a cup of tea is good. But watching two sync with a Sunday dinner is the best.
DSyR Viper	I bet you will pin this
KiwiTV	Dele alli is a cracking plur
Sam Zzzzy	Fut champs gets harder on a Saturday
Simen Lyngstad	Get Jamie Vardy back! He is a craaaacking pluuur on this game!<3
FreshTheScot	What a surprise Matt copying Chris with primes only now.
Josh francis	Fred
Neazle	Get gullet Chris heâ€™s great for a baby. Cracking pluuuur
Bradley Kelly	Who else seen someone bid 199000 on pepe scream when mat was scrolling through the pepes
Int_ Scxtty	Already liked at start
Charlie Mitten	Great video lads just loving the way the videos are going keep it up
EL1TE x BULLD0G	41212 is wide is good works well for me but what formation do u recommend I want to try something new
Eoin Wilson	Jesus is like 60k
Johnny Gamer 19	Van dijk
Paul APj	Do the Hunter journey
Savvy Chaos	I packed my first scream got ampadu 90 pace and 90 physical
ReDu bowlcut	Put Casemiro in cm and get a Brazilian right back
Jacob Williams	Radja Nainggolan is one of the most expensive board pack
Noah Cutts	Get the icon Carlos
Alfie Bowden	Chris try 4312 itâ€™s insane
Morgan Edwards	Liked it as soon as I clicked on the video all ready knew it was gonna be a banger ğŸ”¥
Sean Fahey	Fabinho over dele or fred
Lukerz	Matuidi
shaf don	Get salah in rf!!
CJ4 SA	Bring cracking content back mat!
Tom Cummins	Great video keep up the good workâ¤ï¸â¤ï¸
Harvey 07	Highest Value board is probably Son or Fabinho idk anyone else
Adam Rock	Son
Jacob Partridge	Fred is awful please donâ€™t get him
Lewis Whiteley	Chris needs the beard back
Fortnite Gamer270307	The packs from yesterday said fifa 18 not 19 anyone else notice
christian mcloughlin	Try 3-4-3 remember fifa 17
Ridged Gaming- Fortnite&Fifa	Son
William Saunders	Van dike
R1SKYPLAY3R 789	fred
Jack Smith	George best rw, omg that sounds naughty for you Chris
TClampLFC	Van dijk
BVDS	Ur vids are so good. Keep up the good work.crackin plur
Matthew Gallacher	Chris sell casemiro
James Loraine	Itâ€™s so hard trying to play fifa while watching twosync
Owen Priestner	Chris on custom tactics use fast build up and pressure after possession loss it works so well for me i have won 5 in a row with it
Ross Haggart	Fred
Finn McKay	ive had both and fred is way better
ShakerJim1	For your next icon get Amazon he's prime ğŸ˜‚ğŸ˜‚
Jordan Bolling	CHRIS TRY NAINGOLAN OR CASEMIRO SINCE YOU HAVE ICONS NOW...I KNOW 7 CHEM BUT IT WOULD COOL TO SEE THEM
Youtub crazy 789	Where do you check the percentage of packing a good player in a pack?
Jack 27	Great content guys always look forward to ur vids!ğŸ‘
mike hunt	Put Stevie g in the middle naingolan on left centre Pogba in the right centre you'll still have 100 chem
Random Tyyppi	Chris gerrard IN the middle pogba on THE right alex sandro lb AND UR Champion league Naingolan in lcm
James Hardy	GEORGE BEST NEXT CHRISSSSYYY BOY <3
GamingGuru 101	Can we just talk about yesterday when Matt was almost having an orgasm over Sokratis and he has now sold him ğŸ˜‚
Cesar Ferreira	The EXACT same thing happened to me in FUT Champs matt. Lose last second to BS
Danny Keane	Martial
Jordan Williams	good videos but hardly surprising that you have a 1.7 million coin player when you routinely spend Â£70 on pack openings. While its nice to see you guys play with players normal people wouldn't get a chance to play, it would also be nice to see you guys have a more balanced output. Maybe have another account dedicated to spending less and only using rewards packs? I honestly think your best FIFA videos were at the start when it was actually exciting when you got a new good player for your team. Now you get Gerrard and I'm just like that's cool I guess, no doubt he will be changed for another icon in a couple of videos time.  Also if you are going down the route of investing loads of money, at least switch it up. have multiple squads that are more unique and diverse rather than just pursuing an all icon team
Jude Hill	I bet u won't put me on the video
loui5._	dele alli oer fred
Kyle Nichols	Get Zola a huge Chelsea fan would love it if you got him keep up the great work
PNK JOKER	41212 best formation
Yah Boi Cooler	Matt get Butragueno or Stoichkov they look fantastic
Ashy Grewal	Sell cannavaro and get Zola 85
Fundings GT	Most expensive board is probably Radja Naingollan
Johan Vikse	Buy henry st. He is a beast
Liberty Barson	May Iâ€™m the same mega lacks just donâ€™t work for me yet 7.5k packs are sick
XthatgigglesX	Van dijk
CasualWall	I'm banned on PlayStation because one of my friends reported me so I'm just watching all your old videos n I remember them all ğŸ˜‚ğŸ™Œ
Aaron Skelton	Chris u should put gerrard into centre and get Alex Sandro back and link him with your UCL naingolan
Alessandro PlacÃ­	Put Casemiro in left cm and gerrard in the middle pogba on the right
Grom FX	Chris DO NOT get an icon RB or LB, you have the best you can get (pretty much) and you could spend coins elsewhere - keep up the great work guys!
Emirhan Serdan	Matt : Keep him and when he get his upgrade you can use him in sbc or sell him for more
Archie allen	Gold 3 in my first week on fut champs with 2 games remaining
Tom Aldsworth	Love your vids , keep up the good work
Didriken 09	Try to fit in Depay. He is a beast.
Sean Slemon	Fred
JWGAMING	Do i put effort into Squad battles or Rivals?
Dave Richards	Tonightâ€™s games gonna be like Manchester United games ğŸ˜‚
Nathan Brannan	Get prime larson
Ye Mum	I would say put Dele Alli in cm but you have pogba and Stevie g so I would say Fred for pace I know you have Gabriel Jesus but try out inform Joshua King amazing player
Youness Andersen Messaoudi 8e HerstedÃ¸ster Skole	First like love the vids love from Denmark
Max Fiddes	Genuinely look forward to your videos everyday ğŸ‘ğŸ»
Paulius Venys	Get Harry Kane he's amazing he played 5 games scored 8 and it would be a honour if I got featured
Kevin Gallagher	chris get prime icon henrik larsson he is amazing
Filip Karlsson	Hold himm
Corben Oriel	Walker most expensive board playet
Ryo Leigh	Chris donâ€™t go with Fred,  deli Allis finesses are deadly
James Neate	Son is the highest selling board
Gerard McAuley	One of use should get harry Kane heâ€™s really good and has scored 38 goals in 30 games for me
Rhys Evans	Matuidi
Effed Macjon	Chris Naingolan is 150k and is 85
Jamie Rooke	Naingolan
Callum W	What's happening to Matt is happening to everyone - pretty sure fifa is rigged this year more than ever. Easily can be up 3-0 and lose 4-3 as your players just stop playing. I love the game but this needs to be fixed.
Matt Barton	Son sells for a lot Chris
Tyler Connor	I got neymar in a mega pack but untradable
Caspar Vaerand	Vardy is better.. for me he has 45 goals in 30 games
Emrah Besic	Sell he wonâ€™t fit in your team
Matt Beales	Get inzaghi up front
LIam Oâ€™Neill	Kyle walker is 80k
Emerge Legendz	chris, save up for prime best.
Orbital Pro	Hoping this hits 10k before 8
alfie wesley	Chris youâ€™re an absolute legend mate
Andy Davidson	Go live again on twitch
Sam Morrissey	Mat thats want happened to me
Joe Newnham	Van Dijk is a really expensive board palyer
Alex Chamberlain	Keep up the good work lads and I highly recommend you get Cruyff prime he is sick P.S It would be sick if this could be featured in your video ğŸ˜€
The Celtic	Get Henrik Larson upfront he has 98 heading heâ€™s a beast
XplayZ	Matt or Chris buy Stoichkov In ST, he has 92 pace 92 dribbling 93 shooting and 87 passing. Heâ€™s a crackin plur
Norman Thompson	Chris Allison
Adam Sir Rety	Iâ€™ve opened like 8 megapacks and I canâ€™t even get a board...
Lionel Messi	Chris put gerrard in the middle and use your naingolan and alex sandro
Samskills 100	Definitely Fred
Dan Cassidy	So far this year Iâ€™ve used Gabriel Jesus, Lukaku and Salah on 7 chem at ST and Vardy blows them all out of the water!!  Also, Iâ€™ve not long picked up baby Scholes and with a shadow card on him heâ€™s absolutely unreal!!
Eddie Moss	chris says prime or nothing but has 92 maldini hmmmm....
OJhdGamer	Try Petit guys - best CDM IMO
Finlay Mitchell	Kyle Walker is a beast board
HM 14	Get Henry
Wakka	I would never in a million years pay 1.7m for a player with 3 star week foot
Nathan Jay	Dele Alli cracking pluuuurrr
Lloyd Oliver	Matt buy Owen or schevchenko ğŸ‘ğŸ»
M DAK	Should be getting gold 1 or elite with those teams cmon
marnix van doorn	Matt buy stoichkov
Jorn Sanders	Son is expensive board player
Saod Nasser	Cris try inzagi at st
Jack Lyons	Get kovacic he is lethal
Nathan Jameson	I've been sub since 3years ago I hope I hope I get my first notification squad up on screen and I would buy inform hulk you will not regret it Chris
Football is My City	Great vid....... good thing the thumbnail did not spoil the video
DJ Balall FIFA Pack Opener	4-4-1-1 is the best
Nathan Heaton	IF siggudson is an absolute tank u should try him instead of Alli
kamil abboud	mega packs have been the worst packs for me
mo khan	Joined the notification gang and liked the video before i even watched it because you always make my day
Chris Egan	Decent enough guys
alex bell	Dont usually like yt videos but you guys are making some great content and deserved the like! Keep it up guys
Ben Clutterbuck	Sell gerrard heâ€™s now 3mill
philip scolieri	Chris look up tip videos online. Look up custom tactics for your formation. Use coins to put the right chem styles on your players.
Alfie Mehrlich	Kyle walker
Ruhanr Nihgga	Replace gabriel jesus with lacazette
Theledgend Kill	Fred is brill I use him in my squad and he scores a lot
MoGamerHD	Common lets get 10k likes
Claudia Silva	Son is like 70k and he is 84 rated.
Garin255	Naingolan, I donâ€™t know how to spell his name, but he is like 150k 85 rated
Rob Fitzpatrick	Chris don't sell Jesus he is mint and get Fabinho in midfield
geirge davies	get fred he is so good i have hes ucl card and hes good
Coll Anderson	Until Steven Gerrard is out of Chrisâ€™ team I am no longer watching these videos
seif elezaby	Chris put naingolan in the team at lcm  by bringing back Alex sandro and moving gerrard to the middle cm
Christian Hayden	The most expansive board is nainggolan
CC77gaming	Matt I'm in div 5 and this weekend league was my first ever and I went 15-15 how did you do so bad with your God squad
Chris Page	He is no way worth 1.7mil not a chance
gg_harry	Matt please try prime stoichkov he looks so sick
Joe Rowell	4231 narrow is godly
JDGaming	Cryuff
Mathew Platt	Get George Best!! HES A CRACKING PLURRRR
Master Gamer Parody	When I was playing Fut Rivals and I was down 3-0 and I scored 4 goals last 20 minutes.
Seb Rogers	I hate Fred he is too small and I play by cross goals so he didnâ€™t work for me
Monty FIFA	Sell pepe
Chazary Xbox	Chris is better than matt but to be honest if you both mad different YouTube accounts I would wach every vid on both accounts
Danny Murray	Son is one of the most valuable boards
Ali Almishal	Try Pepe out
FUT ARMY	Van dijk 170k
Al Canal	Chris put Gerrard in the middle pogba on the right and put naingolan on the left and put Alex sandro instead of Marcelo
TSunami _	I recommend u build a French team I switched and it helped me so much, respect the grind tho
JackHerreraHazael	If this comment gets pinned I'll make a video discarding my whole team that's worth 400k
Alfred Saad	chris play casemeiro at lcm he get a hyper link to marcelo hbtw he has a decent shot and good defending
Kai Gwiazda	Save up for lukaku ps cracking vids â˜•ï¸
draft ok	Matt needs POTM Hazard
Jayden Scaife	4321 itâ€™s awesome
Swift Arlo	if its "prime or nothing" why do you have middle maldini chilling at cb  like so he sees this comment pls
Luke Pincott	Matt take a break after each game. It actually helps you play better
Harry Darlington	Sell Pepe now
Kai Lane	Get R9
DJC DuBZ	Fred can link with Marcelo as well
Kevin Maher	Hi Chris love the vids can u play show your whole squad and sell everyone u don't need to buy some new players
Hugo Peddy	get moussa dembele part time he is sick
Camy T	Matt and/or Chris get prime seedorf
Ludvig Ryli	Son
Campbell Reilly	Get Inform Lacazette heâ€™s absolutely bonkas
14,999,999 views	Chris try out Son I packed him in a 2 player pack he's doing sick for me
Kasper 27	Get rid of Steven Gerard and get prime matheus btw keep up the work
BJC 1	Try moussa dembele heâ€™s a cracking plur
Gi Joe Don	I know how you feel Matt fut champs is so stressful
Bradley Fraser	Get aubameyang
TheYaffaCake	The saddest part of my day is when the video ends
SHay Bucoo	Best you tubers around , I stop everything at half 3 and half 8 to watch you guys .Keep it up
Lewis Goodier	Chris get prime Raul next
Tekkerz United	Van dijk
Moomoofacemoomoo	I think you should do super weekend every month or fortnight. Love your vids keep up the great work.
AlphOmeg111	Matt put Son on the left  5 star weak foot is broken ğŸ’¯
Reflex HD	I decided not get fifa this year because i needed a break but watching you two play brings back the love i have for the game, keep up the great work lads / love the vids!
Toby Dow	Get zenneti
tommy full	Get prime lampard
Olly Ferguson	I have champions Fred and heâ€™s best player in my team and I have a good team with potm Lucas and Jesus etc
Karen Hickey	What happened to the seria team
superjay 11	Try out naby keita next vid
mads nielsen	Try prime Inzaghi
UdfmXBL	naingolan is most expensive board
tommy davis	Chris next icon get prime Lampard heâ€™s a cracking plur
JORDAN ESSEX	Chris put Gerard in the middle, pogba in the right cm then your champions league Naingolan in left cm and get Sandro instead of Marcelo! Enjoying the vids keep it up ğŸ‘Š
Artur Malo	Matt pepe is amazing love your vids keep it up
Cole Dillon	Dele Alli is amazing
sundog1012	Chris can u get the rangers badge since stevie gs gonna get them to 55 titles... and u have him
James Marshall	Chris you should try getting Kante
banzero 004	The most expensive non walkout is probably heung min son
FifaBlacker	Cracking video love the content from a fan from hull
Ben Howarth	I used Jesus Chris heâ€™s got 60 goals in 68 games
Luke Miller	Kyle walker
TRF TV	Jesus and can dike are good bords
Reece Byford	Can u guys do a set up tour, keep up good work love vidsğŸ‘ğŸ¼
boi	mega packs r so bad for me as well Im doing the hazard atm\
Sharuyan Gopinath	Naingollan is the Expencivest he is 140k, i Packet Him today
Thezimchain	Van djik is an expensive board
Kevin Oconnell	I would use fred as I've used both fred and alli and fred seems to be so much better wins the ball most of the time and fred is good for bringing ball forward and has a good shot played 3 games scored 3 with him
Daniel Gawley	Get kante
Andrew Lowson	I use one to watch Fred and he's incredible
Thomas Hepton	Matt play to gold 3 coz u get an extra player pick
xZenith	Play fred
Random Gamer25	Is that prime maldini or the second best one
Dan Turner	That team is disgusting
ikram hassan	Chris should get freds blue card
Baran Bilgi001	Chris put pogba right cm gerrad middle champions league naingoalan and Alex Sandro LB
William Quinn	Donâ€™t use 4-4-2
Sharky1234	Naingollan is the most expensive board, over 100k ğŸ‘
Alex	One of u get aguero he is sooo good great shooting and can hold the ball up well
Taylor Reece	buy prime Van Basten his the best player I've used ever on fifa. He scores every shot literally
Jxw Oblvion	Get roy keane
Craig Stephens	Fred heâ€™s much better than alli fineness shots and long shots are really good keep up the good vids lads :)
TomJ	Van dijk is an expensive board
Regret	Heâ€™s blue, Heâ€™s white, he fucking dynamite, STEVE GERRARD, STEVE GERRARDD
Sam Walker	Chris, put your nainggolan at left cm, gerrard at central cm and pogba at right cm with Alex sandro at left back, it works
Charlie Smith	Use Fred Chris as then u can put him left cm to get the link to Marcelo and put Stevie g in the middle
LJAB	4-3-1-2 is the best formation in fifa this year
Easythe Beast	If u play fred u can play Gerrard in the middle and fred with the link to Marcelo
Elz Playz	Van dijk is stupid price
Mars Barz	Hugo son 70k
Matthew Old	Son
Jimmy O H	Son and naigoolan are high priced boards
Aidan Brown15	I had both Fred and dele alli and dele alli is much better Fred is way to small
ActivistM17	Alli is amazing for me 83 Games 56 Goals and 47 assists, but due to your team Fred would fit amazing in there. Love your vidsğŸ˜Š
Ollie Burks	Try alan from Napoli
Kian Williams	I just packed CR7 in a 2 player pack ğŸ™ğŸ™ Can I get featured for the luck
defran 17	Chris I use both Fred and dele in my team and they re CRACKING PLURSSS!!!
Dahlin 9	Fred
iPhone Gamer 24	So I spend over Â£40 on fifa points at Sainsburyâ€™s, and I was buzzing, only to realise when I got home and redeemed them that they were for fifa 18
L a m e b o y	Love the vids lads, but Chris you should get IF Alex Sandro instead of Marcelo. He's insane
Eoin Mc taggart	Ur so good at fifa led
Great Banter	I was 4-0 up at half time. Opponent brings loan Ronaldo on. Goes to extra-time and pens, I lose
Isaac Legg	Chris buy lukaku up front instead of Gabriel Jesus heâ€™s so good and reasonably cheap
Eclip5e Glitch	Matt, don't get Henry. He is dreadful at close range shots
Lucas Martin	Sell de gear and get Buffon and with the saved money upgrade somewhere else
Owen Clark	do a two leg super sunday every 2 to 3 weeks
Swannie SonGamer	Class videos. Fred is awesome. Try kondogbia he is even better.
Dan Byrne	Die!
Oliver Purcell	Chris get george best
Matteus	Play once to watch Fred
Charlie Brown	Matt they will go up price when the 90â€™s move to different stats keep it right know
Elcoe Playz	Another fantastic video, keep up the good work ğŸ‘ğŸ‘
Cern Brooks	Van dijk
Nikolai Merkesvik	Matt i packed 91 rated Cruyff in my division rivals and heâ€™s fucking AMAZING, he scores every chance he has
Sam Giddings	Van diak is the most expensive board
Jupsz z	Sell Pepe
Karl Taylor	Chris when you say look at his stats why donâ€™t you just show us their attribute details which would give us a whole look at the player.
SubscribeChannel	mega packs are insane - i packed an icon neved
BR7	Chris try handanovic
XxJD HxX	Cris I would love to see you stream your a cracking plur and me saying cracking plur in school has made me popular in school
Yungen XIV	I can tell a deep thinker by someoneâ€™s face and Chris mate you always look lost in your thoughts
randulle sinstorstefan	van dijk
Recon X Warfare	Chris you should put Gerrard in middle where pogba is and put pogba where Gerrard was
dedoide	Get the new sbc reus he is class. CRACKING PLURRRRRRRR
Brad Hughes	MATT GET THIERRY ğŸ”´âšªï¸
jacob liddiard	Use dele
Jack Proudlock	1formation is the way forwardğŸ‘
Zach Wilson	cracking vid as always ladsğŸ‘ğŸ’ª
Kian Towse	Love the double upload now , really entertaining content
Leon da lion	Get salah chris
Ewan Hickman	Matt get cruyff, Chris use Alli over Fred
Exclusive	Dele Aliâ€™s hight is quite noticeable in the mid field - dele > fred
Jhy McLeod	No one is better then these 2 chaps,  best fifa youtubers and also love your vids
Captain Oskar	Most valuable board pack is probably van dijk
Freaky YT	Ye I find mega packs trash
Ben Harnett	Pls try the players u buy donâ€™t sell them straight away because they have 1 or 2 bad games u will lose coins on tax
Bill Bobs	I'm a rangers fan so delighted you got Gerrard as he is the manager now, btw love the vids keep it up
AJ skillz	Good video lads get Fred one to watch or firmino back and Jorginho one to watch keep up the good work ğŸ’™âš½ï¸
Brandon Boyoh	Love your videos lads, liked before i watched, I stop playing my fifa and watch yours ğŸ–’ğŸ»
Luke Jenkins	Kyle walker is also a good board. around 80k
Sennuh	5:48
Mr Controversial	Happened to me too Matt think you then play harder players
Alex The Penguin 9	Dele Ali is better for me heâ€™s a beast
SkillKing	Anyone else notice Chris jumped when Matt reacted to his Pepe ahhaha
Nathan Gibbons	Matt get potm hazard and potm Reus and make a hybrid
NHT SQUAD	Hi amazing vid  please feature me and buy Fernandinho
JosephMcBroseph	Chris try IF Joshua king
Gamer Guy	Use 4 2 4 Chris
Reece Mirfin	packed fabinho from two player packs, Naldo and matuidi as well, recommend them at this moment
Alex Vincent	Son
Beau Gallop	Chris use ur niangolan and get inform Sandro love the vids from devon
j-zachariah-h	Chris, been looking at the way you play and I've come to the conclusion that mabye a mertens might be a good striker for you, try him as hes cheap and will link to hazard, De bryune, dembele etc....
Lewis Robinson	Naengolan
Max Philmon	Chris, I pulled inform Lukaku in my single 2 player back from the SBC and immediately thought of your luck. But itâ€™s 500k and I wish I could sell it :(
Awais Hussain	Nice twosync lads
Saint Rhys	How is Matt Le Tissier not an Icon ğŸ¤”
daniel moore	Kyle walker is one of the best boards
Tadhg Corkery	I have champions league Fred heâ€™s sick
Shaun Kenealy	Matt play fut champs on Sunday itâ€™s a lot easier
Joe Nash	Loving the vids guys, glad your getting back into the swing of things again
Gaz	Banging video guys, every vid deserves a like!
David Lee	Chrisssssss and Matttttt how old are you guys?
Astonish Drift	Keep the Pepe
Lot Fhager	Walker go for 100k
Oli A	I'd play moussa dembele
AP FIFA	Naingolan is the most expensive board player
Jack_ 1892	Matt , stfu , you talk too much!
FootballCrazyCal 2003	Need some help need about 70k to finish the sbc hazard but I canâ€™t play no games coz I need to buy two players got no coins and canâ€™t get Fifa point what do I do plz
Aaron Hannaby	The best board pack is probably naingolan as I packed him the other day and I sold him for about 160k
Big Fatty	Use fred
ProGamer YT	Chris you got khedria at the same time as Matt ğŸ˜‚
jacob james	Gerards not worth it
Aidan Kelly	Buy gerrard as a manager
Jacob Teal	Get pele
Aaron xxxl	Got that team and your getting silver 1 wtf
Dylarse 2013	Chris why is pele only like 5mil this year and in the last fifas hes been like 15mil
Connor Groom	Get inform gundogan
Jjc 16	Matt get butragueno
gbhg	CHRIS I would personally not buy a Icon for the sake of having one, make sure its a good investment. Especially at right back (you wonâ€™t find better than Walker). As always keep up the good work lads
LR 27	Can you say happy birthday to my friend big day
Connor McCullagh	If it was OTW Fred I would play him over alli but because itâ€™s normal Fred I would play alli
EthWag XD	put your naingolann in rcm and florenzi in Rb and switch Gerrard to CCM just because its centre doesnt mean its defensive remember that
Matthew Crompton	I would chose alli as he is taller and Fred is to weak
poopoopoo54321	Champions League Fred is OP
Robbo 0113	Do more pranks also love the vid
Shaun Shephard	Chris get the alternate chelsea kit looks fresh
Nathan Harris	Don't sell your players because you loose money great videos
splizzonly	Get henry
Tr3yway 69	AA9skillz cracking plur!!!
Rasmus Bach	Radja naingollan from Inter is only 85 rated.
Hey thats pretty good!	Son
Liam Wolstencroft	Hi Chris and Matt I'm in Majorca right now enjoying the weather and watching twosync is the best feeling ever
Bilaal Tajbhai	Keep ur formation for 20 games and if u lose more than half change it
Caelan Wirley	Put Gerrard at RCM so you can smash long shots to the far post with his right foot.
Mitchell Robbins	10 games and 7 goals with a striker is poor unless it's in Fut Champions
ASTROAMP1	On paper stats aren't the same in game and don't determine the players attributes in game. Chris you need to look at work rates and attributes, because Freds in game stats, he has better strength than Ali.
Harvey Loran	Get Thierry Henry
angryPigeon !	Keep up the great work, loving the videos! Bet i dont get featured
Ronaldo Cristiano	Chris..get the prime Henry
Muhammed Hussein	Seriously how can you have 5 mid rolls on a 11 minute video....
MachineGun Gamer	Chris buy the leeds away kit
JP PLAYZZZ	Chris you legend ğŸ˜ğŸ˜ğŸ˜ğŸ˜ğŸ’ªğŸ’ªğŸ¤˜ğŸ¤˜ğŸ‘ğŸ‘ğŸ‘ğŸ’¥ğŸ’¥ğŸ’¥ğŸ’˜ğŸ’˜
Valid gaming	Nainggolan is the most expensive non walkout
Barry Keane	I use 433 and Iâ€™ve won 6 games in a row
Barry Donnelly	Mega packs are shocking got nothing then opened 1 25k pack and got koulibaly
Jasper Savooijen	Still waiting until you guys get a walkout at the same time!
GhostM3RKZ Arm	Best vids ever keep the good work up wish Iâ€™m I can be in one of your vids
mikez2525	4231 wide will suit you
Sam Markillie	You say prime or nothing what about Maldini Chris
mohamad biparva	blive it or not, I have to pay 10 times more than you for every kilobit of the internet to watch things like you guys and I would say this, it worth every Toman, By the way, I'm from IRAN
Amir Wilson	41212 second veration is great for passing thatâ€™s why I use it
Joe Cole	Should go for scholes and lampard for the other two cm positions as you already have gerrard would be insane that
gaming with mitchell fletcher	Lakaku is 200k+ I got him in a free pack in my squad battles
WSH HSW	I would play Fred he is insane for me but deli isn't good on this game I feel like
Kirsty McLaughlin	Chris save up for George best
Fifaproducer 1	I think you should try and save for Ronaldinho he would link to Marcelo and then you can play gerrard as middle cm
Kylekiller321 hardy	Just eating a roast dinner and watching your videos ğŸ˜
Ben Mahon	Chris love the vids by the way but u say only prime icons but u have middle maldini
FarhadAlii	I packed like 3 scream cards plus Isco and Greizmann in the same pack :)
BazzaTheBeast 11	Enjoying the vids crack on with super Sunday âš½ï¸
roadtowillo w2w	Great vids try 4-2-2-2 with the two cams in get in behind and free roam itâ€™s a cracking Plurr
Josh Hill	Chris donâ€™t buy firmino back you should buy Eriksen heâ€™s amazing and I use 451
Dylan Cousins	Chris get scream fellaini
Harris Thomas	Chris are u eventually gonna have an all icon team?
Wolvezz907	Chris try mkhitaryan
Andrew	Chris put naingolan lcm gerrard cm and pogba rcm with alex Sandro left back
Ace	Chris use niangolan in the cm he would link up with hazard and the icons and Sandro if u still have him
Alex Durrand	Chris get lukaku heâ€™s qualityğŸ‡¬ğŸ‡§ğŸ‘ŒğŸ¼
Ivan Nedkov	Sell Marcelo get mertens in cm
FF Gaming	U should discard mats Lucas potm
Lil Brownie	I'm thinking VVD is one of the most expensive board plur
Jacob Jackson	Best community on youtube
Craig Fleming	Get Harry Kane heâ€™s class
J1W	van dijk is the most expensive board player 150k
Cpt.BabyPenguin	Can someone help me? Should I keep Vardy and buy Jesus or not?
Josh Passmore	Willian is different gravy!
SourStock	Back again with my comment about Liniker 92 prime same again at 8:30 eh. Chris you know you want to
Rikard Hellgren	Get prime Larsson he is good
finn waldron	Nainggolan is the most expensive board
McSwagger _	Just gotta say, the thumbnails have been quality recently, I donâ€™t have fifa or a console because mine broke ğŸ˜‚
Jamie Reid	WHOS BUZZING FOR TONIGHT
CRiSB	Put Pogba RCM and Gerrard Central, then put the Nainggolan in for Alli and drop Marcelo for Sandro, then everyone on full chemğŸ‘( Hazard and Nainggolan get belgian link)
Morgan Mockford-allott	Put Iâ€™m your potm Lucas Chris, oh wait...
Liam Tomkins	Just played footy match won 5-4 then get to relax and watch TwoSync, nothing better to do. Keep up the work lads
Neo Persson	I had Fred and he was a machine
Philippe Boulas	chris play casemiro
Miki_2boy 7861	Sell stevie G and buy prime Socrates or Cruyff
Kia Thorpe	Get Kante both is you he is all over the pitch and has good agility and keep up the good work lads, vids are amazing
BossAlstar123	Buy henandez striker
Boom Xhakalaka	Matt you should try out Crespo.
the last try	Iâ€™d go Fred mate just so you have a little bit more defence in the midfield
Simon Martin	Buy esubio
Jack Quinn	Get rid of slippy G and get the king of kings Henrik Larsson
Harry preidt	5:46
Ryan Swancott	Most valuable boards are promes, fabhino,rashford and sanchez
Connor A H	Deli Ali
Pxwell 999	Guys get scream calhanoglu as a super sub he is insane, keep up the good work
cheesehead 2004	Kyle walker Fred Jesus
ARSH ABDUL	Matt buy prime eusebio i bet u wont be dissapointed my friend
Mws Show	Matt get prime Emilio butragueno
CrlRacingLeague	I got gold 2 in fut champs but was so unlucky not to get gold 1 btw mertens is the goat
Harry Hinton	Niangolan is an expensive board heâ€™s 150 k
Samuel Irvine	Van dijk is the most expensive board
JM Gaming!!!!!	Great vids guys
rajunior campbell	Put niangolan in the squad. Link him with hazard and put sandro back in.
avfc 69	424 is sick and love the videos guys keep the hard work up Chris I think you should play more game
Daniel McNally	Been watching since you guys made 3 minute videos. Loving the two a day recently. Keep it up lads. By the way. Try arnautovic heâ€™s a cracking plur
Arbaaz Ali Turk	Get ones to watch fred
Square root of potato	Chris, if you put gerrard at center cm and pogba at right cm, you can put your ucl naingollan at left cm
Horace King	I rather dele ali
SuperDonnan 69	Go 433(3) then switch to a preferred formation then you can get all you goo plurs in
Isaac Sewell	Get Fred and swap him with Gerrard for long shots
DoughBoy	I have the blue fred hes amazing only bad thing about him is that he is so short
Jay Dos Santos	4-3-3 holding
Osision	other than fifa what games do you guys play in your free time plus been here since fifa 14 cant remember the subs but you get better every year
RJC Coyle	Get gundogan back
tony thornton	Chris get George best rf next
Harrie 344	Son or martial ğŸ¤˜ğŸ»ğŸ¤˜ğŸ»
xTeqno	Fred definitely
Ben Stone	Chris itâ€™s my bday today can u put this in the vid
SPISAKMCISF 1	Can you shoutout my friend Sean penny heâ€™s a cracking plur
Patrick Ward	Chris naingollan goes for 160k hes a board i packed him
Taylor Carson	Chris next save up for Ronaldinho
Martin E	Got Salah and Mane from 35k packs
GTX Samurai	You guys are great, always make my day and btw way who should i buy for 70k from bundesliga or league un, would be amazing if I got featured guys!
Ming Jin Lim	Hi chris your maldini is not prime
Aleks Stoimi	Stop asking for likes chris its  getting annoying !!
Charlie Harwood	Van djik is like 100k
Strato YT	Chris get eriksen at cm he has 89 long shot great passing and amazing composure which is perfect , keep up the great work
Eva Nyhuus	For those who says fred over alli nope fkn nope i just had a match with fred the opponent had alli Fred Got eaten Skive like it was rape on FeWc stadium
Floyd scott	Matt get Henry
Charlie Bravery	If you want Gerrard in the middle get Fred at LCM for Marcelo link
Willie Kilpatrick	Fred ones to watch
Jack Moss	Chris! If u put Fred in left cm then you can play gerrard in the middle of the midfield as Fred is Brazilian
Connor Peirce	U guys need go brings back the cracking goal from viewers from Fifa 17
Kirstin Rigg	i got told to watch you by my mates and they say your great and i agree with them keep up the good work
Will Scott	Marhez is a good board
ali alsharif	Plz start doing polls again
A didnâ€™t get any snowballs martin	Heâ€™s blue heâ€™s white hes fucking dynamite Steve gerrard,Steve gerrard
Connor Aitken	Van dijk is expensive
JÃ³hann Snorri Sigurbergsson	Use Gerrard as an CAM
Shay Armstrong	Sbc or sell when he goes up in price when next upgrade happens
Freddie Cheetham	Chris I know at one point you are going to keep switching League.ğŸ˜‚ğŸ˜‚
The Blue Pineapple	Chris go for Baby R9 Ronaldo. He is insane.ğŸ‘ğŸ‘
Terry Smith	Matt shud bring on your fut champs sabitzer in games guy is mental in the current meta
Fl0RE ya mum	i rate your videos, but you should be getting gold 2+ in WL if you play this game everyday
James Holland	Openend a sbc two player pack only 1 and got 89 David Silva hahaha
Salmoney Fifa19	Is gerrard aâ€¦ CRACKING PLURRRR
charlie Fitzsimons	Stick to a formation I use 433(3) itâ€™s so good especially for your kinda plurs
Pharaph	Van dijk is probably the most expensive  board! loving the vids keep up the good work both!
Macauly Snook	Don't buy prime cruyff Castro used him extensively and then said the 89 version is much better
Sonny Lee	Willian and Jesus are good board packs
Luis Costa	buy EusÃ©bio mate.
Glomlaks Plays	Buy Alex Sandro as a left back
The Stunt King !	Van dijk is an expensive board pack
Anthony Torrioni	Trezeguet is a god, scored 23 goals in 12 matches for me in online
Harvey Gaming.24	Nangolan
Shaky Snake	Get lukaku in striker heâ€™s a beast
Myride Mypride	Also do custom tactics !! Swap formation in game when you struggle
William Goodwin	More gameplay plz
Jack Weston	Chris will you ever start streaming on YT or Twitch
Tobyelliott Etc	Keep Pepe as he will go up when they are out of packs
Leo Rodikis	Drinking a vanilla latte for this vid,Keep up the smashing work lads
Nigatron	Swap Stevie G and Pogba then put UCL Radja at Left CM and get otw Vrsalijko at RB
Haz got teckerz	Chris mate you donâ€™t have a ultimate team you have a super ultimate team
Nolan news	I play Jesus in can he's amazing
DUKE_ VLOGS	Chris get rid of Marcelo get Sandro then put pogba right centre mid then Gerard at central centre mid then put that champions league nainggolan at left centre mid the nainggolan will link to Gerard ,Sandro ,cannavaro ,and hazard
FIFA- Ed	Chris wonâ€™t pin this
Mads JÃ¸rgensen	Sell Pepe
vinnie vincent1	Good vid again but you should do the old pranks again ğŸ˜‚
Sefton Omara	Wtf happened to mats team
Jude  Mackey	Your nan
jack the pikey	Sell pepe and get shaqiri
Fifa Weekly	Packed Gaza Baza in a 5k pack while I was watching your vids
Sam Burke	Do a Super Sunday on one of the new mini games
Celtic Talk and rumours	5k in 9 mins phenomenal I guarantee this comment wonâ€™t get pinned
Penny Brooks29	An hour early??
IAS	Chris save up for Eriksen
gazzy D	Love the vids keep it up
Robert Winton	Fred left cm to get link to marcelo Stevie center cm
ugly nit	Sell delli
Mohanad Mannaa	Hey chris try out 4-14-1 or 4231 great formations
Louis 77	Yesterday u legit said sokratis is amazing then u go sell him ??? Fresh vids tho please feature this
Jack Burford	Great vid really enjoying your vids at the moment keep up the good work
Benjamin Salter	I got shaqiri and he cost 90 k
Jordan 97	Mega packs are my favourite as of yesterday, packed prime petit! Now my team is something i could never of dreamed of as a casual
Dylan Kerr	Naingoolan, Van Dijk and Fabinho are the most expensive boards I think
FATMAN	What camera angles do yous play on ?
Matty Ghani	If you pin this comment I will go on all of your past videos and like every single one of them
Dede Curley	Defo alli just because his finesse shot are crazy and really goog in the air love the vids lads!
Lee Blackhall	One of ye save up for gorge best.
EvAVenom	You two should be on 20mil subs, the only reason why you donâ€™t gain as many subs is because all your viewers are loyal, love you guys been here since your very first gaming series on fifa 13â¤ï¸
Fletcher Emery	Love the vids so much
Roman Jarvis	Matt try lukaku
Ollie Penrice	Gerrard is a crackin plur chris
jack r	Use ninnagolan can't say his name inter Belgium put gerrard next to him and get a Belgium epl manager
Liam Fc	I would play dele cause he is way taller
Rian Robertson	Iâ€™m a rangers fan great to see you have our manager what do you think of us
Ninja Kappa	Chris your team is unbelievable keep up the good work
Rustarkkar234	Will every title start OMFG?
Little Slime	Keep him!
Banta Boys	Chris put Casemiro where gerrard is and but Gerard in the middle and pogba on the right
Daniel Halvarsson	Van dijk 165k
Viktor Widman	Get Stoichkov at ST and score some absolute bangers.
DONKERZ 123	Jesus your vids are so great keep up the good work lads!!!
Hayden Porter	Look at nidvid he looks really good
SBCFIFA	Chris try Baby or Middle Gullit, way better than Prime Gerrard for me
AJH	Van dijk, not Rn tho cos heâ€™s an if
marc mansfield	Chris should sell Marcelo and buy Alex Sandro and Nainggolan
PNTHA Envy	Chris get Dele Alli or Inform Sigardsson at RCM. Both are cracking plurs.
Alexander Dordas-Quieti	Get Baggio great plur for a great plaer
Leon Rondel	Should use mkhitaryan
joe davis	Get aubamayang
93z	Use alli quality player, free gets pushed off the ball too easily
SAINT x SNIPEZz	Theyâ€™re only voting Fred because theyâ€™re too poor to buy alli, alli is so much better than Fred attacking
Jindi Singh	Get lukaku heâ€™s amazing, he scored 17 goals in 10 games
Jonathan Higman	Letâ€™s get Super Sunday At 8:00pm!
Bailey Norton	7mins 5k likes ğŸ”¥ğŸ”¥ğŸ”¥ğŸ”¥ğŸ”¥ğŸ”¥ğŸ”¥ğŸ”¥
Gieza Kieza	Chris use alli he is unbelievable I have him
Sim Justice	Radja Naingolaan
Sebastian Villota	Chris if you use Fred you can put Gerrard wherever you want
CharlieAKAEnitityzz P	Keep up the amazing work your both CRACKING YOUTUBERS !!!
Connor Pocock	Chrisssy boy, you should get your Sandro bsck at LB and then put the UCL naingolan at LCM gerrard at CCM and pogba at RCM, loving the vids boys
Bets_ Kerriar	Who remembers there intro where it said if this video hits 2k likes ill slap Matt around the head
ahmad alam	go buy serio B From barca scream card cause u liked it and pleace gerrard next to him and put carvajal or roberto rb
SaVe reflex	Scream card at 5:49         Thank me by liking x
Asian Alan	This is annoying now, Chris play a match
Andrew Boyce	you should use Fred as he's left footed and links with Marcelo leaving Gerrard free to play centrally and Pogba on the right.
Jim Cherry	Van dyke
Jack _Garven	Love your vids keep it up from Scotland =)â¤ï¸
fab HD	Walker
Thomas Kelly Reynolds	I use 4-4-2 with a team worth 20k and in my first fut champs I am on 13 wins and 7 losses
Unknown Gamer	You should go for an all icon team
Lloyd Rawles	Cracking stufffff love the vids atm
Cammy Tuckett	Son is an expensive board
CR_Silva _17	Chris, you should put, Steven Gerrard in the middle then nainggolah ucl in the left and swap Marcelo for Alex Sandro.. Nainggolah is better then alli and Fred combined
Kevin Shannon	Alaba.... Like 80k
Jordan Knibbs	Get inform Ilkay  back in there
BjÃ¸rnar MÃ¥ge NÃ¥	Chris, Buy Aguero BEST ST!!!
Kieran Tillbrook	Kyle walker
JBxXx	Fred
well Off	Use Fred 100% he's much better all round
tommy gill	Liked the video video before watching and got my brewe
Billy Armstrong	Chris is only going to sell gerrard in a couple of days lol
lucas bates	4.5k likes in 40 mins GG
Max Hastings	Get Harry Kane and Kante to link with pogba
Kyle Games	Buy macherano turn him into a cm then cam the cf the St for super sunday
ZLD Gaming	Bad mistake matt socrates was great
Preda Black	This game is broken really shot error is a problem,  you can even tell when your going to get a goal..
Bradley Washington	Thanks for the great vids guys keep it up
1982fuckyou	VVD worth a bit n not a walkout
Gary Swindail	Gueye is better than Alli and fred
T Boi	Alaba is a good board pack. I got him and sold him for 85k
vfbx YT	mint vid bois
ItzJustArchie !	Keep 4321 chris for the rest of fifa
THE GOAT	Same happened to me Mat. I started 10-3 on Friday. Last week I was 10-4 on Friday. I felt I was going to improve on last week. Bang, hit a wall of losses. I couldnâ€™t win to save my life. Finished Gold 3 two weeks in a row.
Simeon . H	every formation has weak spots so you might aswell use one and learn to fix them
Flyn Middlemass	get ipswich kit chris plz
Arthur McGinnis	If youâ€™re watching this video like this comment
Alhamad Fakhrou	You guys shouldnâ€™t close your eyes when getting a walkout. Youâ€™re missing out on the cool live animations.
BoLT ReFlex	Radja Naingolan is the most exepnsive board pack, he goes for 130k btw watching from sweden
william watters	Pick Fred heâ€™s a very good cm on this game I think heâ€™s better then Alli 100%
BVB fan	help me out on youtube please
Archie Parsons	Put son in St he has scored 17 in 12 for me in fut champs
Dylan Robertson	Mat please get prime cruyff
Oscar Hernandez	Chris try Lukaku at ST cracking plurrr
Thomas Beresford	Lads
CastmanMC	What happened to the Matt with glasses?
Luke Major	Matt get van bastern
Adriano	Chris fucksake Man U got one of the best cm in the game on the bench play niangolan lcm gerrard cm then buy alex Sandro and everyone full chem
isaac smith	Love the vids
Patrick Wik	Legends, keep lÃ¥ the good work
Aiden Field	Been subscribed for 4 years and every video Iâ€™ve watched have been absolutely cracking keep it up guys. A question use play Fifa but what team do use support cracking plurssss
Max Johnstone	Chris you should get figo or best in rw
Benjamin Neville	"Prime or nothing" but has 92 Maldini
jeon bassi	chris get prime get scholes he is around a mil but he is absoultly worth it
Sinead McKeown	Chris. You saved up for maradona last year. This year save up for icon cruyff
AL-HD	What happened to the untradeable seria a team?
M Harvey	Nainggolan, martial, son, Fabinho
George Hallam	Does any one recommend a good striker that could replace zaha that's under 60k
Jacob Spencer	Just started watching love the thumb nails your both class YouTubers keep it up
LAGaming 57	All I do everyday is keep on looking fo these vids there amazing well done
ItsCharlie C	Just wanted to say, I really enjoy your videos and amazed how you can do two a day and keep up interesting content, keep up the good work
Spencer Guy	Cracking plur
Joe	Use fred over alli i have them both but fred is a machine
CloutGang	Chris ur not good at fifa
jsm 2005	fred
Soccer Sorcerer	Chris's Moto is prime or nothing but he doesn't have prime maldini
Alana Weir	Virgil Van Dijk and Naingolan are the dearest boards
J H	put gerrard on the right side of midfield
# KsiToWin	Get salah for Willian or is that a step too far ?ğŸ˜‚
Joe Brooks	Chris your a ledge,love the vids
Jason Stanley-McKenna	Chris put naingollan left CM Gerrard central CM and get Alex Sandro back at lb, everyone will be on full Chem and you can use naingollan. Like so Chris can see.
Daniiel Marshall	Iv used both Fred and alli but I prefer alli because heâ€™s stronger and taller however I replaced alli for IF Gundogan heâ€™s sick
Ethan Haugh	Keep a hold of Pepe heâ€™s not going for a lot on the market
Eddy Poole	Chris get inform arnautovic he has scored 14 in 8, btw love the videos
Josh Leader	Son, Fabinho, Walker are a lot for below 86
Murque	In Dubai on holiday and was shouting at the screen at 3:30 but realised there is a time different
Connell Naysmith	Someone just get crespo!
Kolje fifa trader and reviewer	7 goals in 10 games is awful. My Van Basten 89 has 36 games, 59 goals and 13 assists. And 30 of those games are weekend league the 6 last are in div 3 lol
God _	Van dijk
Xxx-TT	Naingolan is expensive for a board
Jack Broadley	Naingolans the most non walkout board
Dessie Collins	Love ur vids from ireland chris gerrard is a CRAKIN PLURRR
con con connor	Get luis figo he's amazing
BenjiM3	In a mega pack within the last 2 days Iâ€™ve opened 3, for pogba salah and IF bailly
Rimtop Rez	Get zola mat has a class card
RZ9	Walker
Kingy Reacts	If you need a striker choose Alan shearer a Geordie hero ğŸ‘ğŸ‘
Morgan Jones	alaba
SGT_jakeybol 26	Son around 70k
Dino	Chris get inform Lukaku
Cameron Gore	Chris get a skin fade lad
Theodore Leimonitis	love your vids from Australia. Btw Chris YOUR HELL OF A PLURRR
The J07	I bet you wonâ€™t pin this
Harry Dixon	Would you ever consider streaming your games on twitch or YouTube ? Love you videos brightens my moodâ¤ï¸
Mackenzie X	Chris Iâ€™m watching from Scotland ğŸ´ó §ó ¢ó ³ó £ó ´ó ¿
Crushy	If you shout this out you will have amazing pack luck for a week
Jon Bray GAMING	Matt if you get Henry u need to fix his balance ive heard he is great when you fix it
Ace Gaming	Naingolan is an expensive board
The Crazy	Chris..... You have said: only prime icons. Is Maldini prime?? ğŸ˜…
Debbie Hazel	Get the Charlton badge
R Walsh	Matt donâ€™t sell scream Pepe he will be boosted and will go up in price,keep up the good work :-)
Cian Fitzpatrick	Chris if itâ€™s not broke donâ€™t fix it
Ignacy Ligara	Fred is the man
Bravoak 45	If you sell all your contracts you can make 600k
IIDeadeye	7.5k packs are the best by far special packs give me nothing
Russell FC	You guys are my favorite youtubers. Been watching since 2014
Pr0x Th3iller	Youâ€™re a legand and swenstuger
Luke Darley	Chris u should try save up for Roberto Carlos heâ€™s a cracking plur
DT03 Gaming	Get Sandro , put niangollan and then put costa LF
Rasmus Holmberg	Chris why dont you put pogba in right cm and Gerard in the middle and then casemiro to the left
Sick salmon	Van dijk is an expensive board pack
TheSuperdan22	Reus is really expensive board
Brj575	Can I have free Fifa points please ğŸ˜‚ğŸ˜­
Darcy Drane	chris put ur icl naingolan at lcm, Gerrard in the middle and Alex Sandro at LB, cracking Plur
Gamestand 5	VVD is a expensive board
Da Fifa Player	Chris, Mat craaacking YouTubers.  This will probably never get featured but keep up the quality vids.
RanderZ	Use Pepe for. A few matches and if he don't do well use him for the screamer sbc if it is out
Max b	you can compare players by select one and stand with your cursor on the other player. Then look at the stats at the left side on the screen. Kind regards from the Netherlands :)
Fred Spellman	Fred as I have the same name ğŸ˜ğŸ˜
BlaqeDk	iÂ´ll put fred, cuz of the pace and definden. Love from denmark
Todd Clarke	Shevchenco I would purchase !!!
HoRiZeN 14	Sell Pepe now cuz heâ€™s got 90 of Def and Phy which is pretty good for a CB so when it changes heâ€™ll go down
Jacobs Tribe	Nainggolan
thorno78	chris put ur Blue UCL Naingolan at LCM, Gerrard in the middle and Alex Sandro at LB
The Gamer Beast	Chris what do you need to do to certify a RB or a LB?
Jmarshy2004	Got Fred in a two player pack at the start of fifa, Iâ€™ve used him in every team ever since and heâ€™s class
Joeplays HD	Try deli Alli heâ€™s amazing Chris
Ben Harrison	Chris put hazard on free roam as he is so good and effective
Charlie Maguire	Kyle walker
Coolkiller_03	Naingolan is a very expensive board
Evan Harrison	Too many icon defenders angry an attacker even if you replace hazard icons are better
omar hd	Henry
fifaninja 292	matty where are you from because my uncle has the same accent as you and i dont know where hes from
Barney Hirst	Get prime schevchenko his card looks insane, better than Henry
Rory Douglas	Get scream busquettes where Gerard is  and move gerrard over
Top 10 goals	100% Fred, I've played with them both and alli doesn't seem to make that much of an impact
Yaboi 11	Chris you say prime or nothing but your Maldini is not prime...
Daniel Ganley	Walker is a lot and he is only a board
Hairy Monkey	Get champions league jesus he is a beast
Brap	Van dyke is a valuable board
Jordan Lowe	Chris i have used both delli alli and fred and hands down fred is so much better
CommentateOn Shit	I play 4-2-4 and itâ€™s amazing
Josh ryley	I prefer raheem Sterling to William as heâ€™s quicker and makes better runs
spectre_ rooj	I was just wondering if u could try seri as cm he is brilliant for me
Joe Betts	Keep this up lads you are the funniest and have good luck unlike me
DAZZAT Thomson	Using one hand is hard
BadBoyGun 1	Get prime BEST her a he'll of a PLUR !!!!!
Swainy	naingolan is the most expensive board pack my g
Alfie Shipley	Potm Reus cracking plur
Callum Richards	Chris thought you only get prime? Thatâ€™s not prime maldini
Ben123	Van djik sells for 150k
Andy Ing	Matt get prime stoichkov he is incredible
Jay Paterson	Chris get eusebio he is amazing prime or nothing hahaha love the vids ğŸ‘
Louie Chambers	play naingolan in lcm and get a Belgium or roma lb
Dragonclash10	Yeet
Callum Lucas	use fred heâ€™s the most underrated player on the game
Mason Ancill	Try inform arnautovic he's a cracking plur
Cian Duggan	Why did you delete your fortnite videos
Danny Copping07	mega packs are bad for me to
natalie cassidy	Vardy scores in every game
Liam Manson	Nainggolan and Van Dijk are the most expensive boards
Invalid Bean	Chris swap Marcelo for Sandro, niangolan lcm Gerard in middle pogba rcm
Savren Chaplin	Chris get Magic because Pogba and Gerrard both have high attacking work rates and medium defensive so you'll have no defensive midfield option
TristanBirkir	Fred
Aiden Gellar	Anyone else just see that someone bided 199,000 on Pepe ğŸ˜‚ğŸ˜‚
Bobby Byk r	Try seri Chris heâ€™s a beast
Kezza Tron	Chris you realise your maldini isnâ€™t the prime one btw
William Gardner	GET IF MITROVIC CRACKING PLUR!
SHD	Fred easy all is trash love the vids keep up the good work
IVIR Matt	Liked The Video Before I Even Watched It, Already Know Itâ€™s Gonna Be A Bangerrr! Steven Gerrard (Cracking Pluurrrrr)
Cal_Dunne_01	Chris put Fred in LCM and gerrard In RCM so they are both on their predominant foot and Fred will keep Marcelo on full chem...love the videos keep up the good workğŸ’™
Bad Man	What a banger
Alex Newell	Firmino is better at striker than jesus
Mackenzie Chapman	Get prime zola
Trash_EU_Pin g	I didnâ€™t get the video in the sub box neither did I get a notification but I have notifications on
BeastyTom	In my opinion Gerrard isn't worth 1.7 mill
jake. scoots	100% charge watching the cracking youtubers
Oskars Grandans	Matt lets be realistic 5star skillers are 2star skillers 4u
eZ XanZz	Chia get Ronaldinho
ThisGrizi	Chris your record with hazard is tragic
Robert Keys	You should def try George best. He's a banger
Jasin Kodzodziku	How can you barely get silver 1 with that god squad?
AssasinGamerHD	Fabhino and naingolan most expensive boards fabhino 90k and naingolan 150k
Kyle Wilson	Get Sandro back and put gerrard in centre then you can put naingolan in lcm he will get full chem
Bernard Scott	Chris, you should prank Matt. Love the vids by the way.
Jaden Hale	Van dijk board
Ceejay Ross	Nigolan heâ€™s a board worth 130k
KaiCameron 10	I think u should play Dele Alli, Iâ€™ve played a lot of teams with him and heâ€™s a CRACKING PLURğŸ˜ŠğŸ˜ŠğŸ˜Š
Tomas Gaming123	Buy henry at st matt
Lil Bon Sucks	Donâ€™t rate mega packs, absolute wank
Joe Stevozz	Can dijk
Rory Nelson	Do they live together
caleb Zoromski	Keep him he will get Better in certain parts of the year
Lisa Scorer	FREED all the way
Itâ€™s Macky	Chris please try lewandowski
pinap replay	Radha niangolan is expensive board
Sam Mulholland	10 games 7 goals isnâ€™t even that good ğŸ˜‚ğŸ˜‚ğŸ˜‚
Danielwalsh013	Alright Chris mate I think you should try a new player at LB because last year you had Carlos and now your on about getting him again
Preben olsen	Van Dijk 150k
Ben Salmon	Sell him
NathanCamerron	Keep up the good work!
Cooper Rogers	Get del piero please
TheCrazyCucumber	Who has the courage to dislike a cracking video
C Mennie	Naingolan most expensive board
xKingz x	Love the vids guys, after using both I can tell you I prefer using Fred, he makes good runs and scored whereas my alli just stayed too far back and never went up
Thomas Harris-Garrido	433
Lucas Reavey	Chris get prime Best heâ€™s class ğŸ‘ŒğŸ»
John Gibbons	Itâ€™s because you were doing so well therefore it matches you with better people
Daniela Jackson	am i the only one hoe likes the vids before i watch them cuse i now the will be the best
CCA 3	Absolutely loving the vids keep it up
AJ Mandeville	I packed Brazilian Ronaldo 94 heâ€™s amazing love the vida
Shokker	TRY AND GET INF VAN DJIK BTW UR VIDS AREAMAZING KEEP IT UP
Dylan Bunting	Can I have a shout out
Kobey Davidson	Feel the same Matt, dominate and lose get dominated and lost
Elliot Sheriff	Gabriel jesus is an expensive board
XGRT	Get inzaghi
William Tyler	Matt I feel the second day of fut champs is always dreadful I can go 8-0 then the next day get slaughtered by garbage because my team just dissapears
NYTRO S	Chris try lacazette up top
Lounary	Van dijk
oisinmurphy 9	Sell De Gea and buy Courtois apparently heâ€™s the best keeper in the game like if u agreeğŸ‘ğŸ¼
William Limbrick	Chris try Seri in CM heâ€™s so class ğŸ‘
FlawlessAndrew	Matt if u saw someone nodded on Pepe for 199K when he sells for 30ğŸ˜‚ğŸ˜‚
Ninja	Matt i think your st icon will be henry
ianthem4fia	shouldnt have sold kdb but its aight
D0M 34	Naingolan Reus Fabinho and van dijk- most expensive boards
William Lauer	Van disk is the most expensive board 100k +
Alex Paletta	Chris get zola
Usy Magik	Van Dijk is the best value board player
john ioe	thierry henry
Jamie Walker	Chris Firmino is a walk out, Fabinho is probs the most expensive board
Iwhiitey 09	Love the vids keep up the good work also Chris get Hernandez in st
EthAgamer	I play dele alli rcm   Better than my baby Gerard 100%
Jmatbass	Fred
Craig Gordon	The pack is at 11:10 thank me later
Dylan Jimenez	Matt you do know Felipe Anderson has a inform
Epic_ Skillz123	I'm loving the upload schedule  -Kai
Finboblegit	Get champions league Fred heâ€™s ridiculous. Cheap Kante?
Peter Fitzsimons	Van djik
Heisenburg	use 4411
Andrew Eary	Chris Try prime rion giggs . BEST PLAYER IN GAME . Play him ST
Niall O'Neill chambers	mega packs are rawcus
Bouncy panda Racoon	Chris get prime Hernandez or tiery Henry
Extremebeasts 34	Chris save for George best heâ€™s a cracking pluuuur
Harrison Thomas	play fred heâ€™s a beast at long shots and all round i had both of them but fred was better keep up the good workğŸ˜Š
Jake lees	Literally yesterday matt saying how good socrates is, sold
Oliver Berg	Get kovacic. A lot better than Fred imo
Max Wallin	Keep the good work upp lads craking plurrr
Flynny 147	Chris get baby cruyff...I know you said prime only but heâ€™s amazing
Adam Martin	Walker is worth 90k
Rio Dennis	Chris get Jorginho one to watch heâ€™s class and has 97 vision
Marvel fan	It is 92 Raul
Abdul The destroyer	Naingolan is the most expensive non walkout
Aidan Thompson	Hi
Sarvesh S	Try cruyff as your st
Hussein Van Der Deen	You can't blame luck after losing 8 games
southeastthree	I can confirm about ST Jesus, mine has scored more goals than played. Enjoying the videos keep it going lads! ğŸ‘ğŸ»
Luke Bills	Get Alex Sandro, play champions league Radja LCM behind hazard then gerrard Cm and pogba RCM, thank me later
Misty	Chris David Alaba goes for 80 k at least I got him cracking plurrrrrrrr
smokesniper1980	No matt i completely agree saterday game play is awful i was 9 and 1 on friday and then saterday came I won my first game. And lost seven in a. Row my lowest result in those games was 4-3 i couldnt keep a. Clean sheet to save my life
Cricky Mcguigan	Get matic chris hell of a plurr
ISTyaboi	I swear every 3minutes theirs a tiktok add
Rory Franks	chris put gerrard in central cm and then put your naingollan left cm and alex sandro left black
Jump scares And reactions	I seriously canâ€™t get and fifa points havenâ€™t got money yet nooo Iâ€™m gonna miss scream cards
Liam Bennett	You should do 'MONTHLY MAYHEM' this is a super weekend every month
Akil Morris	Make super weekend the last Sunday of each month
Andy Jackson	Fred is left footed and would link up to marcelo so you can play Gerrard in the middle and Fred is class this year.
Lewis Inkster	Do you two live together now
kev eko	Chris try Arnautovic IF he's a crackin plur
OMA {JESSE}	Nainggolan is pretty expensive for a board, packed him and sold for 180k ğŸ˜… btw keep up the good work lads ğŸ’ª
Edward Ball	i just cant get my hands off this game<ty for the feauture
Charlie Wilson	Whoâ€™s house do you record at?
Charlie Henry	Nainngolan is expensive
ItsKian HD	Naingolan expensive board 100k plus
Josh gaming	6:45 you can see a guy biding Pepe for 199kğŸ˜‚ on the first page 2nd one
Leo Ascroft	Wow im sick off matt copying chris do ur own thing keep up the good work XD
marios loukatzie	Chris get inform king he is beast in fut champs played 30 scored 47 and 17 assisits
Mitchell Beeks	Get prime Henry up front heâ€™s the best striker in the gameâ¤ï¸
RVMP_Reloads	Hey Chris would you recommend Pogba over Fabinho
Rhys Howarth	Do you guys play cod 4 and can i do some videos of u 2 playing it ?
Kylan Stokoe	Fred because the pace to attack the defenders
callum games	You should get George best for your striker
Gromit123456789	Defo try dele alli his pace and physical are great and he bangs them in with insane shot power. Also u can shout BAMIDELE (his first name) every time he shoots itâ€™s great fun
Bolu Lekan	I have used Fred for around 200 games he is the G.O.A.T
Dan Carr	Chris go for George best
big up george	GET Emilio ButragueÃ±o
how dare you man	Get prime Hernandez in st he was a beast in fifa 18 for you
billy kane	raider games and iduel2010
Ben knowles	hugo is most expensive isnâ€™t he
Wez J.D	Liked the vid before it started, my whole family watching from new zealand
Potatis Ducktrucker	Chris always have stacked team at the begining later on he gets poor
Dan Noone	Roses are red violets are blue Iâ€™ve got my tea and what about you
Scarlett Andrews	Chris you don't really play FIFA much. Why have a decent team for rivals. Play futchaps
Billu Babes	Two sync upload = oh myyy godd
Sadiq Khan	Mat all u do is copy Chris is embarrassing only primes potm hazard
Joshbooth1317_YT	Kyle walker
Ben Wilson	Feeling down atm but always come here to feel good keep it up guys great vids
Declan Sutcliffe	Got me chicken donner Iâ€™m ready
Ifzal Jabar	Get Paul scholes or lampard and aubameyang in st
Sam Watson	Chris put casmiro in lcm and gerrard in rcm and play hazard on 8 chem
jamie 139	Chris upgrade jesus to champions league jesus
Stefanos Aristodemou	Nainggolan is the best board 160k
Rukrz	CHRIS what team do you support and where do you come from?Class vid liked before watched
Big Man in the vlog	My formation is 41212
Reece Bond	Can dijk
abdulla alkhan	Matt my country is in ur kit (Saudi Arabia)
Il Paxalite Il	Chris get OTW Fred
Rory Barraclough	Matt get Icon Ronaldo
Archie Clark	No offence Mat but with your team you should be getting atleast gold 2/ pushing gold1 or elite 3 and you're getting silver 1 ?
mariano rodriguez	Love the vids since I started playing FIFA, watching from Puerto Rico ğŸ‡µğŸ‡·
chaz butters	I play as 451 try it its so good
George Sparshott	Love the vids lads keep it up ğŸ™ŒğŸ½
jack Bright	Make your vids longer please
Jamie Grice	Kyle Walker is 100k 84 rated
Robert mather	Matic
I RoYaL LiN3R I	Jesus is not my cup of Tea. Please try another striker when I used Jesus he barely scored. Could you try out kun aguero?
Ows Jonez	Virgil dan dijk is a very expensive board player chris lad
Deirdre Coleman	If u mention me I'll give u a cookie
Adam Boyle	Van dijk nainggolan 2 expensive boards
niall Burke	Finished gold 3 with 7 matches remaining
Ryan Smith	Great vid as always been here since raider games
CGS aZrEx_77	Fred all day
MeeshHush 123	Sitting here with my brew refreshing to see the vid keep it up lads
poepalee poepalee	It is a cracking video
Oisin Griffin Barr	Nainngolann is a board and he's 130k
Omri K	Both of you can use the 89 rated Pavel NedvÄ›d he is stupid good for lm for your current formations. Love the vids.
Bradley Whitfield	Van dijk
CHarambe	wow matt is absolutely garbage at the game
EliasJH	Mega packs are the worst promo packs in the game
Kickerz Channel	Rest assured lads chris will sell his jesus soon...
The Samurai	2:30
Jude Anderson	cracking youtubers
AJC_Studios	Nainngolan is an expensive board player he sells for a lot
Darren Hodge	Get prime van basten heâ€™s amazing Chris
jay lord	use the formation 4-3-1-2, just try it ( I won most of my games using this formation
ItsYoBoiHazza YT	Walker he sold for 101k
Marco Orozco	M8
Yapo	gerrards shite now that hes the manager of rangers, mon celtic!!!!!!!!!!!!!!!!!
Ciaran Winstanley	I tried out Fred and really didnâ€™t like him. Always lost 50/50s and lacked a physical presence.
Tom Elliott	cracking video well done
Frankie Hutchings	Chris use casemiro!!!!!!
fifa 19	Deli ali is amazing keep using him
Ben 16	Try seri he's genuinely a beast Chris
Owen Armstrong	How is it that all your big YouTubeâ€™s get all the support and love however they only upload once a week.But two sync who upload two times a day the internet is shocking yous are the best hard working YouTubeâ€™rs in my opinion
Jack Sheppard	One of you could try a 4 2 3 1 and push out 2 of the attacking midfielders.
Kameron Mcelveen	Chris i highly reccomend getting baby makelele for right forward played 15 scored 19 cracking plurrrr... also keep up the good work love the vids
Danesety	Naingolan Best non Walkout pack, got him today!
LisaRingsell	Chris could u please use the Dundee F.C. kit from the spl Scottish league thank u
Brandon Semmens	Matt whoever you get upfront I will but I have 3.1 mil was thinking about prime Henry tbf hell of a plur last year for you
Jet Carnivore	Try Zaha Cracking plur
Conchobor Okelly	Get Carlos Chris
JJGaming 14	Kyle walker is like 90k and heâ€™s only a board
Jimmy One Dig	Iâ€™m from Liverpool get 89 Big Al at ST
Itz Jordz	Pin this for the people that have been here since fifa is in my DNA. You wont
Santa Claus	Why did you sell debruyne aswell nobhead
Ronaldo LuÃ­s NazÃ¡rio de Lima	â€œHeyzoowsâ€... itâ€™s â€œjay-soosâ€
Matt Richardson	Kyle Walker - 100K
Cybix	Nainggolan
A Abdullah	Chris get George best he is the best
Luca Leopoldo	Why are you just going for primes? Others look sick like the baby Cruyf
Alex F5	Good evening
QuersA Zeta	Chis put Sandro at LB and Naingolan at cm and move Gerrard in central
Jill Gosrani	Can u guys pls upload the whole supersunday match
Ellis	I always like the video before I watch it because I know it gonna be a cracking vid
JÃºlio Conde	CHRIS put gerrard on the middle, pogba on the right and your untreadeable naingollan at left cm with Sandro at LB everyone is on 10 Chem Pls like so he can see it
Georgieboy74	Naingollan is 150k and a board
Nathan Pullen	Always have tactics on your players , I wouldnâ€™t get rid of Jesus I have him and he is a beast
KMD Vain	Happy birthday to someone ğŸ‚
Lucas PAPA	Chris get Alex Sandro and put your nainggolan into the team then play gerrard in the middle and put pogba on the right
Charles palmer	Wicked vid lads keep up with the good work
Samuel Tout	Expensive boards= Walker
Ryan McMahon	I play alli and Fred both very good and Iâ€™m going to try moussa dembele aswell
jaafar shams aldeen	Chris try 5-2-1-2 its fantastic plan and i think it will work great for you
W 8	I have fabinho its Amazing
Jayden Mitchell	Already liked before watching the vid because I know itâ€™s going to be another cracker.
Richard Hardy	Has anyone got any suggestions I have a bpl team and I currently have 1.1mil to spend who should I get?
Euan Taylor	Love the vids keep up the good work already know itâ€™s will be a banger so excited
Joshua Conchie	Do a super weekend once a month
Ryan 123	Put fred left center mid and pogba right center mid and stevie g in the middle
Just Fortnite Highlights	I AM SUBBING TO ANYONE WHO LIKES THIS AND SUBS Love yall!! :D
Jake	Chris what team do u support
Dan A	Check your club for players like Valencia whose 82 but sells for 30k.
rfc rfc	Try moussa dembele
Aron Stone	Fred
RossyBoyyy Faze	Geeerrrrrraaaarrrrrdddddd
Josh kennedy	I love Sunday videos, favourite of mine to watch! Keep up the great content lads
the big players	Sell him
Ziyad Elkhawad	Chris get scream Fellani
Dr. Hype	Another banger of a a videos lads. Keep it up
LukaRajak123	get ballack
HB23 Plays	Got my brew and Iâ€™m ready for this video !
xDavid819	I would play Fred I have his champions league card
Archie Smith	Not complaining but thank youuu for the early video
BlackHamster 195	Chris get inform barkly!!!! Cracking plur
jackson misisipys	Sell
Arctik clan	Van djik
RySauc1n	Liked before I watched because I know it will be class
Ben Hillier	Super Sunday is the worst vid of the week ğŸ¤­
Thomas McGuire	Matt, you need prime Crespo, my first weekend league this weekend and only managed 5 losses, he scored for fun
NoToRiOuS WxM	You wonâ€™t pin thisâ¤ï¸ ps love all your videos recently
Lewis McShane	Scare deeney is a beast 90 shot 90 physical perfect fot for aubameyang
Jack&Jacques YT	Get Carlos next
Harry Butler	Matt son at st is a mad man
Skinned Banana	Naingolan sell for 150and is 85 rayed
Andrey 15	Guys, get prime icon Henry, he is a beast
Jack Norris	Kyle Walker 100k board pack
Ricky Thompson	Kyle walker is a expensive board
Ryan Incledon	Get roberto carlos
Lewis Ashby	Have you ever thought about a RTG ? I think it would be interesting to see something different
Reaction Guy	Woooooh Gerrard....the Liverpool Legend
Luke the gamer 2	Opened my 2 100k pack no board open 7.5k get kante
Sam Morley	I was winning 4-0 in 86 minutes and I lost connection and logged back into ultimate team and it counted as a lossğŸ˜¢
TxMaTHY	Chris go for George best or figo at rf
The Australian Dodo	Hi guys you should do a 2 leg and a forfit match every first Sunday of the month the something different on the other sundays btw love you guys
CheekyCharlie Gaming	VAN DIJK IS THE WORTH BITS
Sub3WillNE	Mega packs are awful for me aswell, by the way ur the best fifa youtubers on youtube
Kane Murray	Chris sell de gea and get courtois heâ€™s better
Isidor Elis Hermannsson	Walker
The Reaper	Play cod 4
Maheer	Get inform telisca CRACKING PLURRRRRR
Henrik Loukusa	10 games 7 goals isnt good for stricker ffs
Alex Olsen	Van dijk
Jackson Murray	I packed inform Neymar in 35k pack Matt
100 subs With no videos	Iâ€™m early
Isac Johansson	Vad dijk is a expensive boatd
Lee Potts	Liked the vid before I watched
kacper wojton	courtois not de gea  he's the best goalie in the game love the vids
Harry May	Henry
Mick II	Naingolen
Leah Raggett	son
Otis2005 Sherman	Gerrard. manages rangers use there kit they are the most successful team in football âš½ï¸
Matt Smith	Saturdays are always dreadful in champs. The severs go into meltdown and the gameplay turns into a circus. Friday any time and late Sunday is the prime times to get clean gameplay
The DP gamer	Chis is so stupid like I just cba with this guy however Matt seems like a matey
Hugo Pettersson	Chris dele alli is cracking in cm so good with his timed finishining outside the box
B-Rad Entertainment	Love the vids guys keep it up wanting to know should i sell my inform Werner and one's to watch goretzga for lewandowski, thiago and neurer. Watching from Australia.
boprogamer xd	Use the Portsmouth badge
Luca Hancock	Chris get lacazette hellll of a plurrr
THEREALKEVIN 7	Chris put pogba right center mid Gerard middle and ucl naingolan at right center mid he links to the icons and hazard
LewisThompson13	Get gerrard as your manager
Daniel Olaiya	get a defensive mid
Josh Ottewell	Van dijk
Aidan bodie	Vids are class but u want show this love uses
Nxth4n	Kyle walker, the most expensive board?
Joyce Payne	Matt get eusebio prime cracking plur
tc scoots	Love your vids
ZaPz Offical	Love your vids keep up the good work
AM SWAT	Chris use Fabinho heâ€™s amazing grate vids at the moment
Jack Hughes	Fredâ€™s class
Bilal Iqbal	Prime van vanistelrooy is who I have and he's deadly .... 1.2 million on ps4 and he's the complete package
Cameron Songhurst	If you donâ€™t use Casmiero sell him Chris heâ€™s been on your bench for ages or use him
K. English harry hounslow	I used 300k bpl team for my first 20 games of fut champs and won 3 then changed to a 250k calcio a team and I've won 6 out of 8 of my last games calcio a is solid costa icardi cuadrado Allan khedira hamsik dalbert koulibaly manolas florenzi szczesny fucking solid team wish I used this team from the start
Lukey	Chris are you building up to a full icons team?
Grain Jones	Well done with the vids keep the hipe going
Tom Nelly	Van dijk is the most expensive board
Arch K9	Get yashin
David Fraser	Im watching your videos in the hospital in Liverpool after I broke my arm lookin forward to your uploads has helped me get through this
Lewis Rees	Chris I have 410k who shall I buy
CatchupTV HD	Finally nice video keep it up
Azza Fizzy	Packed dybala in a 5k pack
Dil 112123	My team is sbc Lucas , martial , ucl aguero , vardy , lingard , herrara , young , inform Matip , kompany , bellerin , Leno I have 100k who shall I buy I have Hamsik , Alba, Douglas costa on my Bench who do I buy with 100 k
Asad Ishtiaq	Naingolan is the most expensive board
Nicolas Kuhn	Oxlade with sentinel is a absolut beast...try him...i LOVE this card in fifa 19
Urmo	Dembelle or Fred
SailedChimp67	Hello Chris Youâ€™ll get a good pack in this vid , trust me!
Up The Ante	I WANT BOTH OF U TO MAKE A CHINESE LEAGUE TEAM AND EACH PLAY 10 DIVISION RIVAL GAMES. this experiment  will test ur skill and allow us (and you) to see which is the better player. It also will illustrate to us if you can win games WITHOUT a 1mil coin team
Cyax	Get Varane isnstead of Maldini or canacaro and put him in LCB. He is class! Keep up the good work:)
Jack Boother	Banger
Henryyy T	Naingolan
Luca Fautrero-Sayer	Matt I think I said the exact same about fut champs I even started of 7 and 3 as well the just went downhill
Tobias Wakefield	What happend to the seri a league
TomGayler _	Chris have u ever thought about getting a icon GK
fat tank	I bet if you pin this you both get scream fellaini
Erkku777	Eusebio is really good
Sk3n9man	Chris go for George Best, also notification gang
Jack Bateman	Do snakes and ladders like that game you did in fifa 16
Pizzaparty49	First share also I love your vids
Ben Parker	Never realised how much Chris's team was nearly reaching 5 mil
ML, Aov n more Mythh	Always got my brew, whenever TwoSync uploads.
Henry Fieldson	I thought the vid was meant to be out at 3:30
Jack Kempton	Cruyff
LeaP	You should get prime Hernandez at striker
Ashton Gallagher	Chris try Harry Kane in st
Finlay Saxton	Forest kit Chris
John Mcgrory	Alli finesse shots are crazy!
YOUTUBE Sucks	Fred
GEOGRA The bist	Play Fred cm so he links to Marcelo then you can play gerrard at central CM
LUK3 143	Anyone else see that 200k bid on Pepe?
Lexa	Can anyone reccomend an Icon centre back for under 600k? Was thinking about Cannavaro myself but IÂ´m open to suggestions.
Knatschbart	Go for Prime Vieri up front.  Scored 28 Goals in 13 Games for me - he is amazing. Gold 1/2 in Fut Champs, Div 4 in Rivals - just for reference!
Elliot Sharpe	Will you be any streams lads
Helen Gration	Chris laaaaaaad
Im bad At Fifa	Liked before it started playing, love the vids so much keep up the great work guys â¤
MCG03 03	CRACKING VID
wolfie playz	Van dijk is a expensive 85
Carl Wennberg	1st
Tomi Roderick Owen	Van dijk is probably the most expensive board
Andrew Thierens	Ur the best you tubers ever I don't even have 600 coins and u have gerrard ğŸ˜‚ğŸ˜‚
Christ Luke	Play nainggolan Chris on the left and get alex Sandro
gilybhoy 295	Skipping past Chrisâ€™s part of the video until Steven Gerrard is sold
zeko hardan	Walker kyle walker
Stuart Kilbride	I had both dele alli and Fred and in my opinion dele was better. If I were you I would use dele
Fortnite God 162	Chris move pogba to right cm gerrard to cm and your ucl naingolan to left cm and get sandro back left back
Gaming Companion	Iâ€™m the first to vote
thunder gamer	Sell the screams there not worth hold in on to
Ryan Gemmell	Ali all day chris
Alfie Osborne	NO USE FIRMINO HE IS MUCH BETTER THAN ALLI
Len Harvey	Get rid of aubameyang in your reserves
Thomas Fitzgerald	I bet Chris a lot of money he won't pin this
Liverpool	I had 3 adverts in a minute
Edger John	Fred is op like bakyoko last year he is everywhere and his pace and shot are insane
ItzHassy	Get inform sigurdson for CM heâ€™s good and cheap !
Matthew Hardman	Son
Lucas SÃ¶derberg	Buy back inform gundogan
Ben Pettifor	Got PE tomorrow and were gonna watch super sunday in class ğŸ¤£
Matthew Steadman	Use fred
Terence 14HD	Fucking great vid keep up the good work and can you put this on ur video plz love ur vidsğŸ¤™ğŸ»ğŸ¤™ğŸ»ğŸ‘
Woody0728	should get george best to replace willian
Whitechocolate	Can you change to the Melbourne victory badge please love the vids
Mckenzie TV	I enjoy your videos so much please donâ€™t change I wold really love to be featured ğŸ‘ğŸ’™
Ben Satz	Make your serie a team and put inform immobile at striker, crackin plur
Lloyd Hoskins	Most valuable board is probs normal van dijk
Harrison Tither	Matt keep Pepe and wait for Halloween for when he gets upgraded
hoby 2006	First
Andy Mzobe	FIFA 19 copy pls
J D	Son is an expensive board
Mark Larsen Nassif	You guys should make a vlog
Sidemen mini	Like ur vid keep up the good work
Eddie belshaw	Chris should of got 93 prime matters he's 2 mil
Braydon Baines	Your a cracking plur
MNA04	Life =Twosync
JDrake_22 Ps4	Change formation in game if u want
Kanye West	Give gerrard nunber 8
airon johnstone	whos better son or martial
Isaac Atkinson	Scream card at 5:48 for you people
Matthew Gourley	Chris get prime Hernandez in striker
Luca Briolas	Chris plz get scream fellani. And you won't pin this
Mitchell HARMISON	The stats on the scream cards will increase
DG7Skillz	Firmino is a walkout mate
Alberto Espinedo	get vardy for me he has 64 games played 70 goals scored.
Gooey Gamer	Chris is a cracking lad!!!!!
Martijn de Werd	Chris, replace Marcelo with Alex Sandro, so you can put your blue Nainggolan at lcm, Gerrard at the middle cm and Pogba at rcm
Gem_1 Gaming	Watching from Scotland guys love the videos keep up the EXCELLENT WORK !!!! ğŸ‘ğŸ‘ğŸ‘ and Chris u should get a stronger RB
Snazzy Pants	Love your videos keep up the good work
Ibrahim Mohamed	Best YouTubers going pleaassseee feaatureeee meee
Gustav Nissen	Van Dijk is the most valuable board
CLAPSHAMSANDWICHES	Get prime Owen
Dan Fraser	Chris just take as many finesse shots with Alli as possible and Super Sunday is definitely yours because his finesse shots are broken
StraiN_ Joseph	Love you guys best FIFA content around
George Topham	Put naingollan in cm, and link him with the icons
s.c _05	Been loving the vids recently keep it up
callum pettitt	Love vid
smgmicro	You guys a bloody legends
Not Tachanka	Ive played over 120 games with CL Fred and he is so bad. Heâ€™ll win the ball a few times but he cant do anything else. Heâ€™s short and misses easy chances
Zander Young	Chris get prime larsson for ST
murad shubair	Watching from dubai :)
OscarP	Around 20k subs in 3 weeks. Mad. Well done lads
LoneWolf 124	Kyle Walker is an expensive board player!
Marc Buckley	Bet you wonâ€™t pin this
IN2 V	Guys try hybrids
Rhdzz Gaming	I have Alli and his in game stats are great
Hyper Maxime	6 mins 1.1k likes you guys deserve this support
Alfie Walker	Son. And Jesus
Kung Fu Charlie	Radja naingolan and Virgil van dijk are the most expensive board players
CR 11	Chris I packed David Alaba. I was expecting him to be like 30k but when I checked his price it was at like 75k. This might have changed also loving the vids letâ€™s get a banger of a vid at 8:00
Tom Booth	Cracking PLUR
Venox G-tech	Love the Vids lads. Keep it going. Hell of A Plur
Elliot Harris	Van dijk is most expensive
Jack Gower	Son is
Haytham Hashem	Chris try salah as a striker and videos as always awesome and it would be amazing to get featured
George Hodkinson	Liked the video before it starts if ur new because twosync are flipping brilliant
Isaacs	Like the minute this vid came out coz itâ€™s a cracking video already
Evan Kirwan	Chris if u put this in the vid i will buy you a bag of chips
Bobby Geldof	Ur hard
Matthew Catchick	Watching from Australia, keep up the fantastic Vids
Maria Kowalska	van dijk board pack
itzjames	Van dijk expensive board
Mahfuz Rahman	Get Fred and move him where Gerrard is and put Gerrard in the middle
Jorge Barker	Change to the forest badge
Aljay 55_87	This isn't for matt or chris it's just a general recommendation everybody try Morata he's cheap and has scored 20 goals in 15 games with 4 assists he is insane please buy!!
Freddie Warrillow	I use 4222 and it is the best formation I have ever used. U have players everywhere u need them. Just try it for one game and youâ€™ll see
Pamela MacCrimmon	Kyle walker
Dion Barry	Eusebio Eusebio Eusebio
Scott Anderson	Bet they wonâ€™t reply
George S	Son is the best board
Jack French	Fred
jake holden	i thought u said u wasnt gonna  drop kdb or pogba because your improving the team not downgrading it
_noahmonk	Hi guys
Shxd0w	says prime or nothing and has middle maldini
Futbol Fan41405	I use 4321
Jamezzz_FIFA	Love from Japan great video as always â¤ï¸
FortniteLadd	The 4321 is the best formation
Monique Jairath-Fernandez	Yesssss 10 mins early
Harry Thomas	Hello
AnthonyHD	should have got scholes hes way better and cheaper
fifa hub	Its a great way to spend a Sunday while  watching some cracking you tubers
Chubby Chicken	Loving the uploads â¤ï¸ especially when there early like this one
Fifa legends2522 lfc	Like even before watch keep it up
Sam Lester	banging vid
Official LJaY	Chris will win 2-1 because heâ€™s a geezar
Monday Swing	Packed 1 just before I clicked on the video
Tyler	Where have the 2 super Sunday games gone
CoCoCole the Dabasaurus	liked before I watched the video.
Martin Yale	Cris get the westbrom away kit please love the vids
×¨×‘×™×“ ×§× ×¨	Put Pogba rcm, Gerrard cm and naingolan ucl lcm and Alex Sandro lb
Nick Eh 30	Eusebio
Regan Jones	Chris use the 4 2 4 formation is op as hell
Wilmer and Milo Gaming	You guys are the best FIFA Youtuber in Youtube keep up the good
Twosync Fan	Such a good video keep it up
LPool Ftw	Take inspiration from the pros and get the players they use in ur squad
Itz_Tempx	Thierry Henry or Schivchenco
E- Zay	get fred because you get the brazilian link with marcelo and the you can put gerrard in the middle like you wanted to
Rian Smith	Love the vid already and I haven't even watched it yet
anette heymann	Plz can I ger feuterd
J. C.	Dislike for selling De Bruyne
Christian Lee	chris put prime van nistilrooy in striker instead of jesus
Jack Coton	Already know it's gonna be a banger of a video
Wheelo	Chris will you get the Swansea city kit. Went to watch them against villa yesterday. Amazing fans
Griezkiddy	Get martial at st
Addigames	Got my brew cracking vids lads
Gianni Bonnici	What do you do for living? ğŸ˜‚
Gustav Privat	Chris put Gerrard in the central CM naingolan blue on the left, pogba on the right and alex sandro Inform in LB. Love the vids lads!!!
Henry	Loving the videos guys. Always here straight away, been watching since raider games
Owen Davey	Content is insane right now. Keep it up lads good job.
ged Vasi	Haven't even watched the vid and know its gonna b good and Matt bring back "WHAT A LEGENDDDDDDD"!!!!!!
Corbz HD	Niangollan is 170k and isnâ€™t a walkout
Neo	Get fred and swap his position with Gerrard, if they go wide they can put in better crosses beacaue of their foot ğŸ‘ğŸ¼
Ryze Zylo	Pin this If you love your fans
Rhys Humphreys	You wonâ€™t pin this
Ellis Cowley	First like comment n view
Steven Sleboda	You donâ€™t have a prime maldini
Randomness 3	Great vids
Connor LeClercq	Love you vids from bournemouth been watching for ages now keep it up â€¼ï¸
Resko	Chris I reckon you should get shevchenko or stoichkov
Saugat DeProz	Chris ur catchphrase should be  only primes, only dimes
Chris Paull	I bet I won't be feature but I love ur vids
Guitar4king	Liked before watching 12 times in a row ğŸ’ªğŸ»
Albro HD	Cracking vid
Matt Pender	Great vid your the youtubers to ever create contentğŸ˜€ğŸ˜€
Ben Kelly	Get prime icon Larson
Chris Owens	Get George best
Ahmed King Hatim	Chris go for Roberto Carlos he is a beaaast
Oscar Briggs	Fred is a beast try him and I honestly prefer him to pogba
WIll Richardson	Hey Chris love the vids from New Zealand! Always have my hot chocolate ready
Daniel Browes	Love you guys keep it up
Cameron Nairn	Will I get pinned hmmmmmm
DoMe HyPe	Love twosync
Icey Riskz	Got my cuppa teas come on
Nielsmedskills 16	NOTIFICATION GANG!!!
FGM_ Holby	Iâ€™ve already liked this video cause I know itâ€™s gonna be a banger! Keep up the good work ğŸ”¥
Ben Bushell	Been here since fifa 15 well done you two your doing amazing
Connor Pond	Lukaku ST not even been mentioned?
Jack Chambers	Liked before I even watched the vid keep up the good work
TheGodly Teabag	I bet my house this wonâ€™t get pinned
Harry Sandell	Cracking plurs, keep up the great content
Abdullah khaja	if you smile when you see that twosync uploaded a video like this comment
Sam Norval	Chris get George best
Oscaragamer M	I've already liked the video because I know it's going to be a good one ğŸ¤™ğŸ»
Alekx Cooper	Chris, get Alex Sandro at LB then put ur UCL Naingolan in at Cm and put Gerard in the middle guys please like this so Chris sees  Edit:if u donâ€™t like Alex Sandro get Roberto Carlos(so many people are copying my comment lol)
Jim Fraser	Jesus is a CRACKING PLUR!!!
No noobs YT	Whoever disliked this vid u are a mong
Eoin K	FINNALY CHRIS YOU GOT GERREARD YESSSSS
Fruzzy T	Cracking plur
Matthew Donnell	Liked the vid before it started loving the new videos also I got messi in a two player pack and heâ€™s insane!ğŸ”¥ğŸ”¥
Donald-the-duck Dtd	Chris is the don
Karim Abushaar	Do a super Sunday on the new kickoff modes
Dean Rangeley	Early gang
Thomas Matley	Loving the vids atm always looking forward to them
Simon Paledzki	To fred, i used him and he feels like an attacking kantÃ©
HL TEKERZZ	Love to featured in this video loving vids at the moments also you should buy prime icon Hernandez hes sick :)
MR FIFA BOY	Love the vids , Your Crackinnnnn Plurssss â¤ï¸â¤ï¸
Not TTvDaire	Kyle walker
Istar Freyr	LOOOOOOOOOOOOOOOOOOOOVEEEEEEEEEEEEEEEEEE IT! keep going guys, love your content and my cup of tea here
RAW_ELITE	Love you guys! Been watching since FIFA 16! Keep up the good and hilarious vids!
TheBlack Turtle	Dont use green or blue kits i am blue green colour blind. Love the vids btw
KK 2	If you play on Xbox like this comment
Chris Roberts	You would never pin this
Jamie Warner	CHRIS Use a Liverpool Badge In Honour of Gerrard
Mark Morland	Chris get icon Zanetti
Mason	Play PlayStation instead
RIP Teewiz	Thh
RiotWolf99	get roberto carlos
Faisal Alsuwaihel	There is an icon leauge for managers chris Keep up the great vids
Shane Moran	I was binge watching breaking bad...Then this notification popped up :)
CillianFoley11 11	I know Matt I was 9 wins 2 loss now 10 wins 5 losses
Jacob Ridley	Swap maldini and cannavaro to their strong foot
Nathan Watson	Already liked now time to watch this cracking video
Scott O'Neill	Matt get giggsy
big-boy gamer	Cracking videos
Conan McNicholl	My brothers team just lost their big final today would mean a lot if u gave them a Shoutout in the next vid. Say â€˜up the Biddiesâ€™ (nickname for our team St.Brigids love the vids keep it up bro
Morgan Watmore	legends
Gaurav ranai	U guys are legends    P. S. Would appreciate if u pin my comment Chris and get inaki Williams great super sub and budget player op af
Jamie Moir	Great vid boys Chris what do you think about Gerard
Logan Woodward	Why is this video up at 2:30 not 3:30
Marius music	Cracking Video as always! Wonâ€˜t get featured because I am German :(
oisin murray	liked the video before it even started
Charlie Boy	You guys are absolutely incredible keep it up ğŸ‘ğŸ»
Lawrie	Every Fifa video recently has been awesome, keep it up and stay confident in what your doing
Josh Vortex	If this is a cracking video pin this comment
Alfie Claret	Steven Gerrard Cracking Plurrrrr
Ben Eales	Notification gang  Chris whatâ€™s happened to the serie A team Your vids are awesome right now
Jo Maddaford	Read this please I have a bet with my friend loser gets a punch
Nick Watson	Whenever is see a notification that TwoSync has uploaded I drop what Iâ€™m doing to watch the banger! Even in FutChampsğŸ˜‚
GingerEyeballs	Use the Swansea away kit btw Matt donâ€™t use Pogba at CDM he has high/low work rates
Ryan Davies	Bet you wonâ€™t pin this
Knottla02	2:30 vids don't mind if I do
Finny Boo	NOOO IM LATE
What The Deuce?	Ho cracking plur
Nitro Gaming	Chris wonâ€™t love this commentğŸ˜€âœ…âœ…ğŸ˜€â¤ï¸â¤ï¸
Jacob Chapman	I was the first to like because I liked it before I watched it
SAMMY J J	Chris do timed finesse
Ben Honan	Just sat down after my football match with my brew and a biscuit
Rayyan Ali	Love the vids sooooo much keep it up
xDeath _	Hi chris love the vids keep it up mate :l
Keane Tolley	Hour earlier? Glad I was here early
Olly Nugent	I love a good twosync vid keep it up
Hammondinho123	liked before watching, already know itll be a banger...
Erin Fairhurst	so happy itâ€™s half term so I can watch your videos, love it keep up the good work
Jordan Wilson	Put me In your videoğŸ’™ğŸ’™watching from Scotland,gerrard is doing a great job with rangers,canâ€™t wait to see wit the future holds
fatlinnd rexhepi	great video,even tho i still havenâ€™t watched it,lol.
Josh Spratt	Got the brew ready for yet another great video on a shitty Sunday before school
Owen Dargon	I comented first u guys are the best
George Packer	Courtois is better than de gea
Haanan Afzal	Liked the vid before watching
Maciej Skiba	Great vids lads pls feature
Josh Ambrose	Love the hard work and try scream Kalou he's amazing
MLW 100	Look at Instagram dmâ€™s
KSI-The-King	Love ur vids been watching for a long time now keep up the great work ğŸ‘ŒğŸ»
Teddy Salah11	312th like
Parkor Gamer	Yes boys great vids btw keep up the good work ğŸ˜€ğŸ˜€ğŸ˜€
Cameron Watson	I bet Chris wonâ€™t pin this
Jamie Hughes	First one to like
Samwell	Try HEUNG MIN SON
Jnh HD	Liked before watching because already now it's gonna be a banger
Sudan Ramaswamy	Already liked the video cause I know it's a banger Stevie G
Liam French	Loving the vids keep it going
FIFAgromlingHD	Already know the vid is going to be sick
Greeny504	Amazing content keep going
OmEY	Like for messi in a pack
Alfie McGuire	Love the vids
Stewart Perry	Get Gerard as manager
Porca GameBattles	Love the vids so much keep your your awesome vids !
KOOGH	How ya lad!!!
Abdirahim Issa	Already liked the vid
YoungTroubleHD	have not even clicked start yet because it is GOING TO BE A ABSOLUTE BANGERRR
Michael Brooksy	Get Gerrard as manager too
The beast of kings	Love the videos
jordan ryan	First like
Dan Ryan	Notification finally comes through early
S-L GAMES	Already liked because itâ€™s gonna be an absolutely banger
Reece kinsella	Chris is professional Fifa plurrrrrrğŸ‘ğŸ»
georeg bfiodhdk	Love the vids guys would be amazing to be shown love you two
RIBZ YT	Already liked cuz itâ€™s gunna be a banger by the way Chrisâ€™s use the Bristol city kit
Thor Espen Norsk Fifa og Fortnite	hi
Cian cunningham	Oh my god im Third
Axtz 1	NICE VID
MB-gaming	Please say MB crackin plur
ii Joshy	I like
dannyh 9541	Nice vid guys ğŸ”¥ğŸ”¥ğŸ”¥ğŸ”¥ğŸ”¥
Marley Spencer	Hi Chris, is it hard being a youtuber? Probably wonâ€™t see this
Damn Bleach	Chris and matt have a class day and wish u the best of luck
conjon24	Chris definitely eats popcorn with a spoon
C'ville Fans	Eating my Sunday dinner and watching twosync
Jack Lawes	Keep it going your making great content
Charlie Thomas	Get shearer for Jesus
DOM REEVES	I liked before watching Chris your a cracking player and a cracking legend
lewis crookes	Liked the vid before because already knew the vid was a banger
Louie Williams	Inform xhaka try him and watching from Brighton
Luke Ebejer	Whats a guy gotta do to get featured;) love the vids
masterofthemixz	39th
TriK Titans	Iâ€™m from wales where are you guys from?
Tekashi69baller4lyfee	Amazing content
Jack Moody	Legenddddddsssas
Josh Finn	Crackin vids ğŸ˜‚ğŸ˜‚ğŸ‘ğŸ½ğŸ¤ŸğŸ½
Mexican Lewis	Absalute banger
Baran Kucuk	Hi how are you doing today
Olly	I liked because I know itâ€™s gonna be a cracking vid
Fifa gods 08	They wonâ€™t pin this gurantee
Owen Devos	Do MATT V CHRIS
Jonathan Hewitt	Sick vids keep it all up
amotherwell	Just got me brew, after a game of footie, buzzing
Harry Bell	Yes boys
ITV trolling	Keep it going guys, love your vids lately, well done Chris on getting Gerard
Riskitforabiskit	Get the Derry City kit please and use it in-game!
O C	Are these up at random times now? It been a dodgy timing recently
Jack Laird4	HELLOOOOOOO
Owen Matthews	Get Rui Costa
Ateeq Malik	Hello please use the Liverpool badge
Ahmed Almannaie	Already liked before watching
Anil Atwal	Another banging vid incoming
SlaggieMike	230fps?
Rob Peck	Iâ€™m first and already gonna like got the merch got the bru love it
Iâ€™m am IbrahimoviÄ‡	Nice vid guys notification hang
JP Gamer	Firsy
Football Phenomenon	I BET U BAS DOST U WONT PIN THIS
MOORESEY	Here straight away and iâ€™m loving the vids recentlyğŸ‘ŒğŸ»ğŸ’ªğŸ»
Haymaker	Pin this pls
Jake Harris	First to like and first to have a brew
nathan whitehead	First person to like
Brad Starkey	Love the vids keep it upâ¤ï¸
Stephen Mitchell	If you ever need an Icon ST get Eusebio He looks Amazing
Einar MÃ¦hlen	Love The vids i am from Norway
Adam McCormick	Pin this if you read your comments
VaDe Quantum	What legends!!!
Jack Baker	Love your vids keep it up ğŸ¤™ğŸ½ğŸ¤™ğŸ½
KM 1504	Cracking plurrrr
CR4ZY TY13R	Yay I'm early
GRFX	Chrisss gerrard cracking plurrr
olayy	Use sydney fc kit
Josh Stapleton	Firsts
Camz	Fucking love these videos
Luuk Jansen	i always love the vids keep up the good work
jamie watling	Absolute banger
Fortnite Frenzy 04	banging video boys â¤ï¸
Tyler Correia	Love the vids
CJ MAC	I already know this is gonna be a CRACKIN VID
Harry Nicholls	Liked before it starts
DKGamerHD	could you use the villa kit chris
charlie howe	Ik the videos going to be a banger
Carl Pettersson	Pin me i love u refresh notification team
FMT Cerberus	Bangers
SG x salty	Hi
Ashton Knights	cracking plurrs keep up the work
Josh Smy	Alright mate
HenryLIV10	Love the vids please feature me â¤ï¸
Random Channel	First and love the content
ICringe	First to see
Tobey K805	3rd
Isaac Havard	First
Zineddine Mahrez	Hell of a vid
Wacky ._.	Sup guys
KingyLiam	Iâ€™m sexy that ur team
Dylan Moran	Nice vid lads keep it up
Finn Davies	First
Daniel Airns	Love u guys keep u the good work
Kev Allow yournan	Chris wonâ€™t pin this I promise
Zak Tekkerz	2:30 ?
kallum hayward	Fist comment
Isha Hussain	1
Arend-Jan	First
Harrison Whitt	Get IF hulk
Stejb	1
Josh Lucas	Yo
Joe Hall17	Chicken
TastyDust	Hey
Charlie Finch	Hi
24/7 Gaming	First love you
Luqski	First likerrr
WeAreSoccer	First
farhaan shaikh	First
IT_z WaTfOrD	First
Zayd Masry	Loving the vids keep it up
A Gaming	Pin this plz
[SYNERGY] Cetrix	Notification gang gang
JM 04	My guy
Z3NTREX x	1st
ShOtA killZ	First
Brandon Proctor	1st
Haakon Aleksander Berg Konradsen	First I was first yesterday aswell or maybe Im 3rd or 4th but yestarday I was First!
Tom Bunt	Love u guys
Edvin Ljostveit Reiersen	Fistr
