Happy Power	DUDE TOMORROW IS GOING TO BE MASSIVE! #StayHappy
just a random person	How did i get the notification just now? What the hell!
N3ON	Tomorrow will be awesome like your channel!ğŸ˜€ #StayHappy
TrickZ Blaze	Yes please destroy tilted
Dr.Ew	Dang this video sent to my notifications 2 days later and I thought something was going to happen again
Ka3le	Clickbait your tiltle says *tilted gone* but is it gone nope *new ali a*
Huzaifa Khan	*UPDATE:* Tilted ain't gone! Epic Games trolled the whole community once again.
lll_GO2SL33P_lll	Straight to the point as alwaysğŸ’™
MG Aztik	Actually what's gonna happen is that   Readmore
Xotiic	Yep ghoul and the scythe didnt come out fuck man
Unknown Player183	Scythe ?
Thanos Boi	Happy i think rip tilted means the building being destroyed by the cube because donald mustard put that tweet before the cube got to tilted
HypeMello	People talking about the visitor burt why doesn't any one talk about the enforcer?
TSMeZaFãƒ„	You contradict yourself so much
FoxTrident RANDOMNESS	*E*
prxzo	I donâ€™t think this update will be the biggest update season two brought like 20 point of interest many guns and heals graphics everything so please stop exaggerating the update it will be a decent sized update not a huge one...
Emr3Be4st Fortnite	Nothing happended
Mladen Ä†uriÄ‡	FINALLY TILTED IS GONE
TDG Blue	Good Video extremely excited for tomorrow
Anthony Marlow	Tilted won't be removed tomorrow, we still have the dance on top of a clock tower challenge so if it's gone the people who havent done it won't be able to
IKing Grizzly	Tilted is not going to be gone
A Dog	Have you ever thought of the word bikini bottom and sandy cheeks
i dont know a good name there was no good name	every time there is an event u say TILTED IS GONNA BE DESTROYED TOMORROW NOT CLICKBAIT
Kraken	Why tilted wonâ€™t be destroyed tomorrow: we have challenges in tilted, if they destroy it all then people who donâ€™t have the challenges done then they wonâ€™t be able to, and epic wonâ€™t do that
Gaming Express 2018	Everyone says that tilted will get destroyed in every season
Fortnite Craig	3:09 To be continued...
JakeyGaming	Lmao who are you to judge who has bad grammar?
VÃ˜Å‚Ä	LaST nUmğŸ…±R iS wHer yU HAve tO gO NExT gamE 1:moisty mire 2:WalmArT 3: tiLTde ToWErS!!!!!!1!!!!111!!!! 4:oFf ThE mAP 5:niNJaS StreeM 6:ToMAToE pLAce 7:LObğŸ…±y 8; Anrchie Acer  8: #9 10:NorTh KkkorEa
SGT SEPTIC 10 gaming	@happypower tilted is staying they just release the dance on a clock tower mission as one of the weekly challenges
Cant change my name until 90 days	Is that a new visitor face?
Jorge Resendiz	IDGAF ABOU TITLED BEING DESTROYED BC BROKE AS DEFAULTS LAND THERE AND PRAY FOR A MINIGUN CAUSE SPAM IS ALL THEY KNOW TO DO
RiskyFrisk	Why the heck is this for a Halloween event??
PuR3 Geneticboard9	Boi tilted aint gonna be gone lots of people go there so if it gets remove no one will play
bob	Like if happy power is gay
Amaris Garcia	who else thinks ghoul trooper is gonna be released in the morning like skull trooper and ranger
Joggjnb Fhhvhh	You can hear â€œzero oscillator on.â€ Coming from the portal
Gipsar	Now that they might actually remove tilted, I donâ€™t want them to :(
tannia martinez	The tweet of rip tilted was litteraly released at Sept 6 so what if the portal will bring something out on 6
Wolfie is the best Prime	:(
Young Dame The Sauce god	Idc about no cube made of lean add double shotty
BlooodSlayer145.	Tilted being destroyed never heard that before
Joe Ortiz	Rip tilted :(
Raging Gamer	Soooooo hypeddddd
Menames M cameraman	pretty much
Churro	Season 3 is linked with the visitor
Zai TBA/TES	Visitor is from Dark Dimension. Then he was commanding the Cube to destroy the Fornite. He camr back and maybe he will destroy our game. (My theory sometimes right....IDK) #fornitemares #visitorishere #thecubeisvisitor #forniteseason6
Saint Crush	I need to subâ€¦â€¦â€¦
Football Beast	I am so hyped.ğŸ˜ğŸ˜ğŸ˜ğŸ˜ğŸ˜ğŸ˜ğŸ˜
Bubba0924	The portal just started making weird noises,  try putting the sounds in a spetrogram. #StayHappy
xd Kai	what about mobile r we getting 60 fps ?
Niko O	What if br and stw cross over in the portal and bring husks for fortnitemares?
Twitch. TheRazin	Notice me people scrolling through the comments pweaseee
Tre Keys	Rip nickmercs ;)
Anonymous Dude	Im still wondering who dafuq is Ragnarok like he never even make an appearance in the loading screens
CLASHwithIMMORTAL - Clash Royale and More	SAVE THE WORLD CROSSOVER HOLY SHIT
Arinion	Who else started crying when it said rip titled
EasyMoney1500 TM	I made a clan anyone can join go to the videos comments and tell me
S8	The rip tilted tweet was from the beginning from September lmfao this ainâ€™t a leakğŸ˜‚ğŸ˜‚
Got Em With The Ligma	HAPPY WHY ARE YOU NOT ON THE SUPPORT A CREATOR LIST??? I WANT TO SUPPORT YOU
xd Adrian	What If the thing above Loot Lake opens and the visitor comes back and destroys Tilted Towers? During the rocket event the rift saved tilted but now there's probably nothing that can save it.
ATTY	who else dont give a fk bout fortnitemares and just want the reaper axe
Fire Cream	Thomp heheheh...WAAAHHHH!
R4nd0m P3rs0n	Be ready for epic to add a 10 GB update and then in a couple hours another 5 GB update to fix something smh
suicidarce	cube bringing zombies
King_Renger 03	cube gonna be thanos
AdamHD	IM SO HAPPY!!!!
Hawaiian Porkchop	Happy: Tilted is getting removed. Me: The whole map is getting removed.
Patrik 494	Is ghoul troper coming back? Pls budy tell me answer thanks
SeaBass	I wonâ€™t be surprised if your wrong again
DobbyNick	Tilteds not going bc the challenge is to dance on the clocktower
Thicc Ass Pony	Yo my dad is coming back jeez that rift took himğŸ¤£ğŸ˜­
Jared49er	Yo happy when you look @ the portal it makes the visitor noises from the rocket launch
Ultra Gaming	i want to point out when you skydive in the beam it makes the visitor voice file play
expert_calibre	I have no money :(
cooldude 305	Stw is going to be free in 2019 ğŸ˜­(look on the fortnite channel)
Jacob Vassallo	Now I see why you were showing the rocket launch all the time, and did anyone notice when you glide towards the floating island it makes sound similar to the sounds the rocket made in a part of the rocket launch
1,000 subscribers with Two videos	I bet every single event ever has lead up to this just to re-introduce fortnite mares
1 sub With no video?	There's zombies in save the world right(don't have it so not sure) people have been going on about a crossover between stw and br which could also apply with fortnitemares because zombies and Halloween?
Rion Robinson	Anybody else gonna talk about the pic of visitor doing wakanda forever
BringOutThebold Boi	Liking all the comments I can find
SMER TIS	It better be the OG bckround
Brandon Soto	If titled isnt gone tomorrow, I'm reporting for clickbait and unsubbing. All your recent videos have either been wrong or click bait. I'm getting sick of it.
Keon Edwards	STW Crossover
Decendants G4ming	â€œTmrww will be the biggest update in Fortnite historyâ€  *1 month later*  â€œJesus Christ this is the biggest update everâ€ğŸ˜‚ğŸ’¯
What Up	I have a inference what if all platforms have something to do with this just a thought
Mexicano Beans	Tilted is never going to be destroyed. Itâ€™s just a bunch of leaks. They have been tricking us since season 3! Why would we actually believe it now?!
KingJF85	I'm acc hyped!!!!
hi shape sup	YESSASSSSSS@ASA@ASAA
nootaN	I want more water in fortnite, just my opinion.
eduardiitohh. x	Love ur channle keep it up bro
Uganda Knuckles	*YES TILTED IS GETTING REMOVED WOO WOOOO WOOOOOO WOOOOO WOOOO WOOOOOOO WOOOO WOOOOO WOOOOO FINALLY ITS HAPPENING!!! WOOOOOO WOOOO WOOO WOO WOOO WOOO WOOOO
BreexyYT-	With the power of PHILL SWIFT the POWER of FLEX TAPE comes upon us to PROTEC TILTED TOWERS
6969 subs with no videos channel	I really don't care
1000 subscribers with no videos	Welp rip, I got band practice until 3:30 ğŸ™„ğŸ˜­ğŸ˜‚
C J	Ofc there is a chance that tilted will get destroyed coz the blockbuster skin is tryin to destroy tilted back in s4
Allop Kopin	Can you make longer vids and do you have the shop thing
Holden Willett	No offense but u r kind of booty at fortnite
Hardcore Henry	WHAT U MEAN TILTED GOING BYE BYE?!?! FIRST DUSTY GO BYE BYE, NOW TILTED GOING BYE BYE?!?!
Derek Hammer	gifting??
Kermit Is sad	I bet the rocket comes back and destroys tilted because it was trying to destroy tilted
David Matrai	Why does everyone think Tilted is destroyed when it never ever happens
ItsNotorious	Tomorrow is going to be insane... #StayHappy
SpRaYzZ 7	I better see that scyth
N5-FIFA	So happy I have the visitor it was such a grind but it was worth since a lot of people didnâ€™t like it they didnâ€™t grind for it which is why itâ€™s a semi-rare skin ğŸ˜
Johan Andradd	If fortnite removes tilted rip to their game
Liquid_ JamZ	Old mcdonald and kurnel mustard from the board game clue, put them together and BOOM *DONALD MUSTARD*
Unknown	What's FortniteMares? Be specific
kwj jones	Hi remember me
G Dust	Hello guys welcome back to your daily dose of fortnite here in the Happy Power Channel
Finnatix â€”	*Happy power*  He tries to not make long videos Gets into it quickly  But most importantly  *He doesnâ€™t cliccbait*
FMEC NeyJrUTube	Why tomorrow i have  a soccer  game ffs
PS4BLOWS05	Visitor is awesome
Michael Tisdale	Please don't say Tilted is getting destroyed you have said it too much I promise you it won't happen.
Robo Gamer	I think that when the cube does what ever it does, it will send a blast of energy that half of tilted will be dameged by, causing it to become " Tumbled Towers".  Buildings affected:  Most of trump  Noms store  Long skiny and tall building  Basket ball court  Buss stops  The L buildings    And that tall building in the top right
NightNinjaGamer	Gifting tomorrow?
Marilena Garnica	Oh boi I'm just hyped for save the world
JTZombiE	Hey happy power before you start a video put a spoiler because I wanted to see if my theory that visitor coming back to the event. But its ok
Blight	Husks in battle royale would be interesting
Roblox	1 like and I will eat my toes
Grey 59	Man I Feel Bad For All The Kids That Have To Go To School...I Live In Nevada And Nevada Day Is On Friday So Fuck Yea
IxAMxBERSERK 07	U show the same video of you in paradise palms with magnus every vid and that is from season 5 how is it a recent video thatâ€™s overly old
AKP09	This i feel like is killing the fun of Fortnite, I thought the story line would be way more interesting, not just a Halloween Event (Just a thought)
hayden	Remember when ninja said â€œI canâ€™t wait for Halloweenâ€ on his stream after he came back from fortnite offices
Fox Family	Please DESTROY TILTED
Alpha Gaming	If tilted goes away there finally is gona be a mid game cuz nowdays the game starts and ends in the 2nd storm #stayhappy
Justin Draws	Season 3: meteor hitting tilted Season 4: Missile going for tilted Season 5: Cube destroying tilted Season 6: trying once more to destroy tilted  All of them so far have failed to destroy it. Itâ€™s definitely fake, I believe itâ€™s the old factoryâ€™s going.
Chinese Symbol	The event isnâ€™t the only thing thatâ€™s massive...
PHARAOH Fortnite	Tomorrow  Epic games: this update has been delayed
Bepis man	Happy Power is clickbaiting with this now, the tweet was about fortnite monopoly, good thing you got exposed as breaking TOS by reddit
Skiizzle	when are you gonna notice me I comment so much lmao #stayhappy
TCK Lenny â€”	DAB ON THEM TRY HARD HATERS
ShadoStryke â€¢	Hey Happy Power Iâ€™m 11 years old  , Iâ€™ve been watching you for 3 months now! I love your channel and you too (no homo) you give no bull crap , no clickbait content! If you ever wanna play my username on epic is xXShadoStrikeXx
You Got Fxnnesed	Sucks that I won't actually get to see it in game just like the rocket
HiruxWorld	Like someone already said "The â€œRip Tilted ;)â€ is from when the Cube crushed the buidling" so pls stop clickbaiting...
CraZe wizzy	If tilted is gone I will give very one here $1.00
Gianfranco Iacono	Definitely pretty much a leaked fortniteMares, officially
Tsoukas - Fortnite	Fortnitemares challenges give Ghoul trooper?
Pixel Kid	I thought the portal event is gonna happen
Angel cavalie MugÃ±y Vertyyy	Ghoul trooper
GodSpeed K	2:46 silence
m1222theGOAT	Got the noti 3hrs later ğŸ§â˜¹ï¸ #stayhappy
RED RANGER1345	Tilted GONE  hahahahahahahahahahahahahahahahahahahaha it s not
COLBY XU	Who else saw â€œTilted GONEâ€ and clicked the video?
Benji	I donâ€™t even have my fucking ps4 anymore, rip in chat for me. :(
Faaiz AliTV	That was some pointless info man. The â€œrip tiltedâ€ was from September 6th where the cube was destroying that building in tilted.
Nate Jewer	I donâ€™t want tilted to go like if you agree
GalaxyRealmz 728	Hereâ€™s My Poem;        Portals Open,Thrusters Fly,Lines In The Sky Fill Our Eyes...............................Again
Sophie	If they donâ€™t add fly explosives or sniper shootout I hope they die slowly, stupid c u n t sss
MADDJROCKS Gaming	September 6th is when the cube ran through the building
Awesome Quesadilla	With the monsters part save the world free???? Am I wrong
Flxsh	can't wait
Thanos eat ur pp	Bet theyâ€™re gonna troll us and slowly destroy every other place except tilted
Eddy Romero	After 4:00 tommorw in the morning I can play right when down time ends right
Chronically Sun	The visitor has been waiting
therealfish 209	I think this might lead to battle Royal and save the world cross over
FeAr_OpA	Why does everyone want to hert tilted
zxinks	September 6, 2018... the tweet is old
Teh Official420	Xbox players you ready to not be able to play for the whole day?
Danny Mastar	1. Builds new building in tilted  2. Cube destroys it  3. Demolish the rest  4. Tilted removed
RPGamer 12	I know that im getting allot of hate bcuz of this comment but my gf killed herself last night and i cant get over it and when i watch you i can erace it out of my mind for a while #STAYHAPPY
Adan Sanchez	Titled canâ€™t  be removed because thereâ€™s challenges for tilted!!!!!
Insane Playz	Not all of tilted can be destroyed, as the dance on top of a clock tower has to stay
Stefan Grujicic	pointless video bro
Mcmustache	What I hope they do is give every skin a Halloween costume including defaults so everyone pay and no pay can participate in the event (other than just challenges) #stayhappy
FloodZero	Visitor might come to the item shop??
DaniPunta 04	Nice vid
FearlessJam	New starter pack?
Jaxon Mccarthy	Mabey the save the world will be free too
Sir Pogiãƒ„	I heard some really weird sounds coming out of the perma rift ğŸ™„ğŸ™„
am defaulty boi	3:04 extremely amazing      More like SUPERCALIFRAGILISTUCEXPIALIDOCIOUS
420 IQ	who's most excited about revolver coming back
2k Gold	Your gameplay is fucking dog shit
CRITICAL	So... to those who say scythe isnâ€™t coming back cause it says â€œlimited editionâ€ in its description are totally wrong. The word limited edition means that it can come back a certain time of the year, for example halloween (Fortnitemares) so it came out last year, if it comes back this year then we all know that it means the Christmas skins are coming ;)
DarthLocke 456	When I need vbucks my god bruh in unlucky
James Russo	They wouldnâ€™t remove tilted
1000 subs with no vids challenge	YESSSSSSSSS OMG!!!!
Justin Petsinis	Woke up today on my Birthday and I have 2 kidney stones. Fun times......also great video thank you for posting.
xxxtentacion forever	Clickbait got , happy power
Rv3c	Maybe they will fix     shotguns, that would be huge.
CowTipper 29	Season 3 in February leading all to season 6 in October. We all have to show Fortnite a lot of love and respect for theyâ€™re dedication and effort to do something awesome!
M-Pulsive Gaming	Cant help but click on your videos bro. All the info is straight forward. Thank you
Dr. Coffee_	Best youtuber for Fortnite info
Omegawolf Beast	My boy visitor is gonna destroy some stuff, woo
Bad Gaming	Thanos Tower
PartyGamer 23	I think weâ€™re going back in time when tilted wasnâ€™t in the game yet
Amanda	Itâ€™s the end of all days itâ€™s the end of it all itâ€™s the end of the world itâ€™s the end of my wallet
itzyaboijeff602	visitor better fix what he started
Andrew Cahill	Wouldn't it be funny if everywhere on the Fortnite map EXCEPT Tilted Towers gets destroyed
Gabriel Santiago	I will be 2 hours late for the event because thatâ€™s when I wake up
Pixel	Haha youâ€™ve made a conspiracy about tiled every season since season 3, and nothing happens. Just please consider other things.
MxD Pie	No hate, but you've said, "BIGGEST UPDATE YET!" Like 5 times...
MarveledStar21 MarveledStar21	I don't think Tilted would get removed. The community would be outraged. You see every streamer going to Tilted.
*dabs*	Take a shot every time he says â€œtomorrowâ€, â€œeventâ€, or â€œtodayâ€
Jake The adidas king	Are we going to get trolled AGAIN of tilted getting destroyed
im a minority	Titled towers is being replaced by bilted bowers
Michu	Eyy happy this update is going to be nice and im hyped there is probably going to be some nice skins but i dont have v bucks rip and yeah as always i dont have v bucks but i still #stayhappy and tommorow is the day i would want to play with u happy but idk how i mean im not that active on discord idk bit byeee
Zack Attack	#StayHappy
Stephen Riggle	Iâ€™m just confused as to why this is literally in the middle of the week
Blitz	Oh no ğŸ¤¦â€â™‚ï¸ Iâ€™m late again.....
ZaPa Velocity	Aw the event is happening tomorrow? I ran home for nothing?!
nicholas Tanner	3,4,5,6
NK Skits	Can I support you as a creator?
Andrew	TILTED WILL NOT BE DESTROYED AND I HAVE PROOF  It's a battle pass challenge to land on the clock tower, so they will not remove it until at least season 7.
Tomato Solider	1:42 that is a concept art from Reddit if we enable two factor authentication, we should get that kind of face visor decor for the visitor skin.
Dinesh Sookraj	Nice
Skull kid for smash Aka Blank	I'm a simple man If I see The Visitor I click.
HunterC16 [ â€¢â€¢]	Guys the starry flight glider in the shop right now has a picture of tilted with a bunch of portals over it could that be the event tomorrow?
Yeet	Scythe ?
Destroyer Troll	I I w I wa I was I was b I was bo I was bor I was bore I was bored I was bored s I was bored so I was bored so I I was bored so I d I was bored so I di I was bored so I did I was bored so I did t I was bored so I did th I was bored so I did thi I was bored so I did this I was bored so I did thi I was bored so I did th I was bored so I did t I was bored so I did I was bored so I di I was bored so I d I was bored so I I was bored so I was bored s I was bored I was bore I was bor I was bo I was b I was I wa I w I
HeyMyName Is Space	PRAYFORTILTED
George papapetrou	I will sleep with a _smile_ Wich is unusual because of school I mean what?
jackabob 365	Is it RIP or rip maybe tilted will spit in half
Anthony-Adogs Army	Number of times he's said "this is the biggest update" in his lifetime:50
Shaan HQ	never get a heat and unnoticed
NerdyDirector	The visitor created part of season 4 5 6 and all of this is just a HALLOWEEN EVENT WHAT #StayHappy
EnglandIsMyCity	Well if you didn't see the post ''RIP titled ;)'' is from 6th September, and we're at 23 October, not that is some REEEEAAAALLL misleading information
ChelseaFan454	Tilted isnâ€™t going anywhere lmfao fucking headass clickbait
BrandonDaGamer YT	R.I.P Tilted Towers :(
emma imbrey	New visitor style skin?
ProdigyistheGOAT	Ice cube is a miracle yall spit saliva and i spit lava
FatalPlayzYT	#HYPE  #StayHappy :)
Caiden Day	Thanks to Happy Power We are all caught up on anything going to Happen  #StayHappy
LunaLink	Pretty much, particular,insane, massive
z0h3q	I am always happy when i see your Intro #stayhappy
Masked Dog	1:02 he spelled been correctly you dumb fuck
Saint Savage	I saw a tweet from fortnite that said that double pump is coming back but fortnite deleted the tweet
Tuguar	I think the main event is today, remember today it has been 2 days since the "portal" has been forming, it even says it in the files in "events" it's labelled "ROCKET_PERMARIFT" and it says it's happening at: 9PM BST today :)
Jake Shaw	Epic is always trolling us about tilted being destroyed
David Gonzalez	1 like = 1 protection for titled towers
CompareGaming	Fortnite tomorrowâ€™s update
Zer0 Bl4aze	Tommorow a book closes  And another one begins
Joseph Figueroa	At least this isnt a "todays event" video, oh wait its a "tomorrows event"...........
Mace HarvilÅ‚	Maybe instead of tilted towers going away, itâ€™ll be renamed and redesigned to something that I came up with like â€œCandy Castleâ€ or something like that
Rhys Rhys	#StayHappy all day long
Gemini	This shit is going to be disappointing
Huzafa Mughees	Just asking that shall i buy new halloween skins coming for tomm update or wait for fire works team leader to come back bcz im wanting her for long timr
Francesco Merlino	Ok now this is epic
Carlos PolÃ³nia	Visitor is doing wakanda forever
Rookie Gamenator	Tilted can not be destroyed in Fortnite because there are weekly challenges (for the battlepass) that need you to go to tilted towers.
Dat Scary Boi	Husks maybe? Save the World crossover? Save the World free?
Red X	Watch the visitor or something related to the visitor come in the shop
ğğšğ­ğğ¨ğ ğğ®ğ¤ğ	It's gonna be great! Let's go! #StayHappy
mell0	ğŸŒ‘ğŸŒ‘ğŸŒ‘ğŸŒ‘ğŸŒ‘ğŸŒ‘ğŸŒ‘ğŸŒ‘ğŸŒ‘ğŸŒ‘ ğŸŒ‘ğŸŒ“ğŸŒ•ğŸŒ—ğŸŒ‘ğŸŒ‘ğŸŒ“ğŸŒ•ğŸŒ—ğŸŒ‘ ğŸŒ‘ğŸŒ“ğŸŒ•ğŸŒ—ğŸŒ‘ğŸŒ‘ğŸŒ“ğŸŒ•ğŸŒ—ğŸŒ‘ ğŸŒ‘ğŸŒ“ğŸŒ•ğŸŒ—ğŸŒ‘ğŸŒ‘ğŸŒ“ğŸŒ•ğŸŒ—ğŸŒ‘ ğŸŒ‘ğŸŒ“ğŸŒ•ğŸŒ—ğŸŒ‘ğŸŒ‘ğŸŒ“ğŸŒ•ğŸŒ—ğŸŒ‘ ğŸŒ‘ğŸŒ“ğŸŒ•ğŸŒ•ğŸŒ•ğŸŒ•ğŸŒ•ğŸŒ•ğŸŒ—ğŸŒ‘ ğŸŒ‘ğŸŒ“ğŸŒ•ğŸŒ•ğŸŒ•ğŸŒ•ğŸŒ•ğŸŒ•ğŸŒ—ğŸŒ‘ ğŸŒ‘ğŸŒ“ğŸŒ•ğŸŒ—ğŸŒ‘ğŸŒ‘ğŸŒ“ğŸŒ•ğŸŒ—ğŸŒ‘ ğŸŒ‘ğŸŒ“ğŸŒ•ğŸŒ—ğŸŒ‘ğŸŒ‘ğŸŒ“ğŸŒ•ğŸŒ—ğŸŒ‘ ğŸŒ‘ğŸŒ“ğŸŒ•ğŸŒ—ğŸŒ‘ğŸŒ‘ğŸŒ“ğŸŒ•ğŸŒ—ğŸŒ‘ ğŸŒ‘ğŸŒ“ğŸŒ•ğŸŒ—ğŸŒ‘ğŸŒ‘ğŸŒ“ğŸŒ•ğŸŒ—ğŸŒ‘ ğŸŒ‘ğŸŒ‘ğŸŒ‘ğŸŒ‘ğŸŒ‘ğŸŒ‘ğŸŒ‘ğŸŒ‘ğŸŒ‘ğŸŒ‘ ğŸŒ‘ğŸŒ‘ğŸŒ‘ğŸŒ‘ğŸŒ‘ğŸŒ‘ğŸŒ‘ğŸŒ‘ğŸŒ‘ğŸŒ‘ ğŸŒ‘ğŸŒ‘ğŸŒ“ğŸŒ•ğŸŒ•ğŸŒ•ğŸŒ•ğŸŒ•ğŸŒ—ğŸŒ‘ ğŸŒ‘ğŸŒ‘ğŸŒ“ğŸŒ•ğŸŒ•ğŸŒ•ğŸŒ•ğŸŒ•ğŸŒ—ğŸŒ‘ ğŸŒ‘ğŸŒ‘ğŸŒ‘ğŸŒ‘ğŸŒ“ğŸŒ•ğŸŒ—ğŸŒ‘ğŸŒ‘ğŸŒ‘ ğŸŒ‘ğŸŒ‘ğŸŒ‘ğŸŒ‘ğŸŒ“ğŸŒ•ğŸŒ—ğŸŒ‘ğŸŒ‘ğŸŒ‘ ğŸŒ‘ğŸŒ‘ğŸŒ‘ğŸŒ‘ğŸŒ“ğŸŒ•ğŸŒ—ğŸŒ‘ğŸŒ‘ğŸŒ‘ ğŸŒ‘ğŸŒ‘ğŸŒ‘ğŸŒ‘ğŸŒ“ğŸŒ•ğŸŒ—ğŸŒ‘ğŸŒ‘ğŸŒ‘ ğŸŒ‘ğŸŒ‘ğŸŒ‘ğŸŒ‘ğŸŒ“ğŸŒ•ğŸŒ—ğŸŒ‘ğŸŒ‘ğŸŒ‘ ğŸŒ‘ğŸŒ‘ğŸŒ‘ğŸŒ‘ğŸŒ“ğŸŒ•ğŸŒ—ğŸŒ‘ğŸŒ‘ğŸŒ‘ ğŸŒ‘ğŸŒ‘ğŸŒ“ğŸŒ•ğŸŒ•ğŸŒ•ğŸŒ•ğŸŒ•ğŸŒ—ğŸŒ‘ ğŸŒ‘ğŸŒ‘ğŸŒ“ğŸŒ•ğŸŒ•ğŸŒ•ğŸŒ•ğŸŒ•ğŸŒ—ğŸŒ‘ ğŸŒ‘ğŸŒ‘ğŸŒ‘ğŸŒ‘ğŸŒ‘ğŸŒ‘ğŸŒ‘ğŸŒ‘ğŸŒ‘ğŸŒ‘ ğŸŒ‘ğŸŒ‘ğŸŒ‘ğŸŒ‘ğŸŒ‘ğŸŒ‘ğŸŒ‘ğŸŒ‘ğŸŒ‘ğŸŒ‘ ğŸŒ‘ğŸŒ‘ğŸŒ•ğŸŒ‘ğŸŒ‘ğŸŒ‘ğŸŒ‘ğŸŒ•ğŸŒ‘ğŸŒ‘ ğŸŒ‘ğŸŒ‘ğŸŒ•ğŸŒ‘ğŸŒ‘ğŸŒ‘ğŸŒ‘ğŸŒ•ğŸŒ‘ğŸŒ‘ ğŸŒ‘ğŸŒ‘ğŸŒ•ğŸŒ‘ğŸŒ‘ğŸŒ‘ğŸŒ‘ğŸŒ•ğŸŒ‘ğŸŒ‘ ğŸŒ‘ğŸŒ‘ğŸŒ•ğŸŒ‘ğŸŒ‘ğŸŒ‘ğŸŒ‘ğŸŒ•ğŸŒ‘ğŸŒ‘ ğŸŒ‘ğŸŒ‘ğŸŒ‘ğŸŒ‘ğŸŒ‘ğŸŒ‘ğŸŒ‘ğŸŒ‘ğŸŒ‘ğŸŒ‘ ğŸŒ‘ğŸŒ•ğŸŒ‘ğŸŒ‘ğŸŒ‘ğŸŒ‘ğŸŒ‘ğŸŒ‘ğŸŒ•ğŸŒ‘ ğŸŒ‘ğŸŒ‘ğŸŒ•ğŸŒ‘ğŸŒ‘ğŸŒ‘ğŸŒ‘ğŸŒ•ğŸŒ‘ğŸŒ‘ ğŸŒ‘ğŸŒ‘ğŸŒ‘ğŸŒ•ğŸŒ•ğŸŒ•ğŸŒ•ğŸŒ‘ğŸŒ‘ğŸŒ‘ ğŸŒ‘ğŸŒ‘ğŸŒ‘ğŸŒ‘ğŸŒ‘ğŸŒ‘ğŸŒ‘ğŸŒ‘ğŸŒ‘ğŸŒ‘
Pirate Drummer	Hey 3 was leading to it also. Because if the comet
Brady Eaton	Do u get a new visitor face if u do the new 2fa thing?
Nello	if smgs are still in the game ill cry
TakoFaik	hype!
PioneerHunt24	Fortnitemares trailer where you at?
Postboxpat Fan	Stayha________ #stayhappy
James Hanna	Rip Iâ€™m 300 v bucks away from ghoul
Ariona	Really need to learn to stop repeating your same point over and over again!
Lil Beam	U say been like â€˜benâ€™ not â€˜beanâ€™
Jamie Oshea	i hope husks spawn in on the portal, honestly that would be fun, or anywhere in the map
Daniel Hernandez	Sorry if I'm late I had school :(
Joe DePaola	Tomorrow is my birthday
Pavel Krutilek	Will be save the world in sale ?
Goose	Who else is exited?
caspar	Btw, the gliding glitch at 1:30 in the video can be fixed by pressing your crouch button mid air (CTRL). It's caused when you hit a Rift-to-Go while crouching :)
vortex simmer	Omg I can't wait
Anthony Chotey	I think that tilted towers tweet was for when the cube was in tilted
3Block ko	"Darkness arrives???" Something gonna come out of that portal im thinking save the world zombies
Plixy	Hyped for update!!ğŸ˜ŠğŸ˜„ğŸ˜ƒğŸ˜† #StayHappy
Dudes F'n Up!	I CANT WAIT TILL 2MORROW!!! IM FREAKIN HAVING A SIEZURE!!!  FACK!!!!  OH YEA, YOU INTRO SONG IS SICK!!!!!  WHO DOES IT?!!!!  A LINK?!!?  PEACE!
derpy thederp	I love tilted NOOOOOOO!!!
xsw2703	I wanted the island to possibly fill the divot up a little bit, I absolutely despise that place
Saints Fan	Fuck. I hope tilted isnt removed
LioTheLion 001[Xtra]	New map please
Julien Kulcsar	GHOUL BETTER COME OUT!
Mr. xarismak21	Your videos are insane mannn. I love them and i watch every single one but as you said in the previous vids your mic is dying. #StayHappy
Donald Doink	Tilted is going no where. Itâ€™s the MOST iconic spot on the map. They wonâ€™t change it, at least for a few season, if ever.
ariana arriaga	bruh all the do is add shit to the sky and make holes in the ground.
3DWaffle	Oh MA god i an so lucky My autumnholiday in School starts tomorrow ğŸ‘
iEXPLOZIV	Why is the Visitor Making a X with his hands?
Darkened Shadow	its gonna stay because of the challenge dance on top of a watch towtrr
Burrito Master	IM SOOO HYPED!!!!
Ben Evans	Biggest update ever - were u not there for the tilted update
A fucking faggot	Dude yes I wanna see the visitor return and end his storyline
What's in the Egg?	Maybe the rocket will come back and finally hit tilted towers?
DanielPlayz__ Jamjoom	why are you talking about the visitor, the visitor was since season 4 and now we are on season 6, the visitor is dead.
mesiroy1234	You make me to #stayhppy
SkellyViper	Also, when the rocket launch first happened, the voice said something like coordinates set and the rocket first opened the rift/portal in tilted. Maybe the visitor planned the cube doing this to tilted from the start?!
J Thomas	TiLTeD gOnE fuck off ğŸ˜‚
KingCreeper75	hyyype!!!!1!!1
spooky boi	Ur the best yt channel u my fav idc about heart I'm just saying
AntBee TheKing	How are u so good with vids? #StayHappy
Con the man	Thx for not being a crappy clickbaiter
Verdantglobe	I like the idea of having many things happening but not all at once. I want them to spam the events out
ayy snipezzz	Wow, in the community post I seen " Ghoul Trooper Rerelease" where in the vid did you talk about it?
LTN Shayaan19	Holy jeper wakz #stayhappy
1222 1222	2:20 porno sky whoa.       #StayHappy
Tyrese Soares	Man, Happy always Says "Tomorrow is Gonna Be The BIGGEST update" Then when The update hits It's Only Like 1gb. And Im like BRUH
rust lord gameplays	haunter towers <3
Yo hairline Sucks	An update hasnâ€™t been this big since titled was created as well as the other places
2 Quix	If they realese the ghoul trooper too I hope the OG version looks good they already ruined my skull trooper they better not ruin my ghoul trooper
5tann	what videosettings?
YSG glitch	If hey donâ€™t bring fuking double pump or pump tac ima be pissed
TooningPanda ,Gaming	I don't think anyone has thought about this but remember when the rocket was Going down to tilted and got sucked in by a rift? What if the rocket was Trying to hit tilted. Hear me out. In season 5, on that loading screen when the enforcer was at motel with the rift, he might be able to control rifts, therefore that's probably why the rocket kept on going around the map in rifts because the enforcer was stopping the rocket. This next rocket launch (if there is one.) Could be the visitors second attempt with the cube to help him.
LLJ	Fav YouTuber like if u agree
MurF.	So basically. Theyre killing their game
Jacob Lembrecht	It's not just season 4, it's also the meteors from season 3
-KrooKed -	Tilted always wins (hopefully)
Denver DD	No way tilted gets destroyed
Monkey gamer6	Down with tilted
Clash Gaming	Hello happy power is there a way I can contact you or send you something......thereâ€™s something you might wanna see
Mr J	Corrupted Tilted Towers? What if all the name places become a corrupted place like the corrupted areas with that Halloween theme still
Katan ix	I hope it has an actual story if itâ€™s all been leading up to a Halloween event â€œhighly doubt itâ€ Iâ€™m going to be majorly disapointed
Peggs GT	IF they are gona remove tilted        YOU KNOW THAT YOU JUST GONA DELETE THE GAME
AceCapXl	This has to be the best channel on YouTube for fortnite!
*sniff*	Whos donald mustard please let me know
Epic Darius	Wait tilted is my favourite locationğŸ˜­ğŸ˜­ğŸ˜­ğŸ˜­ğŸ˜­ğŸ˜­ğŸ˜­This cant happen RIP TILTED
Brucci Wayne Music	You say massive update for almost every update...
Sliiifer, The Sky Dragon!	Hey Happy, I really hope you see this but I have a theory. As of now there Is portal appearing in sky, which I think the cube is going to go through, here's how I think it's gonna go down. If you look at the floating island upside down it looks like a volcano, hence the reason volcanoes and stuff were found in the files, I think the island is going to flip upside down and the cube is going to detach and go through the portal, and with out the cube to help it float the island will fall back down to its original spot, but this time upside down and it's going to be a volcano.
Helen	Good_intro,,, watch_a_video_on_my_channel_if_you_want_a_free_music_to_add_sound_to_your_videos.
Lil uzi Verticusss	What time?
AdeptuM	STOP FUCKING SAYING TILTED IS GOING TO BE GONE, THERE IS STILL CHALLENGES THERE SO FUCKOFF, A POI WILL NEVER GO AWAY MID SEASON
GeorgieGaming	I'm getting so exited for this event thanks for the info Happy Power :)
Adan Elahi	Roman reigns have cancerğŸ˜¢
PandaOriginals	lol
dfgjkdbfk	penis hoe
meme boi	Watch how the new item gets disabled due to a bug
Hi Im Ustion	Watch everything come back
Gamezales YT	Itâ€™s like the Star Wars Trilogy
Shayan Suhail	Am I eraly
Jhon wick F	REST IN PASTA Tiltes towers ğŸ˜¢ğŸ˜¢
DBZSpice	Will the pumpkin launcher be permanent or hit for this event
Smugles	*Dab*
Specter 22	HEY #StayHappy
Cyanide	N O T T I L T E D
Holy Cucumber	If tilted is gone that will literally be a game changer. No longer will the first circle finish and only 30 people remaining.
Kaslanov	Someone please help my solo squad 26 kill game get 10 likes Please no one notices meğŸ˜•
Sledheads Wifey	Fuckkkkkk
Duddy PA	Yo happy wassup. #StayHappy
SoMexican	CAN WE ALL MAKE A VIDEO AND ASSUME SHIT????
Sam Gates	This is awesome, thanks for the news!
Humberto Reza	They finna pull some pet cemetery type shit and make characters come back to life with the ray
JHD Gaming	Your channel is growing so fast I was here since 120k subs
MazenTheBestGaming	I have been subbed for a few months now once I saw the description now I saw (slap that subscribe button) because I was subbed I SLAPPED the bell instead ğŸ˜‚
George O	Iâ€™m getting stw tomorrow too :)
Strongster32	Its a shame I wont be there my flight is today.
Leo Kilb	Has anyone see the volcano on the visitors arms
Prince Gamer	Happy wat is ir sensitivity on pc???
10000 Subscriber With One video	Not Tilted plz!
VeryAngryBird	STOP FUCKING SAYING TILTED IS BEING DESTROYED LMAO
Blazing KingGETC	Bet titled wonâ€™t disappear lol
devilgamer 72	What time is downtime in Pacific
Just your average toaster	So is there an event today at 4pm est?
Daegos	More Clickbait. I talk fortnite was right about you.
Liam Crawley	Hi
Jef Van Den Bergh	Make video over all you know off the christmas skins coming back
Miguel Daniel	Bad thing we will have to wait like 6hours to update game
winnie the buff	When ever people hype things up it is always disappointing
MrOhDocS	Will there be a Halloween starter pack?
420StrIkEz	3:10 to be continued....
Gaming Master	*waiting for Ali a's video*
Alexio Abrahams	Your the bomb happy I always watch your vids to keep up with fortnite news keep it coming and always remember stay happy ğŸ˜‹ğŸ¤¯ğŸ‡¿ğŸ‡¦
Zach F	This is all so annoying, too much waiting
Bromate	Not sure if this is true but if you look at the starry flight (glider) in store today  in the picture there is a clock tower and a portal a bit like titled and be portal
DESTROYER OF FACTS	Your #1 source for dailly fortnite entertainment
Andrew Madrid	Is ghoul trooper coming back?
Zeltuxx 27	When is the event?
Nugget	How many times do we have to tell people that tilted is going nowhere
VenomousShack 53	Which nationality are u:   0: Russian 1: Australian 2: Chinese 3: North Korean 4: German 5: Canadian 6: Emirati  7: English 8: American 9: Nigerian
Enigma AtTheDoor	Hey, happy, do you know what time this event will be taking place at, if it's a real time event? #stayhappy
CorgiKing	Well at least I got my final victory at tilted if it's removed
James Davis	Good bye tilted jk I know you still gonna be there ğŸ‘€
RobertSkuli	Can't wait. So excited to see the pumpkin launcher :D #StayHappy
BL4CK N!GHT	Great vid . U shud make them alittle bit taller
alfatrol 345	I was 778 like lol i ruind it 777
Ghashto Dersa	Can't wait for Darkness to finally rise, FAN ART. Jk.
GodRicky	Look at teir 80 of the battlepass. I feel like its going to be a skin for fortnitemares. 2:18 the tweet matches the spray
MC THEGOAT	What is fortnite mares
Gyleeno The Gamer	You are clickbating the title a bit. Th title says ''Tilted Gone'' while it isn't same with a coule other vids and stop hacking in the game it is against the terms of service.
Night Beast	All of this happend just because of a regular meteor
Mix-D	Honestly Going To Love Tomorrows Update #StayHappy EDIT: wait, if all of these seasons have been leading to fortnitemares, does that mean we are moving past the 1st era of Fortnite? Kinda sad if so
Potato Cat	How many GB in ps4
Â¡Hugo! - Me gusta la mÃºsica	OK HAPPY SERIOUSLY STOP SAYING AN UPDATE IS MASSIVE PLEASE
AnAutisticCat	BEGONE TILTED SWEATS
Zapped Tyrant	Titled Towers can't be removed as it's required for one of the battle pass challenges.
Dexter YT	I love you videos and you!ğŸ‘ğŸ‘ğŸ‘ğŸ‘ğŸ‘
Cactus Billy	Are we just not gonna talk about the enforcers
Frontal Ninja	whatâ€¦ the title/ Tilted? FINALLY?!
Namez Jackson	How do I support u I LOVE UR CHANNEL #StayHappy
Egg	Happy, if you go on fortnites Twitter, go to their post on the soaring update. On the epic games website (which is about the soaring update to all game modes. THEN LOOK AT THE GIF AND ON TOMATO TEMPLE THERE IS A HUGE DIRT PATCH. #stayhappy!
Srijan sathish	Tilted will not get destroyed as we know all the challenges can be finished even in last day of the season like that if tilted get destroyed how can we finish the challenge dance on top if clockğŸ¤”ğŸ¤”ğŸ¤”ğŸ¤” tower
Maxfilmsthebest	Hey your such a good YouTube hope you have a great day
xX_Necromancer _Xx	*Title says Tilted Gone *Instantly clicks
Dante Spenkelink	Is'nt there a event today at 4 est?
Gold_Guy 369	End of season 3 to season 6 XD   the meteor!!!!!
Raul Andres	... All the hype from Season 4 to 6 is just a halloween event :/ thats pretty dissapointing storyline IMO
Priyanshu Maurz	Hype is real ! Iâ€™m fapping
Craigh	Thanks for the info dude!
CRAZY MOTHERFUCKING TROLL	Your a really shitty youtuber tbhğŸ‘
Rhinoluncher	#stayunhappy
Shaun O'Donnell	Rocket comes back, trick or treating in retail will be added and tilted destroyed
Bounc3 Jump	If you was next to the cube, your youtube channel would be called Sad Power.
fahim Animations	Are the updates usually on Wednesday
Miron 1800	Do you think weâ€™ll see the ghoul trooper in the shop tomorrow after the update like how the skull trooper appeared in the item shop after the update like 2 weeks ago
Lucy Webb	Hi
umSlade	Happy power and comments are spoiling stuff being leaker means seeing stuff that are coming new and you guys are spoiling it :d #stayhappy
Potato Chips	What happened to the video posted before this one? ğŸ˜­ğŸ˜¢
andria c:	i bet 10$ tilted wont be gone tomorrow
thicc boiii	Helloooo
Chris Don West	Tilted ain't going it's just a meme
Pog	So, this is it. This is the end..
Prismatic	#HYPE #STAYHAPPY #WHATWOULDIDOWITHOUTYOU
Kaido Kirsti	Yeees tilted gone.i will be so happy if tilted gone.if not im going to melt down some kids in tilted.   :)
Fortnite Noob	So hyped. Probably will take 2 hours for the update to finish
Skullark Ecko	Not hating but Season 3 metero will destory tilted Season 4 rocket will destory tilted Season 5 cube will destory tilted Season 6 island will destory tilted ---_________------
Hamdan Alhosani	Perfect Timing
Golden Drop Productions	This is my job, telling old titles, Old Tittle : Fortnite tommorows massive update. #StayHappy. Also the season 3 comet relates to season 4 to season  5 to season 6.
ANGEL MORALES	#StayHappy!
kbgaming comics	Best fortnite leaker #stayhappy
Obunga Obama	Maybe the cube growth is like the story of gotg
KnickM	Short and sweet â€¼ï¸ğŸ’
Ledion Mucha	I dont know with what more to support you! I have clicked the bell icon and i give a like for every video, love you keep up the great content!!!! ğŸ˜ğŸ˜â¤â¤
x_Sh00k_ x	I'm tier 91
nodoka wakabayashi	Dude. No clickbait life
KAI	So early I got the original title#StayHappy
xSnow	Gifting????? lol thatâ€™s a joke lmao There never releasing Gifting
Mr.Retro Kid	Dammit im gonna be at school tomorrow.
Doez	Nooooo Tilted ;(
Junel Gapusan	Just want the Reaper pickaxe,,lmao
YaÄŸÄ±zhan Ä°nal	Who wss here before thumbnail changed?
Chang'e	Honestly, I'm tired of my teammates packing up at Tilted Towers instead of any other location. I would celebrate if Tilted gets removed #StayHappy
XXX TeNtAcTiOn	i left a game just to watch this
Lil B	#StayHappy
Thomas Campbell	great vid cant wait for the update
Savage_Wolf YT	The event is in 2 hours for me EDIT:5 mins left y'all
RuN Nightmare	#StayHappy
Forgotten Shadow	CAN'T WAIT #HYPE  #Stayhappy
Scythe	Nice video , #StayHappy
OhGrumpy Michael	You are gonna be wrong about tilted
Minionfartgun _fan	You are amazingâ¤ï¸â¤ï¸â¤ï¸<3
QadeerYT	No clickbait just quick vids to keep us updated that's why WE like him #stayhappy my friends
Jani Benjamin	ğŸ™Œ
Wasabi Fox	Quick question. Why would they bring the visitor back when it was apart of the battle pass. And no not the battlepass locker, it was for whoever that bought the battle pass in season 4 were able to do the challenges
Xx storm xX	Hypeeeee is real right now thanks happy power ğŸ˜ğŸ‘ğŸ»
Isaac Serrano	I'm early for once
CEEFOUR	Best channel ever #StayHappy â¤ï¸
Charbel Hayek	HYPEEEEEEEEEEEEE
itz BraZo	What time is the update
Alex Rivera	Stop hyping us up man ğŸ˜•
Saviorrr	Can't wait #StayHappy
Linah Vlogs	#StayHappy ! I cannot wait for tomorrow!
Jorge Hernandez	Dear epic, please vault smgs
Piques Cousin	#happysquad #notificationsquad #stayhappy
Rboert Trebor	Imagine if the voyager did something to go back in time and reset the map
BubbleGun 888	Hi
Badgerscool73 Life	Yes!!!! ITS FINALLY GONE! (Hopefully) you know how that town annoyed me....since i was playing from the beggining of season 2....HOPEFULLY.
Blank McBlankface	First
ZerÃ¸x	#HAPPYPOWERTHEBEST
ULTIMATE LeJ3n021	there is still that one challenge that includes tilted though so it will still be here
Destroyer	Finally no tilted
Shane Gonese	*LISTEN*
Firestic 27	Time to delete more stuff  Hahahahahaha
Dudecat	NOOOOOOOOOOOOOOOOOOOOOOOOOOOOOOOOOOOOONOT TILTED ğŸ˜±ğŸ˜±ğŸ˜±ğŸ˜­ğŸ˜­ğŸ˜­ğŸ˜­ğŸ˜­ğŸ˜­ğŸ˜­ğŸ˜­ğŸ˜­ğŸ˜­ğŸ˜­
FlipGURGS	#StayHappy
Aaron Greenberg	I'm super sick rn and probably staying home again. Time to play Fortnightmares tomorrow
Tarik	What Is that quality....
Super Pants	R.I.P Tilted Towers :[
Dario Arias	Iâ€™m in shool watching
edmoister	The â€œRip Tilted ;)â€ is from when the Cube crushed the buidling
Cryptic Sniper	Early
Cousin Gaming	Happy power I would put your pyramid V and your inventory Y, itâ€™s just some better keybinds if you want to use them as no other keybinds use them
Contortio thy 4th	I wonder if all those people that wanted titled gone will be pleased.
xd FinesseMonkey	If they add more of that *ugly ass* blockbuster skin then Iâ€™ll quit fortnite
Funids Son	Hi #stayhappy
Nidhal Mehfooz	who else likes the video before watching because u know that the video is going to be awesome. #StayHappy
Kareem Wes	This will be great then
ebaccanari	hey happy power do you think ghoul trooper and scythe will come back?
Sally Purple	I hope it happens at 4 pm for me tomorrow, because I have school
Process of Elimination	No Scythe for noobs
Sunglasses Tricker34	I think the scythe will be upgradble if the ghoul tropper gonna come back
Scotty Mathues	FIRST SKSKS
SgL Adventures	#stayhappy hey. I would like to help you protect ur content from other using it and not giving u credit. I tagged u on a ig post that was using ur video without giving u credit.
Sukhpreet Sarai	Yooo
DV PLAYZ	Whens the cube event going to happen
A cat	Well I guess rip tilted but I guess yeet?
Eemil Erola	Whats same about a squirrel and a piano??   Squirrel starts with s
D 4 R K	So early the title was Fortnite tommorows big update.
A3bood 82	Happy power youâ€™re my favâ¤ï¸route YouTuber
ãƒ„Unfunny	This got into my sub box now.
XenoidXZ	But the tilted towers tweet was on 6 September 2018 , it was when the cube entered Tilted and destroyed the Strip Mall
â˜‡â˜‡Fluffy pikachuâ˜‡â˜‡	Can't wait to I love your vids
Elite	No views oof
Corsa Miko	Is tilted really gonna be gone? :( #stayhappy
Y0SH1 DesTroyer	Yay
Alex 123452 carroll	Hiii
LegendHunter	Hey Happy, What stage is the Rift right now?? It looks very weird.. #StayHappy
tazegamer 05	When the update comes the ghoul trooper will more likely be in the shop
dEfAuLtZ g0D	When you clearly dont care about the update but you still watch the vid
T e l l m e w h y I m w a i t I n g 18	Calling it now weâ€™re getting bamboozled also wow I didnâ€™t know that the clicking so fast it was private thing was true cus when I clicked it went to a black screen with warning an the title didnâ€™t load..
Vader	NOTI SQUAD>>>AGAIN #StayHappy
Alfie Morton	Thanks For The Update, Love Your Content #StayHappy ğŸ”¥ğŸ”¥ğŸ”¥
Archill	rip my money lol
The Snipez	360p never looked so good
Illy Kaly	He keeps it short. And explains everything. That's why we like him #stayhappy
AeroDeBoi	I am early, let me tell a joke:     HappyPower is bad at fortnite #stayhappy
lone wolf 200868	It would be AWESOME if Happy Power hearts my comment!!!!!!
leroyVDãƒ„	360p sqaud??
iYrndonj -	Clicked on this so fast
Temp Celular	Let me guess......its gonna be delayed
Gelekte Tunes	Love your contenttt
Intense Atom	Best fortnite news guy
Arin_Ross	This might sound crazy but...       I was born on my birthday
Crystal	Great vid and cant wait for tommorow #stayhappy
Extreme Reviews	1st comment
Atomic Fortnite	i play fortnite i get no dubz im also a youtuber and i get no subs when i play i cant get a kill  and i like my own comment because no one will and i will beg untill somebody will
Arez Mangoor	Love ya
Burnt Kebab	Positivity positivity positivity
Kiing	Thanks for the update every day happy! We love you! #StayHappy
Misson:Classified	Ok guys is happy power the best youtuber I vote yes #stayhappy
Sara Wilson	*Blockbuster in the thumbnail:Wakanda Forever*
Robert Thurman	#stayhappy
White Devil	Hey happy#Stay happy
MANSTER	are telted well be go
Exotic Senior	Gifting system is taking to long.. anyway, nice video!
Gfcvgffvb Lopo	Why tomorrow why !!!
TSA Addicted	Yay
zrotheking12 100	First boys
fortnite cube	Early #stayhappy â¤
UnknownDZN	I remember you from gta 5 and now your here :)
Chad Adaza	Early. #stayhappy #noonecaresifyourefirst
Xmas_seek â€˜	Happy always early love ur vids man
mohamad zaatari	Hii
Ronin	I canâ€™t wait!!!!
Jake Driscoll	It sounds like you are daily dose of internet at the beginning no offense #stayhappy
Ottobite	heart this if you don't you don't care about me
Johan Matthew Davis	How to start an Internet Fight   1: Write something online in any public app  2: Wait patiently
COZYALYX	itâ€™s about to get spooky #StayHappy ğŸƒâ¤ï¸
NotRandomFortnite	Me early?
Lazar Beam	Officially 1st to speak
EaZe_kinglelep	Guess what   Read more
The Games	Yes
MxC GUNN3R	Not first
Toasty Channel	First like
Aimanop	Sup happy
Dead Pool	RIP tilted
zelix lol	:oooooooooooooo
Dark Legend	#StayHappy love your vids ğŸ˜
john101isBOSS112	My cockğŸ‘ğŸ‘„ğŸ‘
SSA	Hi its me agen. Love you and your Chanel #stayhappy
OverTaker #1	Rip tilted
Slankã€½an	Canâ€™t wait!
xd Morpp	Tilted noo
Mohammad Alnasif	I love this video
Fortknight	First
EgonYT	Iâ€™ll be here every time happy, #fortnitemares
heroees	Oof
Altan Dag	hey happy power ğŸ˜
Beni	#happy yooo
Comxndo	*happy is a great content creator* ğŸ’™ if anyone sees this I hope you achieve your dreams. The one thing Iâ€™ve always wanted to do is be proud of what i have done. Thatâ€™s why Iâ€™m trying to become a successful youtuber
laurens van egmond	Happy powerrrrrrrr
rhysupinhere	first
fortnite pro	First i love you're vids
ree despacito	lmao 32 ppl cant be first
Kurtongo Paul	ğŸ”¥
Parrio 72	Love your vids
Mr Mac	I cant wait!!!!
Keaton Pascoe	Hello every one if this gets 1200 likes I will tattoo happy power on my arm
Tamko	1
Guillermo garcia	NO TILTED oof
Oh Meow Meow	Itâ€™s not as big as the happy gang though #StayHappy
WallBangBanana YT	HOLY SHIEEEEET
Dehydrationz	Here for another amazing video ğŸ–¤ğŸ”¥
Hanone111 Fortnite	First
ISZ_FiZz	Hi happy power love your content! #StayHappy
Caiden	First one here
BTL_ Zhiyar	Lol itâ€™s private for me cause I clicked it too fast
minecraft master	Letâ€™s go who doesnâ€™t like a good update
Mako	If thereâ€™s no Tilted I will quit fortnite, yes Iâ€™m a tilted sweat
Kiran Byrdsong	7th comment
Churzy	Happy Power Wont Pin This!
Jojo Nilsson	First
Zizooo710 tt v	Noti sqaud like if your in the noti sqaud
TheMadhouse69	Hi
Rin	I am happy and I have power!
Yeeterson Peeterson	Yay another happy video
Fletcher Bargman	Again
Harry Redsell	First
Cat Guy	Fifth
King  Rillyza	Great video
Bl00dfilled	First like
Mike Nanokeesic	Hi Happy #StayHappy
Crystals adopted son tootall	First
lanki	#stayhappy
ItzMoose Bruh	First
qx _ALLAN123	Not tilted
Goonertillidie16	Ok
Hayden Workman	Ayyyyy love you happy
Yoshi Dabs	Yes I love your channel XDDDDDD
starwars starwars	1st like
Furious Bro	Hey person scrolling through the commentsğŸ˜™
JuanSolo	FINALLY it hit my subox
Klarisa Cami	1st
CraigBoi 101	Tilted
Baby Sinclair	#HappyPower
bLaZe Cxsmos	First,, the video is private lol
Ivan Caratachea	Big oof big oof
10,000 Subscribers With Two Videos?	WHICH STREAMER ARE YOU? 1: STREAMER[342] 2: STREAMER[231] 3: STREAMER[572] 4: STREAMER[629] 5: STREAMER[241] 6: STREAMER[666] 7: STREAMER[134] 8: STREAMER[189] 9: STREAMER[69] 10: STREAMER[423]?
Coolninja Flop	I donâ€™t know what to comment -___-
BeastMaster64 BeastMaster64	Wow
NRS_GhostPlays	1st
gpranithreddy Reddy	#Stayhappy
Gaming Reborn Steve/SR19742011	#StayHappy
Leprikon	Whaaaaaaaat
OGC Waves	First
Rayan Adel	Can you heat
Zulache	First
Angel Z	First
Jeppe Dahl	First
Fortnite Gaming XD	Fitst
Riley Taylor	1
omenxiii.	Nice Video My dude
Trash at everything. : God	Letâ€™s go
v3 Tempo	Stay happy
aboodi masoud	first????
Landen !	First
kjegod	Ye Boi
Vize DoomZ	First
China Man	Good video
MTsage	Like for scythe
Ali-A	1st
ãƒ„YoLo Lol	Hey
Watnan Bear	First
Pinhead543	It but my box
CloudyCloudz -	OMG
XxMilk_Da_CowxX	1
Not Zhn	private g4ng
10,000 subscribers with two videos challenge!?	What is green and can fly?      Grass, I lied about the flying part...
