petecarollsgum	U can say it now.............#seahawks
wilbrich30	Just get a baldy
One Jazzy Boi	Up 17 to non-nnn-n-n-nnnnnothin...  ğŸ˜‚ğŸ˜‚
Yung Gwaup	6:32
Tracy Lorraine	Dj mor and cam Newton my favorite players
Shark Commander	Who else wishes the Eagles lose a lot of games just to watch EDP have a stroke on camera.
Orioles1997	Youâ€™d think heâ€™d be somewhat satiated by a Super Bowl championship last year...
Evan Phillipson	try being a falcons fan
celtics8402	2:27 LOL sound like his dad is saying "Please cut it out"
Derek Blackman	EDP's blood pressure is as high as the Eagles' chances of blowing games lmao
Mr. Pugh	Cam Newton...We listen the hate and Keep Pounding!!!! Lmao
Garreth Boland	Born in '88, been a Bears fan my whole life. I feel your agony...
Owen Almoney	Just root for a new team jeez man calm your ass down
SAT Scott	Lmao...im weak asfğŸ¤£ğŸ¤£
ITRY	Lol.
James	2:27 I thought I heard his dad
Rushil Balkundi	urinatingtree criticized the eagles with almost all the vitriol he had and I thought EDP would have even more vitriol for this team. what we got instead was despair... it's kinda sad :/
Andrew Thomas	The first person I thought of after watching this miraculous come back... exactly the reaction I was hoping for. I shouldâ€™ve checked sooner. Pure entertainment lmfao
Dan Dombrowski	need the eagles to suck again so edp cant make more of these lol
Mikey Kreata Flash	Pressure buss pipes for EDP. I laughed and cried for 10 mins!! ğŸ¤£ğŸ¤£ğŸ¤£
Jonny Lake	Just stop.
Cam Newton #Superman #1Hunnit #KeepPounding #CAMVP	Jalen Mills trash ass let Torrey Smith run right by him on that 4th and 10
dee fuller	Talkthemuthafucka445
Mike Mathers	Calm your tits you won the Super Bowl last year.
ChouMakaimura	Pause right at 0:00. Thatâ€™s the face youâ€™d get after getting some good dick or pussy. Send that feelings to space. Let them cosmonauts see the fluids soar to the moon. ğŸ‘¨â€ğŸš€ ğŸŒš
Towqio	That person by the window lucky edp didnâ€™t have his gun out
Ajay Deonarine	Beautiful
wilson imon	That sport is shit
Darius Robinson	At least ya have a super bowl championship
D&E Gaming	Eagles suck
SeahawkFan1995	Eagles blew a 17-0 lead ğŸ˜‚
Jon Taylor	Heâ€™s bout to call a chatline now and beat off
Wolfy Chipmunk	Punchdatdoor445
Daniel Mead	You need anger management
Griffin Ellison	"Donnel Pumprey will have a better career than Christian McCaffrey "- EDP
Jon Caldwell	WaitingForTheFlag445
De'Juan Burns	Fair weather fan
Avery Reed	We need reaction vids bro theyâ€™d be hilarious
Skol TV	Glad we got to see him win the SB , back to regular scheduled programming
Wwe Stuff	Iâ€™m not even excited my favorite team the panthers beat the 3-4 defending super bowl champs i donâ€™t even care
JeffSan	Sounds like he was going to cry at the end
Pancake 26	Dat thumbnail tho....
RagingBlackGuy	Panther Nation Stand Up!!!
SuperLooey	this motherfucker is really selling merchandise!! aint nobody gonna buy shit with ur face in it!
99 Pac	â˜¹
Robert PutLastNameHere	You're a fake ass man. Not even gonna say fan bc its worse than that. Next time you come to Philly I will gladly take an assualt charge bc I'ma punch you in your fuckin mouth
Ricky Cutchin	Cammmmmmmm
JOHN WAYNE	the passion seeping out of this video has brought tears to my eyes
Benson Yazzie	its just a fucking game nigga!!!!!win or lose. it's a game, moron!!! uR 2 stupid 2 understand that. what's uR problem!!! uR 2 stupid understand that!!!!! fuCu nigga!!!!! boy.
Band up Blue	ğŸ¤£ğŸ¤£ğŸ¤£ğŸ¤£SALTY BITCH KEEP PIUNDING
Kevin Duffy	Welcome to the Super Bowl Hangover club. Sincerely, a Broncos fan.
mjmacias623	Admit it already.... Eagles super bowl was a fluke.
Matthew Shortle	Your team just won the Super Bowl dude. Be happy you got one. My Rams are 7-0 but we still have haunting memories going back to Super Bowl 36 when they lost to the Patriots to begin their dynasty.
Some One	HES BACK
MaddenWrecker06 The man	didn't the eagles win the super bowl last season, edp
Lil Joc	Just looking at EDPs head on the YouTube logo on his wallğŸ˜‚ğŸ¤£ğŸ¤£
tree70737	I love when the Eagles lose. This is my favorite part of the dayğŸ˜‚ğŸ˜‚ğŸ˜‚ğŸ˜‚ğŸ˜‚ğŸ˜‚ğŸ˜‚ğŸ˜‚ğŸ˜‚ğŸ˜‚ğŸ˜‚ğŸ˜‚ğŸ˜‚ğŸ˜‚ğŸ˜‚ğŸ˜‚ğŸ˜‚ğŸ˜‚ğŸ˜‚
Dwight 03	Yâ€™all betta get Peterson
D'Angelo Jackson	EDP Dogg, I love you but man, you can't let sports get this much on your health, I'm a raiders fan as hard as any other member of the nation. Even though gruden doing stupid shit, I'm.not letting it get to me, teams have their slump years. You can't let this ruin your health man. Sometimes teams need to lose, to finally understand and to learn what it means to be champions again
ThatCool Guy	chopthatoff445
Patriotic Sports	BREAKING: YouTuber, EDP445, hired as Eagles head coach after Jim Schwartz and Eagles rant
If you heard me speak, I spoke in all facts	You need to tackle that bald spot blood ğŸ˜‚
dlp1212	Fire Darby and Mills!!  Bastards are trash!!
Joseph Quinn	Never shouldâ€™ve traded Torrey Smith in the 1st place.
Regi Cheney	Painful
Charlie C	Try out for the Eagles my nigga
Logan Ne	You are my inner rage and conscience that I canâ€™t unleash in public broski!!! We in this together tho my dude! #FlyEaglesFly baby we got it mayn!
lucas ryan	Fair weather fan
EAGLE___EMPIRE	BlackHomerSimpson445
tes516	We need to send luo dang, the India sprite  head massage guy, and the foot with tool massage guy to epd445 so he can relax.
Alex Casas	Me watching the bowboys
Kenneth Page	the eagles got a ring and lost there fire!!!
Jeff Hass	2:26 Iâ€™m EDP and His floor is my meat
steelersfan 8417	If he gets this mad about a football team losing a game just imagine him  playing video games he probably threatens to kill himself whenever he dies in a shooter LMAO
Ibrahim Moizoos	I'm starting to wonder how the fuck the Sheagles won the super bowl
Sy Flembeck	Guess what EDP....guess who will still be in the hunt for the Super Bowl this year.  THE PATRIOTS!!!!!  Guess who will NOT be contending for it.  LMFAO at you!!!!!
Marvin Wade	YouTube knows me so well. This video was at the top of my Recommending videos right & they were exactly right, I was gonna look this up too ğŸ˜‚
Mr Meaty	Edp blew his virginity loss
Just Ice	Did anyone hear EDP's dad in the back at 2:27?
David Zavala	Scored in 3 straight possessions in the 4th quarter fat boy ha
PSY_Aphex	Angerissues445
Trump 2020	Lmao he's upset about blowing a lead .... Try beings colts fan ... We are the kings of blowing leads late in games ... It's horrible
iLLa SkriLLa	This year has been brutal to watch. Every game except 1 been down to the last 2 mins. Need to play 4 quarters of football. Foot on the gas pedal.
Silvio Aviles	Itâ€™s crazy because I actually flung my laptop across the table and towards the wall yesterday once this game was over. I didnâ€™t give a shit about it because thatâ€™s how upset I was at the Eagles blowing this game away harder than Abella Danger. Itâ€™s one of the worst losses Iâ€™ve seen and Iâ€™ve been a fan since â€˜98.
Jonah Steinberg	WheresYaHairline445
Ra X Automatic	Edp blood pressure is OVER 9000!!!!
Dude Perfect Junior	How do you think falcons fans feel tho
It's Just Matt	I'm geeking ğŸ˜‚ğŸ˜‚
Mike Conville	my nigga is right
Meech B	â€œFRIESâ€ in hell ğŸ”¥ğŸŸğŸ”¥
Abraham Vasquez	See u next week
eddibetty10	Shave yo head nigga LMAO Fuck you holding on to ğŸ˜‚
INB	FuckHighBloodPressure445
TW0man4RMY	LOL 6:30
jabba978	"I wanna punch the fucking dog shit outta this motherfucking YouTube plaque"  Humble brag
Griffinex	Doug still signing books bro lol
Dominic078	Lmaooo
Arturo Ramos	0:44 oh boy...
Tech 1212	At least we won the superbowl lol
DRock7977	Eagles are so fucking garbage useless bum team, awful damn players horrible coaches ugly wifes psycho kids everything is horrible with this disgusting team. Not a single player is even decent throw them all in the garbage bin ship the team to another city and sell all its assets.
Jsmith12292	That's why the Panthers motto is Keep Pounding.
fwied wice	He was pissed ğŸ˜‚
Kenneth Burgos	You know he was thinking about pastrami fries when he made the title to this video
Travis Fuller	I'm going down with the ship bruh
ChicagoDefense	As a bears fan I felt this
Coldzy	edp needa be the new eagles coach
Do Your Job Ya Fat Slob	Youâ€™ll be alright bro chill ğŸ˜‚ğŸ˜‚
Alex Roach	I feel your pain man. As a lifelong Panther fan...Iâ€™m used to the prevent defense when we got a lead and blow it or almost blow it. It sucks that coordinators donâ€™t wanna keep their foot on throats
Julio Abdala	"Demonetized"- YouTube 2018
B.I. 1421	Yea my Cowboys lost but this cat is always epic ğŸ¤£ğŸ˜‚ğŸ¤£ğŸ˜‚
Pablo Fiscal	He low-key still had hope the eagles would have won
Evan Koketko	It could be worse, you could be a Browns fan.
reginald mcneill	He has to go!!! Fireable offense!!
JazzyPrince333	Whoever said that, the best comedy comes from misery is a fucking genius.
kenny w	WHY CAN WE NOT GET OFF THE FIELD ON 4TH DOWN!?!? PATHETIC DEFENSIVE PERFORMANCE! TERRIBLE PLAY CALLING BY JIM
Philnelius Harris	Yall got a super bowl last season. Iâ€™m a Niners fan and super bowl XLVII still haunts me to this day. Iâ€™m worried youâ€™re gonna have a heart attack on camera.
nclanos	#KEEPPOUNDING!!!!!
Sam Parker	Better than my dang team
Noah Lanier	Eagles are ass they had the game but the coach is terrible.
Anthony Mangrella	I love you edp
Derek Mayfield	EDP on the verge of crying.
In CogNeegroh	7-9 or 8-8 for the Iggles
stevesmith19711	I cant not believe the Eagles blew a 17-0 lead. How the fuck can a team do that? Wow!!
Stank Nuffim	The only adjective he knows is "fucking"
xlaostha704x	"gives the game away". #keeppounding.  LMAO, dab on them folks.
Hangmin Cho	Why is EDP445 videos are age restricted?
Mason Mahoney	7/10 no asscracks or shirts off
Mike Angeli	Jim Schwartz donâ€™t run ur offense!! Wentz fumble made them lose lmao...U guys suck.Old man Torry Smith 4th & 10 catch was great
hazemonster	Eagles WILL give you a heart attack my dude...stress less.  I don't want you dead over the Eagles playing poorly.
IML WAY	Edp I hope this team on there way to London there fucking plane goes down smh ğŸ¤¦ğŸ¼â€â™‚ï¸
Balamssin	Alright then why you have merch on your walls
Jeremiah Belton	As a REDSKINS FAN this is quite entertaining. LMFAO
private pyle	445/200
Rod Sarv	Pastrami fries ğŸŸ will make you feel better ğŸ¤£ğŸ¤£ğŸ¤£
Black Libertarian	At least y'all won a super bowl, the falcons aint never gonna win one :(
Beastmode9000	At 2:33 I thought 4 a moment that it was Seth Rollins' Theme Song playin'! Lol!
deku	Punchthatdoor445
David Barber	lol the Panthers buckled down and won!
Josh Clausen	Energizer Easter Bunny ğŸ˜‚ğŸ˜‚ğŸ˜‚ğŸ˜‚ğŸ˜‚ğŸ˜‚ğŸ˜‚
eyanks2584	This is the high quality content we expect from EDP
RayvonFrom Virginia	Somebody peeled this nigga wig back mane
jackals1982	i smell you unc.
Richard Quinn	I take it the eagles lost?
Bflo23	Tell us how you really feel. Don't sugarcoat it.
Charles Philp	This fool is gunna die of a heart attack for youtube views lofuckinl
GBlackbeard 412	ğŸ˜‚ğŸ˜‚ğŸ˜‚ğŸ˜‚ğŸ˜‚ğŸ˜‚
Devon Dow	EDP Im a Panthers Fan till I die but I love your passion for the birds. Im soooo subscribed to your channel.
Seanbanks83	I never seen a team control a mans life more than the eagles do with this man
GPUFF390	Some where in there someone still looking for is Vaseline
i2Shea	Eagles season fading faster than mine and EDPs hairline, real talk.
Mike K	We coming hawks!ğŸ¦ğŸ¦ğŸ¦ğŸ¦ğŸ¦
Its Ali64xX	I hope there are fries in hell
Elvis Silva	This guy overreaction is beyond hilarious. ğŸ˜‚ğŸ˜‚ğŸ˜‚
David Miniel	Who shouted for him to cut it out?
Collin Hart	Gotta eat that L sometimes
Dragonell Z Stop Motion	#TACKLETHEMUTHAFUCKA
Julio Ventura	Good thing he ain't a Raiders fan
Pancho Pistolas	Summer Olympics Bobsled Hairline
Michael Price	I love this channel, & as much as I can somewhat relate to this channel as a Texan fan..(bc we always find a way to fck up) ik at the end of the day itâ€™s all only a game. As much as I understand the struggle I will never get why you always act as if they will never win anything or why itâ€™s the end of the world. Although it may only be for YouTube for you.. Whoever wants to base their life on a sports team getting somewhere is a waste of life.. there are many more things important than that. Hope one day you get that. If itâ€™s for YouTube itâ€™s obviously worked & congrats.. otherwise get straight
BlockHeadG	Edp s dad canâ€™t fap in peace, the ungrateful son.
Dj Bernal	They need to have edp in the locker room when halftime comes so he can do this exact shit in front of them lmao
WMACK0523	KEEPPOUNDING!
Pharaoh XCIV	At least yâ€™all ainâ€™t Giants fans Iâ€™ve had to sit through shit seasons year after year. At least the eagles are actually a good team they just have to execute on defense when it comes to third downs.  #giantsfan #1-15 #tankszn
MadMan 90	ğŸ’€ğŸ’€ğŸ’€
A J	â€œ...And The panthers keep the drive alive â€œ
ArcTrooperMaize	God fated EDP and the Eagles together to give us amazing give us content like this
Steven Kemp	EDP FOR EAGLES DEFENSIVE COORDINATOR
Young Slyme	HOLD DAT L BOYYYY
Seth Haze	Eagles making this man lose all his hair ğŸ˜‚ğŸ˜‚ğŸ˜‚
hi lo	Has a 15 year old, I fell your pain :(
Shill Flock Ave	â€œFrysâ€ in hell
Freeflow Lifestyle	Look at what the eagles did to EDP hairline.. lol
Alex Diaz	Die Eagle Die. On the world to your suckiness...
The Sports Fan	Your dad regrets not aborting you
Shadow Zone	This nigga talking about attacking jim schwartz with a machete.
Michael Escobar	Clicked off Jason Garretts bitch ass to listen to some real shit.
LV Joe	Take that machete and chop what's left of your hair off
Mr Mimi	Edp needs to get a punching bag with jalen mills and Doug Peterson on it. #GetThatExercise445
SAE Erb	I think it time for you to find a new team bro.  Your putting way to much emotion into it.  You remind me of my 5 year old son when he loses.  Life is too short to be butt hurt every week man.  True fans rep and stick with their teams through good and bad.  You should be a Patriots fan if you want a team that wins.  They might cheat but at least they win right...
joey flores	PunchDatWall445
Reginald Gonzales	ACL,ACL,ACL
veritas1007	good luck with trying to get a 1/2 million subscribers o also the Falcons will maul the Giants on Monday night
Cam Kuechly	Yâ€™all just won a super bowl ğŸ˜‚ I would take 10 0-16 seasons for just ONE super bowl ring
tbraysfan2008	2:26 was that his dad yelling in the background?
Zoron	This is what happens when someone schmuck gets so into a sport they keep watching as their blood pressure raises and despite bitching all the time about a team they keep watching them
Jamaal Miller	Chopthebitchoff445
Emmanuel Garcia	Lmaooo yall better watch yourself guys if you pass by his window u dead
D'Tywuan Davis	BlowingLeads445
Steven Exil	2:21 when gohan kills cell ğŸ˜‚
EnSabahNur	My nigga you need to step away for real instead of this back & forth bullshit!
whip tater	watch that BP BRU TAKE IT FROM AN OLD CAT FIND SOMEBODY WHO GOT SOME MEDICAL, CUE UP FENCE WALK, GUARANTEED IT ALL WILL GO WAY LIKE A PUFF OF SMOKE TRUST ME. MATTER FACT I'M GONNA YOU TUBE THAT CUT RIGHT NOW
Rucci SODMG	ğŸ˜‚ğŸ˜‚ğŸ˜‚
KuljuSportsGamingHD	classic edp
NickFoles IsGoat	Bro this pissed me off
garrett king	#KeepPounding
George Peezy	how can someone be such a bitch after his team winning a super bowl.. embarrassing
Matthew Ludwig	EDP this team is not worth getting angry over. But its OK. I know your the most passionate eagles fan out there. I hate to admit it bud they deserved to lose but I will also give the panthers credit. I'm plenty pissed off too but please don't hurt yourself. The eagles have a lot of issues at rb, o-line, cb, safety, lb. Hope they can get these issues addressed soon. They better get their act together against the jags.
Scuz	Was it the refs fault this time edp?? Quit sleeping on our ass mad ur team fell tf off.
#1brother	I'm a Panthers fan and I've been waiting for this lol
Corey Petroskey	I wonder if the eagles players have seen edp
Pahco da Don thomas	I love the Eagles win or lose we got to fix some things....we good
Tony Wade	LOL
Dabket3araB	This is gonna be good. Get your snacks ready.
MrBaddog7676	Lol! As a Giants fan, these videos brighten my day ğŸ˜‚ğŸ˜‚ğŸ˜‚ğŸ˜‚.
ps4god d	When we loose I just go to the video when we beat the Steelers ğŸ˜­ğŸ˜‚
NORTH CAROLINA MUSIC	Lmao legendary
LukeTes	classic edp
kcjuggalo2001	Fuck the eagles!  Go Chiefs!
bryan ifeanyi	You are hilarious lmaoo! As a fellow die hard Eagles fan, I was so shocked but more so disappointed on not executing this win that was rightfully ours!! We dominated til the 4th quarter then bad defense play calling and blown coverage mess shit up! Idk we need to make serious adjustments fast. This game was a remix of the Titans game like you said. Itâ€™s still fly eagles fly! Now weâ€™re on a right thread before our bye week...
brandon ADAMS	I hope the eagles bring me pastrami fries in hell
Overkillz25	TackleTheMothaFucka445
Darius Powell	Man I wish he continued it so we could see him freaking out as the Eagles tried to comeback
adam7mma	It really says Eat day pussy on that YouTube plaque! ğŸ’€ğŸ¤£
Rock City	Blow that lead 445
XXXTENTACION LLJ For life	#FreeEDP445 after he murders Jim Schwartz with his smelly ass
LPS_Biggie	As a Jags fan, I feel you rn. We're in the same place going into London, and it's gonna be a shitfest the whole game, on both sides I'm guessing
Joshua	Say what you will, EDP has every right to be upset.
Dan P	I was so hoping the eagles would lose for this video lol
Frank DeAnda	That lead went away faster than that hairline.
THicc Grimes	Oh fuck, EDP got a play button?
inferdus	how many times does he says fucking
Erik Mitchell	21-17
Edward Kelly	Cheer up Jacksonville is banged up on offense so you guys should get a win next week.
Buddy Barlow	H T T R but on another note man...Philly just ain't as good as they were last year man, it sure as hell won't be a repeat this year for you boys.
Dub Snac	I honestly wonder how EDP would be if the eagles were a good team every year maybe he skinny not a virgin and has amazing hair oh well the world may never know
Duane Akerfelds	If you dont like EDP then fuck you
Sports Highlights	Love your enemies read Matthew 5:44
PacK Winded	This video is gold #NOBODYCANFUCKINTACKLE
VortexFX	Still canâ€™t believe I saw this manâ€™s ass and second ass on his stomach
Art87 Stang	We lost too man Dam Cowboys.  . Lost
Jonathan Bunting	Worst game Iâ€™ve ever seen. I definitely ranted harder than EDP. Team is a joke
Magic BurritoTV	BurnInHell445
James Lisle	JackOffToSuperBowlHighlights445
Olutomi	The only thing to take my mind off an Eagles loss is an EDP reaction video.
Dazzy Rockz	I waited all day for eagles to blow the game and watch this video
Coolgaming17	This so funny cuz Iâ€™m a panthers fanğŸ˜‚ğŸ˜‚
Quentin	When having a bad day just binge watch EDP videos
Rick James	Httr we on top lol
StevenPT Martinez	Highlights  2:25 3:58 7:00
koi kid	Once again tf is up with this thumbnail
Luis Heredia	Edp should be an ESPN reporter
Nyc News Now	Lmao yo everytime the eagles lose  you know it's  gonna be a classic vid with this guy
Alex S	Damn edp rocking the Lebronline
rogerskolney	The Eagles held that lead about as well as your head held its hair.
Stoner Phoenix	#keeppounding
Robert Mormando	Damn EDP bout to get his ass spanked by his Dad
Tyler Andrade	I'm a Pats fan and despite winning 5 rings this is how I react when we go down 7-0 lmao. Fucking football does shit to your brain.
LimewhiteTV	Hairline on 4th and forever
Robert J	Waiting for your mother to come in and tell you to keep it down.
Swagmaster116	CoachThoseEagles445
Swerve J Jordan	Who else taking a big ass shit watching this?ğŸ˜‚ğŸ˜‚ğŸ˜‚ğŸ˜‚ğŸ˜‚ğŸ˜‚ğŸ˜‚ğŸ˜‚
Patrick	Didnâ€™t the eagles like just win the Super Bowl.
M Gregston	4:05
Ninjafrogz	I was watching the game thinking about EDP making a video like this.
The Gambler	The title alone had me dying....give it 2 them
Frank Moyer	Blame the new NFL tackling rules also
ThatOneGuy 123	Hahahahahahahahahaa how â€˜bout them Panthers!
Mario Soriano	The eagles blew the lead again choke eagles choke
Spoopy Danny Boi	The 49ers have it worse
JewwBaccaa	This video is gonna get a copy right strike
Matt Sheiman	2:46 Look at the challenges facing the nation and say *FUCK!*
J I	Wecanttackle445
Mr 28-3 YALL THOUGHT YALL HAD IT	Bitch ass nigga thats what yo fat ass get
Lakeey	as an avid carolina panthers fan, I enjoyed this video
Logan Swartz	I still think the Eagles can win the NFC East
Brandon Kelso	Literally downloaded this video. This will cure depression
fixxxer3456	Welcome to how Falcons fans feel on a daily basis EDP
Biggie Sneeze	Don't let the Eagles losing distracted you that the fact cam newton spiked on 4th and 1 and mcm didn't get the 1st down...
Jason Smith	Here comes the rage....
Eric Wollam	I wonder if EDP knows that the majority of his fans not from Philly are just from /sp/ and 4chan
Dante Guardi	EDP should be a guest on Barstool sports show â€œpardon my takeâ€
Illusions	Before I even clicked on the video, the title had me dying lmao
Jose Moreno	It seems like Felipe isnâ€™t getting his cheeks busted tonight being that the eagles lost, #bustthemcheeks445.
Joseph Russell	Is it wrong for me to enjoy his misery?ğŸ¤·ğŸ½â€â™€ï¸
Bman 4	If Edp puts an age restriction on the videos there should be no reason why he got terminated.
Jeremy Ross	Hilarious ğŸ˜‚ğŸ˜‚ğŸ˜‚ğŸ˜‚ğŸ˜‚ğŸ˜‚âš°âš°âš°âš°
Parker D.	I stopped watching Lana Rhoades for this
Vinny Smoove	This nigga don't be that mad he knows we love this shit ğŸ˜‚ğŸ˜‚ğŸ˜‚ğŸ˜‚ğŸ˜‚
Dennis Allen	Lol. Keeppounding.
bumblebee	Highlights: â€œheroin bird lookin-â€œ â€œ2-0 what the fuck-206â€ â€œNOBODYEY CAN FUCKIN TACKLE EM- *breaks table*â€ â€œI wanna fuckin throw up right nowâ€ â€œand youâ€™re like the energizer fuckin Easter bunny and shitâ€ â€œthey better get the fuck away from my window Iâ€™ll light these motherfuckers upâ€ â€œI hope this team burns in fucking hellâ€
Dr Pavel, Im CIA.	Wentz Cox Ertz Alshon Goedert Bennett  Thatâ€™s it. Everyone else can die.
-azzcheekz	This man was really about to cry lmao still love u edp
Jacob Anderson	Bro i havent seen edp this mad in so long
Jack Azz	Xvideos > Porn hub
Bad news Brothas	Kill jim schwatz445
Bryan Ho	Ripmyass445
Smallnappy	And then there was the Cowboys game...
Bashir Shah	The video starts at 0:00
Jay C	You said you done with the team WHY YOU MAD? ğŸ¤·â€â™‚ï¸
Byakuya Kuchki	EatThatL445
Patrick Star	I left my grandmas funeral to watch this
Xero-TheBig-Boss	Season is over we ain't making playoffs for sure. Even if by a miracle we do make playoffs we lose in wildcard.
Abdul Inniss	You should have traded Carson Wents to Cleveland for the number 1 pick. Nick Foles should have been your starter.
Paul Sexauer	And the Philadelphia eagles have blown a 17 point lead unbelievable ğŸ˜‚
Eddie Navejas	Thank you baby jesus for the eagles losing lmfao
The United State Of Iowa.	GoingToShootUpTheTeamBus445
Illest one	I was waiting for this. LMAO this team ain't repeating this year. RAM'S are taking the NFC this year!
Julien Johnson	Edp hairline look lika puzzle peice
Jonathan Joseph	Heroin bird Motherfucker
COWBOYS NATION	WE FUCKIN LOST CAUSE OF A MOTHER FUCKIN FIELD GOAL.  COWBOYS MANAGEMENT YOUR FUCKIN STUPID. WHY THE FUCK WOULD YOU GET RID OF DAN FUCKIN BAILEY
moe dog	Eagles losing is the best thing to happen on Sunday because you get this , we need a 0 and 16 season to see how bad he goes off ğŸ¤£ğŸ¤£
plowerman78	Looks like hes gonna sleep in his car again
Hulk247	ğŸ¤£ğŸ˜‚ğŸ¤£ğŸ˜‚ğŸ¤£ğŸ˜‚ğŸ¤£you Channel is pure gold bruh!!! I KNOW how you feel. Iâ€™m in Cleveland and is a browns fan.. we give damn near EVERY game away smh ğŸ¤¦ğŸ½â€â™‚ï¸
Kevin Wright	Funniest shit 6:32
thesaintsangels89	Edp best advice I can give ya is to take a step back nd to stop idolozing football over everything in life for ur mental nd physical overall being ...but then again..hopefully if ur not as stubborn...then no need to worry about that cat being stuck on that tree
hypeboy95	Even thou its his name...im still on the fact his youtube play button really says EatDatPussy ğŸ˜©ğŸ˜­ğŸ˜©ğŸ˜­ğŸ˜©ğŸ˜­ğŸ˜©ğŸ˜­ niggas a legend
El Poundo	Bet it was worth it when you won super bowlast year.
nah im not real	How bout them rams
RockSolidEJV420	I donâ€™t care what anyone says. Eric Reid made that interception.
swebbmann	LOL
Chumba	Game was so fucking horrendous to watch. Lost my whole high watching that weak shit.
sliehgtofhand	Hey Brian, sorry but I copyrighted the phrase "sit/sat back" a little while ago, I watched a lot of your other videos and you owe me about $700,000.
f00zh	dude's still fat and going bald to boot
Adonai G.	Your team just won a super bowl lol
Jason Bailey	#KEEPPOUNDING  4-2 on our way to the Super Bowl!!
Parker Anderson	GOAT GOT HIS CHANNEL BACK!!!
Orlando Lemus	Idk wut to say idk
YDE KALI4NIA	At least youâ€™re not a 49ers fan
that guy	If Trump became president EDP can become the head coach of the Eagles.  Lmao
Godzilla John	Hey guys, forget football. Here is the *real* reality:  Jesus Christ died on a cross to save people from their sin, according to the bible. Then Jesus rose from the dead, 3 days later, thus defeating death. Anyone who believes this will not perish but will have eternal life.
NFresh	Eagles soo traashhhhhhhh lmaoo
Ruben Leal	He gunna cry in the car...
Backyard Mechanic's	cantnobodyfuckintackle445
David Camba	Who else comes to EDPâ€™s channel just to see his reaction after the games I know I do ğŸ˜‚
Black Star	Watch how he's gonna dickeat when we start winning
Sean Wallace	SmashThatTV445
Ricardo Garcia	Bro yâ€™all just won the SB Iâ€™m a fucking cowboys fan and I would still be happy if my team won the SB even if they went 1-15 the next season but shit the Cowboys are fucking dog shit and those mfâ€™s I hope those mfâ€™s wives cheat on all them fuck the cowboys sorry ass Fucking team
Winston Haywood	lmfaooooooo when Carson fumbled on that last play, the first thing I thought of was "EDP BOUT TO GO OFF XD!!!!!"
George Is Straight Elite	That hairline threw a pick 6
the man	Jaguars vs Eagles next week in London (England gets another dud, take that NFL)
Denis Rodriguez	Try to be a cowboys fan
James Smith	Whyâ€™d you take the sticker video down
Mir Carson	6:35 so we just gona ignore that lolololo
michael edwards	Lmaooo it's been alot of choke jobs this week
Geeked-OutTurtlesFan38	It could be worse. You could be one of those toilets you clog up every day. ğŸ˜‚ğŸ˜‚ğŸ˜‚
daniel maldonado	As a Cowboys fan I feel the same way about the Cowboys Garret needs to go Jerry Jones needs to die we will never win another super bowl as long Jerry Jones is around heâ€™s the cancer for the cowboys
Benzi Musiq	show off the youtube award now why will ya LOL
Ed Carlon	Them rams finna eat that eagles ass
JayyBird	That moment when you tell your favorite team to burn in hell.......
BOONK GANG WHOLE LOTTA GANG SHIETTT	Lmao you called it on your instagram. Been waiting for this bruh.
David Jackson	You look a little salty. You should take a shower. #patriotsnation
Breezy7	This thumbnail tho ğŸ˜‚ğŸ˜‚
James Voufo Safor	Who couldn't wait for EDP445's reaction after the game
Andrew Sullivan	Just got reinstated to Youtube - Now wishes over 50 players and coaches to burn in hell.
Lex Haddon	Look on the bright side cowgirls lost
Jon Day	Fake reaction.  Hamming it up for the camera.
Joe Kieffer	At least my Vikings won
SIR SI3GHAN	This comment section is for the mature only.
Donald Trump	I stopped fucking Melania for this
Liberty Minded Solutions	Root for the patriots
stinkydroolface	#DIDITFORMOMS
The AUX Cord	I'm a browns and eagles fan. The 20 years of my life have been pure agony
John Carter	Damn the emotion in EDP's voice at the end of this video was so sad. ğŸ˜¥
snowman texas	Eagles suck
Beanie	What happened to the video after this one?
p i	After a 17 pt lead man
Abraham Rivera	Man I knew you would delete that video if you ripping that Eagles sticker from the back of your car ğŸ˜‚ ğŸ¦…
bruno romero	I feel u edp ğŸ˜ª
Brazen X. Calibur	He's acting like they didn't just win the Super Bowl last year.
Dan Albanese	What yâ€™all think EDP room smell like?
Paperbag1124	Energizer Bunny XD
Michael33R	When EDP445 dies, he should let the Eagles D lower his coffin so they can let him down one last time.
Kyle Syamken	My Cowboys and my fantasy team are losing but this video alone is what made me decide to put down the jug of bleach again
Noah Scott	I feel your pain as a bears fan
Ryan Cooper	Love reading the comments, yâ€™all funny as shitğŸ˜‚
Slack Attack	We have a QB playing at a MVP level and Zach Ertz and Alshon are balling out ..... HOW THE FUCK DO YOU BLOW A 17 POINT LEAD IN THE 4th ......
THE GOAT	Being a patriots fan is worth it FOH
funkyflights	Go back to Nick Foles, he's the better QB, play's better under pressure...
Connor Leeson	Hold this L #KeepPounding
mjstory1976	The Chokles ğŸ˜‚ğŸ˜‚
Everydaysporttalks	the eagles win the superbowl last year why first him one year after. Yes there defense should be better but  that just going overboat
Dark warrior7000	That game score was 21- 17 my team won that 38-31 #NewEnglandPatriots
oJC Swaqq	not evening laughing is just frustrating being a fan of this team u never know what to expect from them that's how they are just embarrassing wow
this is quist	HighBloodPressure445
sat716	What was the video he uploaded titled: "yup im a fake fan ğŸ˜˜ğŸ˜˜ğŸ˜˜" about
kc 3182x	A fat virgin crying lol!!
Holden Chase	Sorefist445
DA Cousin	PunchDatDoor445
D. D.	Fry Eagles Fry!
Tyme	Eagles are gonna make him commit breathent
Bill bob	Football making EDP445 balding
heatchamps2011	U wanna see a worse defense ? The dolphins
Country Road	Dam and you know Newton got under that skin doing all his Corny ğŸŒ½. Shit
matt13r1	Eagles could win back to back Super Bowls and you still wont be happy.
Shark Deepwater8	Bruh... "Fries in hell". Can't keep away from junk food if he tried.
Biggus Dickus	Newton>Wentz and thatâ€™s facts
Some Asshole	He tearing up lol
Pedro Leco	Give me the philly special... hold the Lâ€™s please! #keeppounding
bee dot a dot	The title supposed to be "I hope this team brings me fries in hell"
Novashock 12	Blood pressure through the roof
Sam Sackett	EDP should livestream himself watching the game
SwagTitan	I stopped having sex to watch this
bio hazard47	Defense is trash
Gimili101	I'm guessing that when EDP dies 30-50 years from now, it'll be of a heart attack from recording one of these fan rage videos.
LJG	This is why we sub people.. this is what we wait for!!!
RoachClip OTG	The Eagles defense been choking all year
C OhHiOh	This was me during the Ohio state game
u yuh	can you please fix that hairline
randomdude476	Exactly why I want Bob Sutton (Chiefs) fired!
Zach Stacey	Hold this L
Arthas Menethil	2018 eagles= 2013 Baltimore Ravens.
Matt Bradley	Lmaooo I CAME HERE TO SEE THE MELTDOWN
javier ortiz	Take a chill pill ma niggah
Chris Lee	Panthers picked their teeth with Eagle bones. Carolina!!
TheREALTittymaster	Time for you to ride off into the sunset and quit all this.  You've made an ass of yourself long enough and it's tired AF.  Sell your shit and make something of your life.
Mikey	2:23 Ohio State fans last night
William Reed	Thatâ€™s what ur garbage ass team gets for dancing on the field celebrating before the game is over #panthers4life
Ty Pls	blood pressure 666/420
TheSpriggins28	Heâ€™s back
Zack	That moment when EDP's Dads deodorant gets more ass than EDP ğŸ˜‚ğŸ˜‚ğŸ˜‚ğŸ’€
Czech The Great	WHO THE FUCK IS WATCHING HIM IN DA FLAT?!?!?!    All bullshit aside, I'm hoping Bryant  has a good season and works on having a better attitude towards the eagles!  âœŒâœŒâœŒ
Bart Simpson is gangsta	EDP yall just won the super bowl why tf are you raging lmfao chill and go watch sum porn ğŸ˜‚ğŸ˜‚ğŸ˜‚
Jordan Singer	WeNeedLeveonBell445
Dino Cerquetelli III	Jalen mills is gonna be publicly executed for that coverage on 4th and 10
Leonard Taylor	If we didnt watch the nfl, you would never know this team won the super bowl last season.
Ethan Vance	PHILADELPHIA TAKE OUT YOUR METRO CARDS AND BOARD THE L TRAIN DUMMIES ğŸ˜‚ğŸ˜‚ğŸ˜‚ #KEEPPOUNDING
Alimony Pony	My man said that heroin bird lookin nigga about Jim Schwartz has me weaaaaak
InQuickWeTrust	Football is so gay
Stompin Thomp	As a panther fan, Iâ€™ve never been so hyped for an EDP video.
zac taylor	FuckThatTeam445
evan johnson	You think your team is a joke, take a look at my team the fucking a jaguars, our backup QB is better than our starting QB
MrQuestionBox	Amen!
Brent Skomsky	eagles are still the best team in the nfl
Thefallen Griefer	I would love to watch him play Madden ğŸ˜‚ğŸ˜‚ğŸ˜‚
David WhoIM	Wait for it.... Boom
John Gotti	Jim Schwartz is sucking his moms cock.
Ocho	ChopTheBitchOff445
The Real Yoda	We need to get rid of Carson Wentz
Thisaintwhatyouwant	LOOK AT THAT...LOOK AT THAT SHIT...LOOK A THAT SHIT!!!!!!!!!!!!! LOL LOL
Ben Shapiro	Show us the TV.
beastman736	Quit fucking bitching you fatass fucking fuck Jesus Christ thatâ€™s all you do is gripe
Cannon Cook	bruh, your team just won the Super Bowl like 9 months ago
Juan Felipe	Back to the old eagles
Phil lee	I punch holes in walls with my fists you big pussy and it don't make my fists sore. . .Imagine all the dents in your fat whale ass head after I got done with you faggot!!!!!
coltonphillips725	I don't understand how Carolina won that game but I'm so grateful for the win .
Rh2_04	MadAsFuck445
Gregory Cunningham	He was actually about to cry ğŸ˜‚
steelman46	keep the faith EDP! You just gotta believe! Repeat! Repeat!
donovan Poole	Hey itâ€™s okay gg tho panthers put in that work but yâ€™all gave us a big fight
Sicksi	DeleteThatVideo445
DOOM PhD	TALKING ALL OF THAT SHIT WHEN THEY BEAT THE WORST TEAM IN FOOTBALL LOLGIANTS
MOE money	Ima jet fan and this made my day after that performance  today.ğŸ˜‚ğŸ˜‚ğŸ¤£ğŸ¤£ğŸ˜‚ğŸ¤£ğŸ¤£
SpartanStahl	The way his Carson wentz poster looks. His right hand with the football blocks the â€œEâ€ so it looks like â€œFaglesâ€
Diagonal_Fleece	I mean EDP did say he thought they'd lose
Gregory Lewis	The Giants game was a fluke ğŸ˜’ğŸ˜’ğŸ˜’
Washington Capital	Lol yall sorry mofos
Courtland Griffith	He couldn't be an Atlanta fan. He'd have died years ago.
AshGreninja1819	I knew the rant would come
southpark 981	Damn edp look like he wanna cry..
Luke Cunningham	Highbloodpressure445
ViBz Echo	Bro I was so mad I was shaking.
julian sykes	Someone re upload this we must add it to the lost achieves
h	become a 76ers fan
Prettyneatperson	Fucking Eagles coming from a Steelers fan
thedarkestdawn1	The eagles stressed him out so bad his hairline couldn't take the pressure and got outta there. ğŸ˜‚ğŸ˜‚ğŸ˜‚
Eugene	I can make them fry in hell
Nilesh Kumaraswamy	Eagles choked away 17 point lead
Gary H	Keep Pounding lmao, Panthers made your team our bitch.
Born again 86	Who came here after eagles lost lol ğŸ˜‚
BowlesMovement08	I miss these videos lol. Chill they got a ring thoğŸ‘€ğŸ˜¯
carbajal8283	HighBloodPressure445
xChris3297	his apple watch sent out the heart rate notification ambulance is on the way !
Adam Robles	What The Hell?!! Eagles Had This Game Won!!! What Happen?!!!
Matthew Dworschak	This is why we subscribe
Jason Lamb	We are fucking trash.  You were way more calm than I was during this EPIC COLLAPSE
mickee06	You faded the front of your hairline?
Anthony Powell	Keep Pounding ğŸ¤£ğŸ¤£ğŸ¤£ğŸ¤£
Bird Gang	Fuck this god dammn team im an eagles fan we gave the game away iy pisses me off we should of blown them out of the fuckin stadium fuck jim swartz and doug pederson im tired losing games like this just fuck this team wtf is going on with them doug pederson is a scared little bitch fearless gtfo
Devon F	CryEaglesCry445
Eagles crazy	Edp love  you  bro parker and bell asap  I'm heated
Jeremy Hutchings	Did you give him back his Vaseline Brian..
Lj Boyd	Edp we in this hellhole together bro hmu
Ok.Shorty	3-4 welp  Seasons over
Dough Baby	This is the angriest Iâ€™ve ever seen him
KEVO KEVORKIAN	EDP YOUR A FUCK BOY LOL  CRY EGALS CRY
Don Eladio	That Thumbnail LMAO!!
Michael Krasting	At least this proves how fake of a fan you are, if you actually cared you'd probably have something you aren't very familiar with, it's called FAITH, being with your team to the end, you are the poster child for why everyone HATES us. I'm an Eagles fan, though I'm only 18 and have only been a fan for 15 years, I take my loss with a grain of salt and move on, like sticking $500 dollar merch in your crotch shows immaturity.
Colin Sullivan	You could be a Bills fan. We are suffering this year.
johnny 12	PlayDespacito445
kevin sibert	that o is trash
Abeer Khan	You're telling me! I was at that game I felt like jumping off the stadium
Dan Da	I wonder do they show his videos to the team for motivation.....
Lucas Williams	U should live stream games
LatinoPackBuster	This guy is never happy even wen they win lol wtf
mikebing1230	Iâ€™ve been waiting for this!
KiDD340	Reportthischannel445
Alvin Tyler	I want to see a video of him taking all his eagles stuff off the wall and trashing it. If we are a joke. Real eagle fans donâ€™t need this trash ass dude.
Wrestling Otaku	feel bad for the eagles man. they and the jaguars aren't the same team that they were a season ago. now I have to worry about the ravens playing at carolina next week.
Alfredo Forte	The new Eagle fight song:  Spread Eagles...Spreadddddd.  Spread those cheeks out wide...lather up with Vaseline so we can be comfortable when other teams take....take aim .... take aim ...for penâ€”â€”atraation!
eddie bongsworth	My sentiments exactly fucking chocked this shit away like it was EDP'S cock on a Friday night.
Devin Rendon	I was hoping to see ass and titties in this video
Mr. salty gumdrop	Dis is quality content right here lmao
JR	I'm lmao at 2:22 to 2:25 he punch his bedroom door the next thing his dad in the background talk about cut it out or something like that he said #lol.
Sammy0071993	Go panthers!!! (All games are rigged btw)
Shawn Ferenczy	The only good thing about the birds having a bad season so far is you.
Def G	Dude is legit dying watching football.
Seth Evans	Cat doesn't know football except how to swear. ğŸ˜‚ğŸ˜‚ğŸ˜‚ğŸ˜‚
EatThosePastramiFries445	BlewA17-0Lead445
Morgan Walz	World of Warcraft freakout part 2
Nancy Penaâ€™Cortez	I hope trump frys in hell. That racist, sexist, mysogonistic, orange man makes me literally shake. Iâ€™m literally shaking rn.
Nair Johnson	ChokeThatGame445
Ryan Garcia	Iâ€™m mad of the eagles
Kevin Durant's Other Account	Yesss! Let that hate flow thru you! As soon as I saw the final score, I raced over to YouTube to find the rant video.
OGMillyMillz Vs Anybody	Itâ€™s 2018 and EDP still has the TV with the VCR already installed in it. ğŸ˜‚ğŸ¤£
Brolygarcia 92	I knew this video is gonna pop out lol
rromeo 9	blowdatlead445
sirgigglez	Repeat!
Leslie Jones	I use to be this guy!!!! You have to find a different outlet to express your anger man. Going about it this way is only going to lead to an early grave.
Volm22	Watching this as I come back from the eagles game and I feel so much better
Zionesify	The best rant EDP videos are the ones where he watches the game live !!!!
Jake Depriest	U just won a super bowl. Fuck it. If the raiders won a super bowl id be happy for 10 yrs
Atomspare	#KeepPounding
To Pimp A Pharcyde	Lmaooo pause at 0:34
Tommy Bright	Who wanna put money in it over/under EDP suffers a heart attack by week 12 send me your bets
Johnny Z	Why so mad, you already said the season was over. And Why is it on the D, your offense cant do shit
Rodney Gilmore Jr	10:02 Heâ€™s done  EDP you need your hands
Malik Wright	I just realized edp445 look like fletcher cox ğŸ˜‚ğŸ˜‚ğŸ˜‚
Inf Know	Felipe gonna have to wear shades and lie to his co-workers tomorrow about accidentally running into a door. Hesaklutz445
Bear 7453	Panthers are my sleeper team this season to make a run in the playoffs, and Seattle.
Trolln Yall	I honestly love watching eagles lose just for these videos ğŸ˜‚
Michelle Quick	These fake outraged videos, whatever you want to call them, arenâ€™t working anymore! Try letting Felipe slide into your bootypipe and record it.
hanratty450	Your neighbors must love you
Adams Saenz	Breaking news EDP 445 dies because of an aneurysm
Cokeless Name	That reverse psych hype up during the video backfired on himğŸ˜‚ğŸ˜‚
Dalton Deisler	You guys won a super bowl last year. Fuck you
Dominic DeNaro	Ur misery makes me so happy #Cowboys nation
lilthothunter	Blowthelead445
GOAT GUZMAN	For the first time in 10 years I agree with edp am done with the eagles
Panthers Gaming	PANTHERS WIN WE WON THE GAME CAM IS THE GOAT
Luca DeAdam	Just when EDP's hairline was looking like it was gonna make a recovery... smh my nigga EDP is gonna be bald by the end of the season.
RetroEnvy	Was waiting for this.
Mute Pepe	Eagles makin my boy bald ğŸ˜¨
Lex Zone-Six	Y'all just won a super bowl...
simm442010	Doug pederson said in the post game that  the pressure is off. That all I need to hear to for me to throw the towel in for this season.  They can dance and lose out  I don't care anymore.  Redskins will win the east.
Logan N	And how giants fans feel. Eagles fans will never be happy
Donovan	LETS GOOOO KEEP POUNDING
postshanna	do you even enjoy football? this is supposed to be fun bro. its time for a new hobby lol
Musty Chicken	Blowthegame445
Plxiii Lul	Punchmydoor445
TakeAcTN	I stopped feeding my kids to watch this
Maximilion Pegasus	At least youâ€™re not a saints fan.
TheMayweather	think about how proud edp was of his eagles when they were up 17-0
Black Koshinomi	He looks like a angry bear in that thumbnail
Flazko	Nice choke job. ğŸ˜‚ How you blow a 17 point lead??
BJH 2112	I stopped watching lesbian interracial midget amputee necrobeastiality porn for this video
Hay H	You coming to the UK next week edp?
Bucs Fan	Eagles are complete shit its hilarious
First Name	Eagleschoked445
Andrew Black	As a Panthers fan... today was a good day lol. Time for my feel EDP video.
E J A Y E	We fucking suck!!!
Seargent AR-10	ğŸ˜‚ğŸ˜‚ğŸ˜‚ğŸ˜‚ğŸ˜‚ğŸ˜‚
Clamp Season18	Lmao eagles are trash just like their white trash fans
Black Skip Bayless	Been waiting for this
Tooperfect87	Cut cho hair nigga
Erik Gonzales	As soon as it was 17-14 I knew we were in for a classic EDP video
Nick Bundren	#KeepPounding
james cartex	Bruh is blood pressure is going to go through the roof
J Ski	Jim got a free Check an a ring  he donâ€™t give a dam
los ang	did his EBT not work? why is he so pissed
Q Jones	Can we get an F for the door that EDP punched
Jacob Brown	Panthers take that W
KingVerbatim	DontWatchFootball445
Luke Noonan	Keep Pounding
WWF247	Lmao all jolly last week talking that bullshit and I called it! His Bitch ass gunna whine like usual ğŸ˜‚ğŸ˜‚ğŸ˜‚ğŸ˜‚ LMFAO LMFAO LMFAO
APizzle90	IceDatHand445
Yaboiwooddyyy :p	Punch that wall 445
thegorn68	How do the neighbors never complain about all the yelling in the Section 8 apartment he lives in?
snackers401	This is more enjoyable than Baker's face
Polar Elite	We need EDP on the sideline for the eagles
BoiSam2092CrownRoyal	I'm so fucking happy edp is back!
Eagle Fanatic04	Did he forget we won the super bowl last year???
bill mars	Thank god i had cam newton for my fantasy qb thank you edp
Kevin D	IM NOT GON F%#KING WATCH FOOTBALL UNTIL THEY GET BETTER!!!!
Hugo  Villalobos	This is the type of shit I subscribed for
Much Loser	Eagles going back to their old form faster than your receding hairline.
Betelgeuse	GarbageAssTeam445
Emir Mutver	eagLes
MINsportspruduction	Lol
C00kecutter	How does a team burn in hell? Lmao
Day-me-in Moody	Edp445 is the arsenal fan tv of american football.
Shoot kid	take a shot every time EDP curses
Akademiksthetypeofnigga	Nobodycanfuckingtackle445
NYG Joe	Panthers on some BS this year
john hoskins	Make it 3-13. This shit is why I don't pay for cable or Netflix
Nigel Verdell	Comebackfrom17-0_445
Anthony Yousif	Just watched my Bears lose. I feel it edp
g0dlen	EDP on the brink of tears
Robert Fillis	#KeepPounding ğŸ˜œ
treven douglas	EDPVsTheDoor
Cooper Quinn	High ass blood pressure 445
Andrew Martinez	I think edp needs to focus on getting laid now
no anime	He mad
Always 1906	eagles blew a 17 point lead at home eh well how about that
AJ Tubridy	SorryAssFuckingFaggot445
coach	Now you know how us bears fans felt on week 1
Daniel Gallagher	You are 100% balding because of football.
The_V_Man Vaman1992	Soon as they lost I thought of you ğŸ¤£ğŸ¤£
Evcham 21	This is so sad edp445 rip your sticker
Jay11	I love being a panthers fan and watching thisğŸ˜‚ğŸ˜‚
Andres Nieto	As a dolphin fan we too blew a 17 point lead
Shane Harper	at least the 76ers and flyers won yesterday.......... lol yea this season is a wrap
Vertigo Gaming	Hopefully thatâ€™s not your fapping hand
whatyouknowbout272	From a Panthers fan, we may have won today but your team just got you a superbowl man. I would trade 10 seasons of shit to get that superbowl 50 back.. Donâ€™t be so hard on your team bro, they came thru for you against the most hated team in the NFL.
Tony	Lmaooooooo
Xavier Mitchell	Anybody got popcorn?
Astroworld ?	This is the funniest comments section  I have ever seen
Roboclops	I'm getting off a tough loss to the Patriots right now. Being a Bears fan sucks too.
Jeff Fisher	Fire Schwartz
Thanos B. Jordan	No more 28-3 jokes for eagles fans ha
Pattersquach	It could be worse. You could be a raiders fan.
AJ _	You'd like them fried u fat fuck
Anthony Santiago	Eatdatblown17pointlead445
Jeffrey Abbey	Hahahaha Jags next...  Good thing you have a QB and the Jags don't   But keeping my Giants alive!!!  Yessss C'mon Giants
KdJ2	The titles alone kill me. I was in tears throughout this whole thing.
TLE0622 IPL	Clicked off red tube for this
Joaquin Ames	Got mad at an amber alert cuz they interrupted this video
DJ Tapia	â€œIdgaf who is watching me outside, they better get away from my window before I light this motherfucker upâ€
allen withered	r u still fucking  mad about u getting shot motherfucking 7 times
JacrispaÃ©	Poor guy just wants his team to consistently do good
Nathan	Bringoutthefireball445
BUP	Trashdemeagles445
Andy Haywood	Imagine if he was a bengals fan
Kmart Gaming	I thought he was done after the Vikings Game?
Brendan Kearney	2:10 for the 4th and 10 conversion
Scott Lutz	I am a Raiders fan and not an Eagles fan and yes my raiders suck but unlike EDP 445, I am not the one saying I hate my team just because we Suck. As a real fan I can be mad and disappointed in your team but if u are a real fan donâ€™t be saying u hate your team or F them
Mohamad Mahmoud	Chill bro you won last year
Bob Cobb	just tackle him LOL
Dan Lutter	I wanna see his reaction video from the actual end of the game lol
LeGoat James	Blewthatlead445
Goatbrook	Fuck Count=498
Gabe Mac	Breakthathand445
zeefly226	I think you need to accept Jesus Christ as your Lord and Savior to control your anger issues.
D Man26	Lmaoooo. EDP why donâ€™t you go play for eagles!!????
Swagg_ Kidd	Lmaooo
Colin Bass	this is what its like to be a browns fan except multiply it by 100 and its every week
Kenneth Mann	I feel ya EDP, the eagles r a total disappointment. These niggas let me down every fucking week. Our defense is complete shit, how tf we blow a 17 point lead, thatâ€™s fucking pathetic
Ğ ÑƒÑÑĞºĞ°Ñ ĞºÑƒĞºĞ»Ğ° _	EnjoyDatBloodPressure445
Pacers Nation	Clicked off my shrek hentai for this....
Tony D	i was waiting for this
Ish0and0shake	One hundred likes and EDP releases his full nudes
The Philadelphia Eagles	ğŸ˜­
Nikola Radosavljevich	Your defense was dancing in the huddle at the beginning of the 4th up 17-0. Wtf are they thinking?????
Hyperball	My nigga, EDP's favourite word
RaineTCG	Taking football this seriously. Pretty pathetic.
Darxxxide	#keeppounding
Speedy Gonzalez	Madassnigga445
Sebastian Gorley	2:37 is that seth rollins theme song?
Henry Randolph	I want edp as the next cowboys head coach
H R	They need to put edp on that defensive line!!!
BigSteveTW88fan	*Sees Eagles blew 17 point lead* *Goes directly to EDP's channel*
eaglesfan 4life	If your sick and tired of them then why not sell your gear and stuff if you really hate em
Wet Dreams	This is the EDP we all know and love
Justin Yummerz	Ya know EDP, you can always be a Steelers fan... you just have to be a little more relaxed.
Legendary Winner	Fuckthatheroinbirdnigga445
PackManJake	Release Jalen Mills
MachineGunMike	2:27 Edpâ€™s dad ğŸ˜‚
erdoganslustknabe	DatTeamTrash445
Controversial BM	U spoke it into existence keep saying they gon win watch they win next game
The Vol General	BlowDatLead445
MustangMalone	Brian, give me my motherfuckin jar of Vaseline back my nigga!  You got me fucked up!
Alex Tomczak	EaglesRtrash445
CallMeBeggar	Lol when the autumnal mead commercial came on.
Admiral Drums	YOU ARE A FAKE ASS BITCH 'MY NIGGA'. YOU LOVE THEM WHEN THEY WIN BUT HATE THE EAGLES  WHEN THEY LOSE. THAT'S WHAT A FAKE ASS FAN IS.......YOU BITCH! DOES YOUR MOMMY OR DADDY YELL AT YOU WHEN YOU MAKE YOUR FAKE ASS VIDEOS IN YOUR ROOM? MOVE OUT OF MOMMY AND DADDY'S HOUSE DUDE, IT'S PATHETIC.
Damon Smith	Cowboynation445
NOVA NEBULA	LMAO
OPG SELLOUT	Waab
jordan cook	17-0
Blake Bandz	I came here to make myself feel better after the worst lost in eagles history
Matthew Campbell	the goat
Deion Moore	This is beautiful
Trae Day	NobodyCanFuckingTackle445
xKing_At_Birth x	I was so mad until we got the ball back 14-17 and I knew it was destined to be a dub #keepounding
Richard Waldrup	Nobody can tackle at 2:21 then goes off!! #LMAO
tr900 -	HEARING EDP SCREAM WHILE COMMERCIALS IS PLAYING IN THE BACKGROUND
CDZ NUTZZZ	AND THE EAGLES FANS THOUGHT THEY WERE GOING TO THE SB AFTER THAT GIANTS BLOW OUT WIN LMAOO
Tyrone Rule Jr	Lmao edp cracks me up
_iYogurtSlinger_	Last time I was this early Unknown Person had Sammy GG in his mouth. Lulz. #WorkedFaggot
Black Sloth	Fat no pussy-gettin nigga
Lil Cuzi Vert	Did anybody else wait for this video after they saw the eagles blow a 17 point lead
Mark Marton	Oh for god sakes EDP445 stop hating your fucking team! I'm sick and fucking tired of you keep saying "FUCK!! THIS TEAM SUCKS!!" EDP445 for the last time! Calm the fuck down! Oh and by the way EDP, fuck you!
Jake Hemmerick	Lol I saw the Eagles score. I went straight to YouTube, just to have weekend made.
Succ	DOUBLE UPLOAD Pog
Joesph Stalin	This is epic #victoryroyale
theycallme_oj	As a panthers fan this is truly the greatest icing on a cake after a win
Ted Geracie	Bahahahahhahahahahaha
Amir	I thought we was gonna lose I turned that game off
control ALT delete	Don't lie EDP your fist is sore from beating off not from punching the wall.
That Egulls boy	How has EDP not destroyed his throat yet with the yelling and deepthroating of objects?
IceWater714	I was so waiting for this :D :D :D
Fluffkinn_wit No_Hairline	EaglesWorseThanMyHairline445
The Reel Bill Seigel	I fuckin hate this team
svega24	Its the secondary mate
Paolucci Talks	Anyone else notice when edp takes a step it puts so much pressure on the ground it causes the camera to refocus?
kcskateee crowder	I almost clicked on another video then I saw the goat.
James Silver	Get a punching bag
Jordan A	Here before it gets age restricted
im bored	God bless the panthers
tweezerjam34	This ones on Doug Pederson. The 4th quarter play calling was awful. This one stings.
Everybody's Uncle	10:22 EDP is a flat universer
Blindfold Gang	Yup EDP is back
Dude Feysh	Get verified on twitter already
helicopter weewee	Season's pretty much over.  Time to start cheering the Chiefs I think...
porkytm	Lmfaoo this was better than I expected ğŸ˜‚ğŸ˜‚ğŸ˜‚
LAZY GOD	The only thing that could top this video is EDP's dad asking for Vaseline mid video
Incognito Latino	eagles looking like atlanta out here
Russian Old Spice	HTTR
ASC Eagleman	Jim is too DAMN conservative! He refuses to blitz and it's so frustrating to watch! Plays too much zone and has the the CB's line up way too far back... If you wanna beat the eagles just throw over 10 yards every time they can't STOP IT!!!!!
EH M	Couldnâ€™t wait for this. ğŸ˜‚ğŸ˜‚ğŸ˜‚ğŸ˜‚ğŸ–•
derrick megown	Been saying that. Doug gets a lead and loves to sit on it. He starts running plays that stay at the line of scrimmage instead of letting Wentz do what got us the lead to put them away
Xairic	Hell not real, just burn em yourself
Creeper 198	Well he predicted it they Lost 21-17 at least they blew a 17-0 Lead
Aaron Scruggs	At least it wasn't 28-3ğŸ˜‚ğŸ˜‚ğŸ˜‚
StoneColdReznov	He back!!!!!
War Winner	Firejimschwartz445
FitWorldExposed	Iâ€™m thinkin about gettin yo pops some Vaseline for Christmas
lol hey	When I was watching this game I was just happy to know that edp would make another videoğŸ˜‚ğŸ˜‚ğŸ˜‚
Johnathon Pomerlee	Edo bout tomorrow turn to a cowboys fan in a min
Ultra17	This is what I subscribed for
toomuchsauce	EaglesFryInHell445
Carti Plugg	Imagine EDP being a Browns or Bills fan or something lmaoo
HereIsWisdom 1318	Someone tell this fatboy they just won the Superbowl!  If i was an eagles fan, id be happing 3 decades when they won the SB!
Detroit-vs-Everybody	Iâ€™ve been refreshing YouTube since the game ended
danthetrainman56	im more disgusted that the deflatriots won
xXExxolasXx xXExxolasXx	Says the one looking like oldmanjenkins445
Prime.	l don't know what's better the W or this
Kai	I WAS WAITING FOR THIS LMAO
Jesus Perez	You tell them EDP! I would rather have you as their coach.ğŸ‘Œ
JustJasperrr	kept pounding that eagle ass bitch hahahaha #Keeppounding ğŸ’™ğŸ’™
JmsEdits	Least yâ€™all better than the bills
Matt Williams	Brokemysuperbowlmemorabilia445
Lebron James	We had a 17-0 lead until the 4TH Quarter and somehow once again blow it 21-17 ğŸ˜’ğŸ˜’ğŸ˜’
Grioh	was waiting for thisğŸ˜‡ğŸ˜‡ğŸ˜‡ğŸ˜‡
Mordecai The Awesome Bluejay #PuppetMaster	mentally ill black man throws a rage fit over a football game
Daniel Zapata	Never refreshed a page so much in my life, BlowThatLead445!
Yes123	Fuck this team!
Ronnie Collier Collier II	Worst defending super bowl in the history of NFL
Honey Badger	I feel the same way for the Bears as they made to many mistakes on special teams, Secondary, and Mitch Tribisky who threw too many goddamn over throwed passes and these Bum ass Recievers can't catch like the ball is on fire excluding Trey Burton. Fucking too many mistakes against the Patriots. THE FUCKING PATRIOTS! THIS AIN'T YOUR AVERAGE JOE TEAM LIKE THE BEARS TREATED THEM THROUGHOUT THE 2ND HALF!
Cristian Arteaga	I donâ€™t see the Raiders making the playoffs in the next 10 years with Jon Gruden
Yikes Jungkook	the thumbnail ğŸ’€ğŸ’€
Derian Hurless	Blowthatlead445
The Goat	I hung up on my girl just to watch this
Sir Spookii	I saw the ending of the game and I just started waiting lol.
Otaku Tester	Chokedatlead445 coming back at yal trollin no life mothafuckers with another god damn L
drunk Squidward	Thumbnail got me dead XD
CardinalSin21	Honestly I enjoy seeing the eagles lose... only cause you know EDP is gonna lose it lmao
Sean Rideaux	He had Smallwood in the flat and got greedy and forced it to Jeffries on 3rd down
jack joannides	EDP become a giants fan. If you did you might have to hurt yourself.
RegularArc	My panthers won and I get a good edp video letâ€™s go
GT: EmeraldRepublic	I actually agree with him. Eagles are trash this season. There is no hope
SteeleWorldWide2	Malt Liquor!
t1sp	FUCK JIM SCHWARTZ AND JALEN MILLS  HOLY FUCK FIX THIS TEAM
RobertHall85	SmashDatTV445
Lazaro Chairez	I nominate edp445 as eagles coach
friendlynicemail	OH the SUFFERING
lucifer	LOL SO THEY WIN THE SUPER BOWl AND NOW HE IS A FAN LMFAOOOOOO
Ghost_Fazbear	I've never been so anxious for an upload
Giants1995	This dude is on suicide watch every season
Brandon Bohn	burninhell445
georgearrivals	damn you managed to pull a giants lmfao
OrangePinaple 1736	Came on youtube this the first thing i see i couldn't stop laughing
Wakkoz	EDP prolly wants to smash the TV screen as hard as he clapped Felipe's cheeks.ğŸ˜‚ğŸ˜‚ğŸ˜‚ğŸ’€
Observed Germ	ğŸ˜‚ğŸ˜‚ğŸ˜‚
Dan Saeed	I have NEVER clicked on a video so fast
MyFly 713	thats why you gotta join pats nation
The Engie That Cried Nope	This ought to be good.
The Alkemist Official	He seems kinda angry...
Deez Nutz On yo chin	Knewitwascoming445
Crow.	EDP about to go to flood all the toilets at Lincoln financial field for this
BonelessDean69	Eagle is trash as hell man they blow leads like a MF and I don't even watch football.
Wentzipaul	Iâ€™m gonna be frying in hell after killing myself
The Film Freak	These are the days I live for
Jonmetal 96	EDP's hairline receding as each loss happens
ZelGoesHard	FrenchFriesinHell445
yung professional	lmao ur eagles got beat like my meat
Phantom McCoy	2019 Philadelphia Eagles Head Coach EDP445
Fernie Ortiz	lmfao I've been waiting for this video ğŸ˜‚ğŸ˜‚ğŸ˜‚ğŸ˜‚ğŸ˜‚ğŸ˜‚ğŸ˜‚ğŸ˜‚ğŸ˜‚
Kendall Fire	LMAOOOOO GG         Eagles blew a 17 point lead btw
IronicPlague	Pretty much me as a raiders fan this season
Todd Gack	Instant classic lol
Ash Sixx	Karma is undefeated. You get what you deserved, you spoiled ass fraud piece of shit.
Stefano Dal Vecchio	DAMN!
Fluffy Bunny	I feel like I can no longer make fun of Falcons fans.
AyOxImCarrying x2	Thumbnail speaks 1000 words lol
Donald Sterling	Eagles blew a lead like EDP still blows Nitrofreak on the DL
OG Kusherton	I knew it was coming any minute now
Jarvis Landry #14Hunnit #Landreezy #Juice	Jags finna clap the Eagles cheeks next week like how edp claps Felipe cheeks
EDP's Nephew	Never clicked fast enough to uncle bryants rant time
RCM b	I stopped beating off to Brutal Anal Pounding just so I can peep this bullshit ass video
Erik the WWE & Anime fan	EDP vs Dad ll
Lil TAY #YungestFlexaUfDaCentery	Even when the Eagles win theyâ€™re ass
glph music	I'm a Panthers fan and I knew you'd react to this bruh! I was just sitting here like "Damn I know my nigga EDP mad af"
travelers light	I wanted them to lose so bad ğŸ˜‚
Connor	Who else has been waiting?
gustavo martinez	What happened to Area 51 did you get fired?
Sodaboy1996	Your hairline is 4th and inches
Jeff DiBernardo	At least your team wasn't stopped 1 yd short on a hail mary from tying the game.
Eman Plummer	Man i was so happy the eagles choked because of the incoming edp rant
JaniSWFC	BlewDat17-0Lead445
Garpod	Iâ€™d slap ur ass low key no homo
Winston The Gorilla	EaglesBlew17-0445
Alex M	LMAO!!!!!!! 17-0 AND the Panthers scored 3 TD in the 4thğŸ˜‚ğŸ˜‚ğŸ˜‚
Divine_Wrath	Could be worse. At least you guys won a SuperBowl. I'll probably never see the Lions win one in my life.
Tobias	YellingAtMillionaires445
GO AGANE	been refreshing my feed for this
Waveface killah	Cam newton the goat
Peter Dunbar	Welcome to EDP445's best reaction video. Seeing Eagles collapse and his reaction live was better than another season of Breaking Bad
Tyler Garcia	FryingFriesAtLeos445
Martin Conta Gets Banned	ğŸ˜‚ğŸ˜‚ğŸ˜‚
TheMoistMarshmallow	I was waiting for this ğŸ’€ğŸ’€ğŸ’€ğŸ’€ğŸ’€
Dane	BreakMyShit445
Craig king	I was waiting ğŸ˜µğŸ˜‚ğŸ˜‚ğŸ˜‚ğŸ˜‚
PHW Gamer	Evan thorntans arsehole
A random ass weeb	17-0
King baker Mayfield	Bears fans, where ya at, WE WERE STOPPED AT THE FUCKING 1
TakeFlight89	Uploaded 3 minutes ago. Already 1.5k views
C-Town Beats	At least u ainâ€™t a bears fan we got stopped 1 yard short smh
Dbomb 12	Highblooddpressure445
SUPER JUICE	I WAS WAITING FOR THIS NOTIFICATION
Austin Talks	Haha KEEP POUNDING!!!!!!!!
ILikeTheCubs	Eagles lost and Patriots win. Words EDP hates to hear
barcalona55	2:18 Youâ€™re welcome. ReversePsychology445
Big Jordan	Panthers fan who was waiting for this!!!!
Mark L	Music to our ears.
Pavel Mamboleo	Ahh this is why I root against the birds ğŸ˜‚ğŸ˜‚
DaMeeK32	17-0 FUCK
Joey Durning	His blood pressure is through the stratosphere
eviltwinnumber2	Everybody flocks here fast af when the eagles lose lmaoooo
Sonic Mania	Why you always negative towards this time? ğŸ’€
Aleks Melys	Aw sensitive much 2018 eagles suck deal with it
Stevie Jr Is a Kevin Durant guy	Philadelphia eagles are totally garbage!  ğŸ˜„ğŸ˜„ğŸ˜„ğŸ˜„ Hold your L
Chad Warden	Edp bouta go on a toilet flooding rage
MemeGod	God Bless EDP
Tariq Johnson	ITS HERE OMG THE VIDEO FROM THE HEAVENS
Go Eagles	This game really really shows we arenâ€™t very going anywhere far this year. Inexcusable collapse on defense the last 3 dries and horrible game management at the end of the game
KingToro	Eagles blew a 17-0 lead
Doge Doge	Chokeadelia
The Prince	We whooped that assğŸ˜‚ğŸ˜‚ğŸ˜‚
lafnotfamous	ğŸ˜‚ğŸ˜‚ğŸ˜‚ğŸ˜‚ğŸ˜‚ğŸ˜‚
Mike Hawk	LMFAOOOO Eagles blew a 17 point lead
Devin Garcia	Was waiting for this!!! Don't worry dude you all just won the Super Bowl last year chill! ğŸ˜‚
Truth Army	ChopThatBitchOff445
Carter Miller	Fuck Jim Schwartz
emisoccer â€¢	Iâ€™ve been waiting
Michael Peterson	Gracious the titleğŸ˜©
Memphis Wilson	I feel bad for Wentz lmao this team is a disgrace
rett Audorff	At least you got a ring.  Chill
Joe Romero	I agree they blew this game big time, they let off the gas to early
darin_ the_loser	He's talking about the fake eagles team fyi
mav stevens	when the eagles choke and lose a close game and edp makes a rant video from area 51 > when hes at his house ranting
- DLBJ-	Cam, ohhh Cammmm
Jason	Sup fatboi
Darien Espiritu	Enjoy this L fat boy.
jack xo	who else wants edp to livestream him watching the game live
Sam Is Alive	LearnToPlay445
GrizzlyScalp950	No excuse literally gave it away like chumps. Four quarters in a football game eagles play  all of them not three and prance about and wither away in the fourth.
SilentMoist Games	eaglols
Andy Johnson	Waiting so long for this
Henry Friedman	I was rooting for the Panthers more than my favorite team this week for this reason
Ted Nugent	This is beautiful watching his meltdowns!
Blurryface|-/	And the Patriots won hahaha today is a GREAT DAY!
Turn Down For Watt	FryInHell445
Ziryuri	*_I Hope EDP donâ€™t have a thicc nigga heart attack because of some dumb shit 445_*
drewbacca26	ThreeUnansweredTouchdowns445
MGamez2	His video titles kill me
Xaviar Bruce	L haha blew a 17-0 lead
James Burke	Lmao
Pepsi Man	Refs bailed out the Eagles and Still lost
GreenGaboon	Honestly i can relate to edp as an eagles fan.
Smooth J360	I agree with you about Schwartz EDP, this game was some Bullshit!!!
Hunter WB	Did they not just win the Super Bowl?
Joshua Aguilar	big ass mood BROOO
Victor Moore	I clicked on that notification so fast
Ragada Blaze	Was waiting for this ğŸ˜‚
You Smell Me ?	I feel like Iâ€™m frying in hell everytime you take a meanass shit Bryant.  -Daddy445
Sebastian Perez	Stopped watching Lisa Ann for this
Mike Rowe	I BEEEEN WAITING FOR THIIISIISSIISSIIIISSSSSSSSSS   GO PANTHERS BABY! WOOOOOOOOO
Boogz	bahaahahahah
RagingGamer2128	That stubborn ass should shove the Vaseline up his ass
Varson 188	FriesInHell445
Monkeyman32	HERE WE GO!!!
DBZMut	These rants man! Lol, my team almost lost to the browns so i really couldnâ€™t talk
The MAGA Way	Donald Trump the BEST President the US has ever seen. Don't @ me.
Fuck Gatorade bottles	ahahahaha gahteeeeemm ah good times
Rhys Syhr904	EatThatPantherCock445
DillonJacksonTv	LETS GOOO
Lucas Lopez	Keep pounding lmao
Kevin Fletcher	I knew we were boutta get some EDP heat once the game endedğŸ¤£
Jalenmillsisgarbage 81	Weplaypreventcuzwethinkwe'vealreadywon445
ImmaLetUFinish	Lmao take that fat panther cock
Shane Edwards	oof
A Good fella	Lmao. I clicked on this shit so fast. Fuck live streaming my grandmas funeral. Blowthat17pointlead445.
Caymien Davis	Yes sir EDP sorry we had to do it to yağŸ˜ˆ
Rey Perez	Here before EDP breaks his TV
Captainchita456	LMFAOOOO
Kay Kutta	Eagles canâ€™t win every game lol
PhillySortsFan46	Givedatgameaway445
Connor Marston	Was waiting for this! Yesssssssss
Barnaby Blackman	Being waiting for this video all day, lmaoooo ğŸ˜‚ğŸ˜‚ğŸ˜‚ğŸ˜‚ EDP bout to murder some toilets.
Dario Diaz	Was waiting for this to come out
Randy Moss	Eatdatautism445
Dank Hill	ThisTeamFuckingSucks445
Michael	GoingToCommitToasterBath445
Merse	Edp blood pressure is too high rn
Caleb Williams	3rd
Atikatikata	They choked
A8_Onex	All I have to say isğŸ˜‚
BigGame Hunter	Iâ€™ve been refreshing my sub page waiting for this.
UnderratedCollegePlayers	The video weâ€™ve all been waiting for the second this game ended. ğŸ’€
Depression Session	And then there was the Browns game...
B Lou's Lighter	DeepFriedEagles445
Jordan Todd	Oof
Cole Smith	Boy this finna be a good video, the only good thing about today
The Progressive Voice	Classic reverse psychology
Buffalo Gaming	I was so ready for this lmao
Brad Hoover	Dad?
Hoodie Eric	Givethefuckinggameaway445
nathan scott	Omg edp ur soo hot please fuck my sissy ass
RADATTI&SONS J	You called it smh ğŸ¤¬ğŸ¤¬ğŸ¤¬
Richard Prescott	I'm happy
JT Golden	Never clicked so fast ğŸ’¨
K12SEA	Been waiting for this vid all day
Dylan C.	Oh fuck
jameskevinemma	This has not been ur week
Conor McGregor	yesss i have been waiting for this ğŸ˜‚ğŸ˜‚
Yung Bado	Bro got his channel back
PhinsFan 72	It's time
Julian Shipp J.R.	Clicked off porn hub for this
Andrew LaFever	Lmao
Apollo	Saddd
dominick costagliola	First
Baby shark do doo do do doo	Eagles blew a 17-0 lead
User Name	Fryinhell445
Deshean Jackson	Fries?
Christian Alexander the Great	Foles >>> Wentz
Iâ€™m a roblox pleb	Hahahahahahahhahahahahahaahhaha
How bout Tree Fiddy	17-0 loleagles
Jvse	BEEN WAITING FOR THIS ALL DAY
falloutmaster233	It wouldnâ€™t surprise me if EDP and Felipe did a drive by on the Eagles Team Bus.
jda swisha	2nd
Riley White	Forst
The1andonly 803	ğŸ˜­ğŸ˜­ğŸ˜­ğŸ˜­ğŸ˜­ğŸ˜­
Some User	Nice
ChiefsRaysBolts	Second
Samuel Delgado	Yessss the goat is back
Bob Melvin	First
